wallet_address,malicious,bitcoin_spent,bitcoin_received,total_balance,total_transactions
12kt1XRN4fEjZYb2d5sdMQuFY354jPeUBG,FALSE,0,1014427,1014427,1
122MvWAve3rh7PmJf6cjdKJTWdcjo3oRgK,FALSE,0,193424,193424,1
112J5z2qDMm4EkMXfAdL3EmtDpmRKc9jMo,FALSE,0,546,546,1
1135ZmfarGGgjYF1BBsLgRq1V1S2fygTxg,FALSE,0,3677865,3677865,1
113j7bsWe7bVA3rDNq8LeNJwDF1RBeAGQn,FALSE,23534,23534,0,2
112J7nQ2TVRg7YHqbDtmUVadXP5tJ6Zeap,FALSE,0,27902,27902,1
111111111BumHKnZ2jXw2mbmHrRwJ3h,FALSE,0,5500,5500,1
112ZX38Gza2Dp53SJTFEvCtf6djXndLAYY,FALSE,0,620000,620000,1
113ezDDVmR1dAjfUUJMkVfixJfjXNj46ST,FALSE,0,360000,360000,1
112tKALrhCvtCmRyZW7WcZXbEzk73qKe4K,FALSE,546,1146,600,2
113AKpywqQ3tEQA7fDNxKcmwHcqqT4LPXG,FALSE,0,5310,5310,1
113LKgxVZj71PNQWPnRUKq5Ray2dn1XBbq,FALSE,1185863,9814660,8628797,19
112H9MBWBTN7RJBDa5Fup13Zy3p33ZHCem,FALSE,0,49999000,49999000,1
1126qTvJbXSutn4kje7MdXHjhTa5azrNji,FALSE,0,3000,3000,1
112xKJ9a4FnrsjQitnhJnsBqHYwyPoJviZ,FALSE,0,15475,15475,3
113wwuDu4KKYc4Fj28kmEfacwuoZH9FsUa,FALSE,131053030,132313938,1260908,6
1133VKCKapWXCdio32FQsETC9npUJyXsZr,FALSE,0,546,546,1
113GuWXghXUy3DHzcmMigdyGGbo9LVT3zj,FALSE,86649,111758,25109,11
112ECwJiw5J8b22G579QwXKfYdiNPUoDha,FALSE,0,146185,146185,1
112LdJUnYCxdjd1oynTNRDHiGGzfJYma4R,FALSE,0,1308441,1308441,1
112vtt4rh4qCSzLN8iUnakRhgYLSt8gU49,FALSE,24612165200,24612238900,73700,8
113A69ddQVjrQXM8q6HBEeNb6WSA6MGvF8,FALSE,0,140284,140284,6
113h7SPvR7TKT9aNuuCBWxVWXNvdzY4MeZ,FALSE,0,23970,23970,1
112TeQnKqbc8Us1tCgXmrwXvhkd3cM5Pq8,FALSE,0,1000198,1000198,1
113BBZr3V872pU8udoKGnAmHeEVShNxDvA,FALSE,0,10000,10000,1
113ULxbBwJ3VrbsRpaqB49vpCtq32Tv854,FALSE,2398333,2404974,6641,8
112U2BWo9V32wDY6m1MHfaxJkT4cd1jabG,FALSE,0,69013,69013,1
112bQnhmAtdhDcv3q8tPPhBwXz1Ba2BTeS,FALSE,0,300000,300000,1
112gGaUswVTGjajnxeZ7PmYL5cjQfzdQD4,FALSE,190024000,201113400,11089400,25
112hpsNmQj6kRZcEt1YeYygXzXvXRNp4Kw,FALSE,5460,7098,1638,14
113tg8FLea8XK3uDUzrk3HdCuTUmGoBYD5,FALSE,0,202205,202205,1
113PFAF4ih3X5AnsuEKxFfcNqVoweUtqyR,FALSE,0,549,549,1
1129CeRxkvqgihm19iVRmJNasWPFhZhrQU,FALSE,105430,110860,5430,3
112sSjj8MLTWH1vQN5pDmYxVHBDu73pXej,FALSE,0,176191,176191,1
1126uqrMBbZJyjRGxSqHQDP5Wf9sK9EgCT,FALSE,92487043,93170978,683935,36
112rFYoiC4ivPQhtEAsM4LNj6ZfUM1fXBK,FALSE,0,995949,995949,1
113TcqKZPEC5afBtgTipaV5ADdbyLVErjz,FALSE,1892328,1892329,1,3
112SD5WhBr4ZAHRj4XkxLkc8M2RUKcxrc5,FALSE,0,90000,90000,1
113d97Fjkbb8WoTYZXd55CLRZTDrfBMf46,FALSE,0,1,1,1
112xHZWFZps5ZSTUN9vyuevrQ6BWsyBUB6,FALSE,0,102000,102000,1
113kwbxKAPe2PiKjYGUt2wXiSYsyELso8L,FALSE,0,123004,123004,2
113KWMte3bmKUBfWW5WKymsmw94Z9mqAoJ,FALSE,180000,180000,0,2
113wkvUrzU82pPAoLfdvVej18sZoLC6GBz,FALSE,0,548,548,1
1134WxnKWm8jwYBLhSxmCbujaQAzRnkvHn,FALSE,17442458,17442458,0,2
11125rYAZwJqGoEpZn41EB2JLfA7EkVrgR,FALSE,0,223250,223250,1
113anwR9EfENt65WFp8MXKtyCnV42LJ9Nx,FALSE,157991,157991,0,2
112vdV3SB8KSZ5waejJGrM7szzwre2DFQN,FALSE,0,124960,124960,1
113dvc2gPRBhzLxkziGoZSc7XRPbeptFat,FALSE,126824,131485,4661,9
113vE7g4MrE8gJeoGpfhuCpDFSCpC4JM7t,FALSE,0,10000,10000,1
112e3wPLTyek3SuCFcEfyitAvUTZTje2jh,FALSE,0,173002,173002,1
113MZpT6g9CuveLRznJjX9KmdmfjepA4Gz,FALSE,0,2008,2008,1
113pEi76h3357iimXoaqqypyWiZYxwLmVQ,FALSE,16034260,16099171,64911,2
112aMZMKTt7YQ8jkyC3hzzjFamd6rF9U3Z,FALSE,9000000,9000000,0,2
1128nAbDmbWNrs6eieKVxKqVbQCTFxJpqP,FALSE,0,11000,11000,1
112Abxs4AECoAtce1PGVGShoXS3NvVeaxS,FALSE,0,40000,40000,1
112J2qKSZ8MkeCDToCqpFw1X47o7PRHFEU,FALSE,0,1000,1000,1
112iieciTC5BKT49TdpPwMfRS4HtFgN71G,FALSE,5608417,6338635,730218,25
113h6Si2uSN36deV2WsprJqHhj75C4xp9,FALSE,0,30000,30000,1
112GSJpoyfMdufdWFNcMFQcs89rb9bjn8x,FALSE,0,33194,33194,1
111YfounDDF3vexE3CVtKtupr88kDDQr,FALSE,0,546,546,1
112RTnZP7ScPeASFzJTUDemkLekxZewX54,FALSE,0,137071,137071,1
112qYHZe4PJfWqchX3pQFQ4er4SQKhSqtD,FALSE,1952,1952,0,2
113xantewSK1Eo9h43k7QwnUZjCLdEXY3p,FALSE,0,266047,266047,1
1132CfM5iWHZUHgt98oWzy5jK9aBCTPZNX,FALSE,124879,134949,10070,19
113DGXiFNDbdYLS4DtSgU3n6oBr8TRARuV,FALSE,0,12334,12334,1
1113BhXHduqsBVpwaVb7YRbMLogujacWk,FALSE,0,5480,5480,1
113XfQFG6BKEUxMgLoqZcody2aWmRFZbBY,FALSE,368866,380650,11784,5
112Fk41hCZYsaVVL89YQLZFwpgKVfQJaP1,FALSE,76360,76360,0,2
113qpJfq4XGzLxBsVSsr54aDhzT1avsPXL,FALSE,2896554,3048024,151470,7
1131hpq5ub584JmtrmRyPQpjFrCLFqHBAR,FALSE,0,3953498,3953498,1
113ah6G9R5CpQ1jJN7VYS5cEn9Eosq2Jvx,FALSE,0,34680041,34680041,8
112fK4ME19Xp9NYmokhpjLwnoQiHx2iw7D,FALSE,3860542,3860542,0,2
113yn1m2Se48qvWXZPoJ36pu4hJcrzwCcG,FALSE,917618,917618,0,2
113AWvYWLdmasqaGhbhUjzzCLStY2o7Pg,FALSE,0,998244,998244,1
113upEEMVTG6kzYK3dMjifhvXUD3EcRuvV,FALSE,77942601,77942602,1,21
113c8xBMqTZ6z8BvtFMhrsmkbFMJrZTCFS,FALSE,144000,144000,0,2
113xy6EYz4rEkVVyBtBy4ywTzQfQELnBCo,FALSE,7229985,7229985,0,2
113WdwjMs9ptgSw7gAmQv3rJTHHfVS1HiH,FALSE,7182880,7187400,4520,10
113hmccdy4A6LXqZ5VkBUbmwXaviiMAuDi,FALSE,0,3279,3279,1
1127uinFrNC4xNqZYj22augem3CorqNw58,FALSE,5479717,5674633,194916,3
112czuyqTZtbzqeksVvmA7eFubiDJoCRCz,FALSE,0,2628,2628,1
113dHb1sCHaa1wUZh4BCkN46jZcPERUsMa,FALSE,0,2559,2559,1
113X2663JEF6aEgyHqXarzsYJmkvsNmhRN,FALSE,810796,810797,1,3
113UoDq8k6SwnSVnnmZwp1rMQubrHc3imd,FALSE,290000000,290000000,0,2
113PtutJFmuVvDRidAjkwxGcfaceym6FhK,FALSE,0,25114,25114,1
11259Ry5ag2Gtqf7MsNJ2j3xHyqKst2qQU,FALSE,0,471525,471525,1
111nstitutedAmongMenXXXXXXXYkWtwg,FALSE,0,1,1,1
1138cruEHLYuijGm4p8e4ZXddsxDHwp9Jc,FALSE,0,8717515,8717515,1
1134J2LtWxQBC8FzT2TXdVXUGnp8KaUDMo,FALSE,0,233527,233527,1
112W6NJTF44Dnc1VMmSjVLiLzXwvHRJNNJ,FALSE,1205549,1205550,1,3
112pvRGRwzd8qmSD1cHANqMdrb5Utpi6Hs,FALSE,0,5500,5500,1
112sxYiE63q2rxLY3DeJCQu5VY2WRfshDZ,FALSE,0,8333,8333,1
1124xdzsbDQTNA46yqm6dRV21ns5kkHTWi,FALSE,0,3921000,3921000,1
112BnFqQFYp2ZF8A33AW4Tg3HPUAeWS9DZ,FALSE,0,12312,12312,1
112gYwpu2A8xj3ziMptBmRb9dCYqHrN6GF,FALSE,0,9489,9489,1
112BuUitSLN9FiNy9etkuNyjEkMtLcppo1,FALSE,0,524163,524163,1
113AvmUBZkxFeXxKAUBX5aKmW69tS1qRDK,FALSE,0,1101,1101,1
112wkbd3ThMBzEyw4CXWr9ZWGFSJDHxQVH,FALSE,0,12410,12410,1
11111v9JgGnnP2BVvxcwXzTUJF4r2mh1,FALSE,0,2000,2000,1
113t1uuVuC6wEDMP3bncyQxAMwaLc3N11K,FALSE,1226,1226,0,2
112g8wryEGppK6qbofyCo3UfaB5eGWeN3q,FALSE,0,4467,4467,1
112YiFkFqBTEXUGwf41mLuQ2S9PQxidhBb,FALSE,0,437,437,1
113Vs7kv7jDrXQSBYyuvQ5dxWuwmvsq8Rt,FALSE,1.32E+11,1.32E+11,50000,44
1127VKVHSwzWaVHJKirT3qS9C6cEBQm16c,FALSE,24233936,25000000,766064,2
112Umnt5hQ7YzzQLzpHnVQJUMMcofBuU4o,FALSE,0,9206,9206,1
113VfxebYxqoFQfyWvPf4SgSqAhtcRof67,FALSE,0,3485,3485,2
113jDbR8dWXReZwW58qZFgzqKrKFz8iHND,FALSE,192350,192350,0,2
113271S9ZHiUYo51dqjcXhfsmjSGY26SEa,FALSE,11185023,11185023,0,4
113xh6zvJ73sKdjKWTUZiGDjkw6CEj2tZd,FALSE,28364,28364,0,2
1128PRcSixkqfh7GT21vsk5ywoiCRPU68r,FALSE,0,18148,18148,1
112eey9Qurg5f4RVSKjeys5ypeNmRMgmT2,FALSE,0,2730,2730,1
112RB2fZFBCsJwoHxsyHqTNzarvs6EZkj,FALSE,0,53908385,53908385,1
112Wa8MuqsaBcSbLkoaSmPC8DQ99wGrUhD,FALSE,0,2710,2710,1
113PdJMFaLC8xsKginDqqyn4PMDtPkQFRT,FALSE,2263279,2491116,227837,8
113QwoaqVRLcMQ16sZtbc9YpTU4w61cjwV,FALSE,0,39548,39548,1
1137JwhyxXfgM1twjZgqPdBB4Kq4pg537G,FALSE,0,29170994,29170994,1
113wRQgq57X54Zf8DyS2DBaCqMoF9Lx6ip,FALSE,0,5770,5770,1
113wfagTtPgfEhw7RQrL85JCUrLjxN6DxA,FALSE,921239,921239,0,2
11314VGEjrN47oeetqpnc3hUogmYCxmn2E,FALSE,0,30895000,30895000,1
113HTf1jL9VDZ6vqW1mfa2PJKbZJPqMNn7,FALSE,0,10050,10050,1
113Uh1cx2nT7ceXJ84hcBYBiY7dPqRmFHx,FALSE,0,10000000,10000000,1
113hAMs7sw7Qgg3sb2Hgnf7EZ32bEWckuY,FALSE,0,473726,473726,1
112Xncy2TV9pCH8NhNx5qZq6VG2wkuYnox,FALSE,0,10000,10000,1
112KdjDJp6ogveKf8pUfAE2NBdgHR5XVtp,FALSE,0,631,631,1
1112CT1GXCVxtKXbf9YugavFxJfXCGmBRi,FALSE,0,548,548,1
113oCDryxcuc5F3cpH3Gtd9rrpEtyeDM9j,FALSE,0,78635,78635,1
1128tWWia2N4RU6GngjkgKbQih6Z8FbGE1,FALSE,0,1805,1805,1
113ZfKCgZKSSD9RT5bicNRPtwLjwC67FTy,FALSE,130362,130909,547,3
113uirvdotd7juqvLazGhRHKHg9KG6X7dg,FALSE,0,10732,10732,1
112D6DYeZkD6Ci3KE5yKcHe3avtR2kXGC6,FALSE,1000,1000,0,2
113PJQvvVAqhLgCv5LU63RTK92gPy1nmNQ,FALSE,17290,17290,0,2
113o6Fw2iZxdqDMAzMr8yae9V25RScuQk,FALSE,0,1000,1000,1
1121YXrM9tSEDFECTiL5Bq2yj8scMnc6og,FALSE,0,1001285,1001285,1
112ahG2nb3RXZPErZrr3aBz1hXgKvUtihe,FALSE,0,627,627,1
112geRaszfBA1pxr8TgXmCohRvj8M5cUpX,FALSE,0,37482,37482,1
112EZVWy8Wksa26kYpbhAu8X3b49XDikh6,FALSE,0,11500,11500,1
113Lhg1XXnbvShJ4CYwFzZF4iCQB2kcJ77,FALSE,0,4008,4008,1
1139j5TAgKLKJwVU5aTk9SA4M48WjYuU1d,FALSE,4785310,4785310,0,2
113GJxbT9x5eszGeNSqvm1GWiUjfbVCCXW,FALSE,0,68502,68502,1
113zFszvNQj6nNTPPjjykDsofjjJPRnW9i,FALSE,112816,112816,0,2
112PAKhA55BJLjL42Damb9SacohuRAwLgM,FALSE,0,11255000,11255000,2
112gMjBQHtbSe9uojqVHeAAXbreyCB71Km,FALSE,0,5500,5500,1
113D6ogu2UQVJg12WbsiYYzQoM54UyZGaV,FALSE,0,34621,34621,3
112PYDET1Q3QBNDX1NMyYQec7fszsot66p,FALSE,0,105700000,105700000,1
113oqZSWvaVeJEKypyT8JVEotxjNFE4BC,FALSE,0,1442351,1442351,1
113ioUM4K5PZ88wUzUsfBYe1sdFAmTnWpq,FALSE,0,12511,12511,1
113yL4w5gMHYJaxMKjWtae66YpLCL4eJpj,FALSE,1070000,1070002,2,8
111Uo6RHtUexUa4qa7ZvMoaxMpgzpPUHd,FALSE,0,211380,211380,1
112sD2Ko7rHsKanNNtCU3xQZ9Cb39E2s2c,FALSE,0,45109,45109,1
112ouD3G3E8PfsSveUAnuU9vghHv5xMrgT,FALSE,546,1092,546,3
1117kRPrW9Pz9Sa35yCkb8w6HAKuyst3Y,FALSE,0,56283,56283,2
113qDvDaFTogZNiSb2dmoPeSGVsrNPDsYr,FALSE,0,54234,54234,1
1134nhbq4udy2JtUM2ifsYNjwTsTZjgRgv,FALSE,0,1018,1018,1
113AkDNvun3z9oPPrMz387jAYZiM3ebfAc,FALSE,143622,143622,0,2
112L73YojNTHDMH6fpXQ42Jj4Cp7ru4GMg,FALSE,0,1010723,1010723,1
112ZRpAKRetZiEQb1YqKgy9zavGRQiKPKN,FALSE,0,836374,836374,1
112h2xN1KTFFEgDCJiqKcb7zRiUL9jgjXg,FALSE,0,10600000,10600000,1
113Lnxq89VmJuQ1xPMycsXAAAEbetaxM9K,FALSE,0,1209,1209,1
112XJo76Hmnif2kAZaQVkpmq56MXnj6pUJ,FALSE,16748455,16762830,14375,3
112Z9PFhUnJqdPTeB293cHmaVv5aVDJBht,FALSE,0,35340,35340,1
1124aU9FMvJZxgVTVKhqkxBE1UkpVKvRJt,FALSE,0,12583842,12583842,1
113JvVaNUkWFUWpxe5bUJENjqENY5PMApK,FALSE,0,791,791,1
113uwwCZmWcDsLUk7AjBmM3wd5pLLcqzkb,FALSE,6000,12546,6546,4
112cYmZSnZvQqShJSeJHrHsR5jotijgrfn,FALSE,0,5500,5500,1
112pfqBv6AFJDMpxrhVRpZJ4Gj5SnMF36P,FALSE,0,100000,100000,1
113hvzsVp3KfdSxupZcH4TWabbtqHCiaKW,FALSE,0,3715236,3715236,1
1131CSKPKNygktRSjr7fLPmyH7sZw9jpUG,FALSE,10011,10011,0,2
113pcZAb8Je4sgTNog7ckM8d3qii1PxSTx,FALSE,0,666667300,666667300,3
1138KKd4Lyc8yjaer2YeoFWmmUDHqg2MDG,FALSE,104000,104920,920,15
113Mt5s3LpodJBY8Jfpj2bkRxKUu2CmbLC,FALSE,0,547232,547232,1
113bLBPMJmVyAEdxhj2jZB3jgPziVrFJv9,FALSE,0,30000,30000,1
113hXvAGiXHam3xXe2WaMZvDkttFaD2sse,FALSE,0,20000,20000,2
113QkBxmNyA33Efz3ePsQz9MfbuQsGM7CX,FALSE,0,1953,1953,1
113nn7g5Wpdd76RiVBYtt3X3NykPmcKYQt,FALSE,0,14589,14589,1
113HHDYUTUwHC8sZmBhH3by1zD2d7F5CAK,FALSE,0,3242,3242,1
113px1sUxoUGwg83E3BKirNrVnUAWFBANb,FALSE,0,742442,742442,1
113mmP2SYprvDPP2samypmxbWYLqowfdnb,FALSE,171156,228552,57396,3
112tW1AWw15RPUDcDpnu8TjVpWkU5mrBiM,FALSE,0,76230,76230,1
112KHDDH4Rhfem6MvQTJQfS8wtL1cfhq9u,FALSE,10280110,34271462,23991352,214
113w8MCbcAGXH7VdPBZ6S2k9ygwXRKYL39,FALSE,80000,81092,1092,6
11333u3DjE6RyFrsdPpcJVJjPzDQ5z1Rte,FALSE,0,9162,9162,1
113rzw1UdWzaKiptbW89Zc1w6amnJuybQQ,FALSE,0,748875,748875,1
112toLN751Jwmaw7x5xcX51fqrVJUwm27n,FALSE,0,14053,14053,2
112hk2VK1eyYMg4GczZ7g8CVCyw6RLgvJs,FALSE,0,656075,656075,1
111Gk2Yb7VgCTZ6sjfwWYzEsAcuoBhsG,FALSE,0,5480,5480,1
113vRyHQrWYe8XWyxxo6Pqg9CrVnq24sPy,FALSE,12549833,12645672,95839,15
112hCkj9YzuS9nvDXYgpg9ZMMh75S65PyC,FALSE,0,938337,938337,1
113VkmTPanHBd1RFXRFbRsouySL1DM2Xai,FALSE,0,10,10,1
112wawqimhpsaERHw5ybj2EyH8woFADSYA,FALSE,328506768,328506768,0,161
112vyLzYUZS98AXMzVrwLguaKi4Qp4ufUk,FALSE,0,36491,36491,1
113ACv7caEvxa7d74K48BDn4PhmxSiWTK8,FALSE,0,940000,940000,1
112zDjimve7D2wMCH6mggxTNrX3tNmPFwB,FALSE,0,1000,1000,1
1139DYP3TMC4ysenLyoKH5ufUSLFM5E9is,FALSE,0,5430,5430,1
1127KRag2R5D2c6PvbQeA6LxNYmf4yDZtQ,FALSE,0,438824,438824,1
113jPFf3prcdTuJ9m2NdzuNzMgahiBvAuo,FALSE,0,50000,50000,1
113SMEpio6kCNTF1pc7WKk99tdAYXnsVhh,FALSE,0,16380,16380,1
112HJL7U6va5K4CPgY85Ashb7bDEqaEEgd,FALSE,97995500,98000000,4500,5
112Xv7u92AiJnz32r8T5iHXzpxLg9zeuwy,FALSE,546,1092,546,3
1123FoHVCxBLwRABNaNDVrFHDNYGNL75Tu,FALSE,0,85740000,85740000,1
1125GfHrNeN3G4G6bCtFAWwg26FsNmtqoU,FALSE,0,407570,407570,1
113QULJXJiA7a3jZi2G3zkS5XtcT6UbQNh,FALSE,20085077,22631977,2546900,11
112EAoA58eBK8dU76CeRJ7WZXABFXXA6SS,FALSE,0,10829,10829,1
113oUrbRFhrkdyrAjnaV9a4SK15QVn3eZb,FALSE,3276,7644,4368,20
111HEfsidBu3nTisf64mgArDUCFUYXJTZ,FALSE,2000000,2067129,67129,3
112a7eU7FGhRdpZ7RXJ9THR777ZJwxoshU,FALSE,0,402172841,402172841,3
1139Urcv5iVmwDHiAnoNJr27cGjEDdpEma,FALSE,0,50000,50000,1
1131thK6pddrRwSvwBF5U3xKAZJhvhjuQ2,FALSE,0,1000,1000,1
112Zu4x6mZHsG8rDqh7LZ3VayimxVdsLnJ,FALSE,358486901,374143101,15656200,37
113HWDJVpuEBjUeLd2Zt1EgaazwUQYjuFx,FALSE,0,169844,169844,1
112wYUyiWH1Hq8P15VasY7RMbgaiZVGzqF,FALSE,24679,24679,0,2
113CHHmcDZzYz3M4RxPNJTHYmTQmVCriaz,FALSE,285755,291842,6087,8
113oCxn8diBZBPGjcr6BCLuBapLvQTaef2,FALSE,0,693000,693000,1
113MYsfn2T9f9EChYPEtianM7ThytZWpAJ,FALSE,0,270122,270122,1
112WKDxinoGx363YGDp8Pv3Vnazto2WfSt,FALSE,860000,900000,40000,2
1139x6Demhj9zYikk3RMg3Gg1tUZyFDJss,FALSE,0,33619,33619,5
112t7cQGjteaZp5v4LiDpEZ8VM9HJhoR1d,FALSE,0,1052792,1052792,1
113fCxkH1noE2Krzk7zu7mqsFeLjgDUnzy,FALSE,57120000,57120000,0,7
112p4NAmwNYNDMV7RxqESNZKThQiMyniVR,FALSE,0,5798253,5798253,1
112EPWP3t3gAsfdqk5mC96zbXmziXjpvd2,FALSE,0,3807,3807,1
112MJYJdBNZEvcEzJ4r36umMARjZpbg98Y,FALSE,282704,296900,14196,5
113YBzn52QTSCNvCghV1Q8ND9viZRDY8bL,FALSE,0,51674606,51674606,1
113SmZgEefgtxQX4XyE49jArGzdTzuzJH9,FALSE,0,7089,7089,1
113NfkBpyqCR6CUpQwZTuau5gpzfubCQBt,FALSE,2164396,2164396,0,18
1136zBsaBcPZM54XgwbfUSVU3YMZii13nu,FALSE,0,902,902,1
113BoekcQS1PdQPVJ3wHc91Nvm5fj1qdAX,FALSE,0,190705,190705,1
1139mGXaTqx7KDEASoe9gRFCNF2xnqogtg,FALSE,0,29573,29573,1
112MA2csjyzyQ6ejYGWYq9gYA9rDLBChSL,FALSE,0,9140000,9140000,3
1126QP7Cvpcb3dn6kFVEuc36eNJDTbMXSV,FALSE,5855039820,5855039895,75,30
112XsRp5bDfCUBCo95vPTdtzQMg3wVH92P,FALSE,0,7353,7353,1
113BPigne7YqxkSVTjTyutVTWJuRds3zW,FALSE,0,1,1,1
112QSmEfPEBQvP5HYSbs53tgJ6YwbS5uPL,FALSE,1709953,1709954,1,3
1127qn6gF8LmuE98L6iEocMqUZRzbpxhjc,FALSE,0,5500,5500,1
113JKW9vzqdgXr5DRoKsrTng3KD6cZBPmy,FALSE,546,1092,546,2
112VVeabpngiaocs5rkG3Fjd7TYyPwqJzL,FALSE,2535,2535,0,2
113Ak5n8zBzmBQNkg1YecRQkNDEVgMdW4m,FALSE,113635168,117924252,4289084,35
113VyHkm53nufs9DgMrKHQcMSMxG3ywwMG,FALSE,0,91274,91274,1
112bPPyY9C8RvBqQV8KQq6azfjwQh5uKcZ,FALSE,724000,724000,0,2
113hbPaNfNBsmy42LSujiVJ4eXE1QfaFgw,FALSE,0,86178,86178,1
1131xHfKzJ6B5KzePtJBMfdd5ZqyAqPtVv,FALSE,14690245,15006487,316242,33
113EzVCtmVvDuNVFeJ7SXUjL8EAShL3mkb,FALSE,0,1000,1000,1
11314xXzo9qSpH5KqTKJ8UbpmFLUmp1fBF,FALSE,0,2500,2500,1
113vKpZonEHVxWDtZCzTWXZCpqcsxy6kNM,FALSE,0,10233,10233,1
112EpZmyp1iCB8PnBGQJFeifR1rhvW1PML,FALSE,0,546,546,1
112JmFaCpEyUB8FMY1vPEJxizRrq6aH2oJ,FALSE,0,2730,2730,1
112V5eMecpkwbznmBQPJEYLXRXy8guay7S,FALSE,24754,25301,547,3
113NKGPgbvyTRBbwvbood1DFebEmPhqB9x,FALSE,0,2500,2500,1
1127TuFtyYckUdJvxTaSrS9jnY38XaNWAm,FALSE,0,1764415,1764415,3
112X8zBaHFJRQqE6pu5DKntGePLhBhc7Tw,FALSE,0,20000,20000,1
112ojgXvBPpNQHQEHTayPGu4mSWQTNPvXL,FALSE,0,91044,91044,1
112rwUUJhCdqkXoYXQN3cVbitLhdyNKP5T,FALSE,16500,500546,484046,3
112ZfUBKyr4c87LLrEYiwUKxnSuCx2N1a1,FALSE,10986100,10986101,1,3
112fLREKPQy9E6w6v1ZkVdCTeGKDoxcWbR,FALSE,138894,157894,19000,13
113hTzWmovJPnJzq3tbkj6ieEquufTWVad,FALSE,0,9884,9884,1
113CmNVrK77ZxuWbSw16noDA4Z1uNUc49a,FALSE,1309911,1309911,0,2
1111F8tE8v1Y1twLmJ8i5ck9JdSFGYhn1,FALSE,416000,802000,386000,28
112DC2TEwzvXN8aTqMd581vFsEX2y8HRqx,FALSE,12000,13092,1092,6
1123xjpYyJxCAZnLpgxzeQoMZvAwBiKKds,FALSE,2000,2000,0,2
112YQTCodnhgEQ2VKcWXknewZ8KP4Kq1Co,FALSE,0,2059,2059,1
112yMa1dJ5fLBbktwMQM4EQ6Vj6YkppeTZ,FALSE,0,13736,13736,1
113XZiE62bnyHo7KUviSWxcxr2WWZbaJyz,FALSE,0,939,939,1
113MMfMBDKSWVGTbiszyuTLDhxRApJica9,FALSE,5277,18823,13546,3
112gQwXVJXBC4swUREouGksfkDSmh6tEzS,FALSE,3576947,4671947,1095000,88
1131LyQfFboojuvBXXcGBuaSTdkoLsjP97,FALSE,0,289430,289430,1
113iTwroGFhoK9odgSZgUhQXVjByWoRCjg,FALSE,0,1900000,1900000,1
113Wkkhit9hdE1DX2VqCSoKygfs4pvi3fW,FALSE,0,312048,312048,1
112CUuqQgZomduP1YLuQaVTyxERc2eN1a,FALSE,0,1000,1000,1
112AEAthqCDJcJBRjRhuvVTX3A3L9XJGTE,FALSE,0,12392,12392,1
112ZA91V9FDjuNzJErPQySWUpsZrGbogCB,FALSE,1634760,1634760,0,2
112gypt8UyZjNwNge1EzFEf3BEG8yt2f1c,FALSE,0,6026723,6026723,1
113VaZTwi5yNL2REmsceqqSrfrsNLWntfw,FALSE,546,1092,546,3
113wRKUEnYp1vXdogNC7Av1bZeX4mcK5mY,FALSE,0,23002,23002,1
113WBEbZ62mAQjBXA28RtpKmXUorHGxLqr,FALSE,0,2730,2730,1
112WPPD4HqxHkDmgtxjrt1KFFJf22J1nVQ,FALSE,0,8145,8145,1
1136opGAse7THkXt5deRPauqwEGPUHgpkc,FALSE,73033,73033,0,2
113yNE37dGGhXhuJXnManJZTsdZF39G3W7,FALSE,0,3785307,3785307,1
1133ztweBK4GfXVvgwwc9PwLrrPmzTo7iM,FALSE,0,943740,943740,1
112SVGPJWEZtU1VnVZ3meZijV1Cqz28Ye,FALSE,40000,40546,546,3
1123S55T5FA3fqfinPW9zZnNQoEcnzoKPn,FALSE,0,1489,1489,1
113M75j7vnUXm3LZM9BL6ik6davgwZDDRG,FALSE,0,768,768,1
112WFeFC1MoT7XQY8QhaY2a2VWYWFyUkZ4,FALSE,0,2044,2044,1
112vEEzkd945BbHS9qbAK3CbXfZ4idt4Ng,FALSE,61548727,63548727,2000000,3
112GL6emZ5k7CgBFmUdwLUV5HcRKVBUXVk,FALSE,0,404960,404960,1
1125NNxSUTYM1dzXL8bKaer7RDJcphzyyf,FALSE,0,1000,1000,1
112hxuiJzNkN973kR1booZqi8dGPnDH21J,FALSE,0,50171,50171,1
113pKho1xZnas3NKbj551S5E2F12QZRtfJ,FALSE,7798,10546,2748,3
112MMFiwLsav5YgqMw4eDvUJ9cVL78poGh,FALSE,0,612136,612136,1
113gVoFY7CvZGCzKW59A8jvTQCuHpcTqvM,FALSE,6577650,6577650,0,2
113ExBvaNs9FLi71vgMmAUAcpv1r6w2AeX,FALSE,333726907,333744135,17228,12
113NLiVaTZyL8FryZWWwYicDhS2fp4Pknp,FALSE,4511919,4775168,263249,210
11227iGdNx2QMcVPkiMY1TmDucDg7vnGas,FALSE,0,10600000,10600000,1
112sYf4MhzGos1xj2JvAZFV4t9yh7fxLPC,FALSE,0,2500,2500,1
112xrPHVTFUXUyjbagK3d6u2gJkMbCXD8v,FALSE,100000,100002,2,4
111Fwq4A1rzUBVzJhdYWAqQS5HUqgyqWY,FALSE,0,1,1,1
113wJXUx8Jt97M1yD6Voxh8wsd2XsEJxGm,FALSE,0,990180,990180,1
113KcCCEWboZ9mbXLn2BXdo11sRHMto6wF,FALSE,0,6941568,6941568,5
111111HB6pkyzX4aeutfjMywenXe1yF3,FALSE,0,548,548,1
112ZcGYLUCMbK6xhacjJHjERLecYbY9qCT,FALSE,0,8830200,8830200,1
112cRnJhxj4LcQQj5UVpyh7RF2ZcoHev2s,FALSE,26721172,31277996,4556824,38
113RP42WDAnAK9KSMPg81uQkuivA7hjViw,FALSE,201010000,201010600,600,6
1137Hpb5im1jnX7RAVgKRAnbboXtudyREP,FALSE,0,30150,30150,1
1128s6wJFjiPSQfcUCKMjeCbWXsoWK8sx9,FALSE,0,19749,19749,1
113jpLUW7qoj3rJF7DFLJEs3BTuLSSfLwY,FALSE,105091,105091,0,2
112iBUaBY9LbowrcxW17herJcaYhSSEcMA,FALSE,5500,11000,5500,2
112SrHrVUbttuCDhwi7GPmnFhk3KD5u8fb,FALSE,0,4493293,4493293,1
113bQgSf3UVPJHKGVnjBTci51gh7WiKkaS,FALSE,27210,29730,2520,10
113KRBB2SzRAT53jwo4fkJ4MYFtLSc6dZh,FALSE,0,6000,6000,2
113yVLy8BxEhPwS4w6jsiqS52SaCXEqf64,FALSE,0,579143,579143,1
113u7RcC55zYnYH4N1y8NfrjjPzZxuts2A,FALSE,0,4580633,4580633,1
1135QBo3dc2nw6j8Xs2JFT8Y4CDRo9Ehqv,FALSE,0,10000,10000,1
112rqVrKWDmGuDCzFDfKLAaBuDUzMBt8HM,FALSE,0,30992,30992,1
112AyeeirZ8csyssfUGhwhErAv53YcmUJc,FALSE,0,13493500,13493500,6
113c9J5Y8cfxyL4pBYMns2cVNRgjjQJCkf,FALSE,0,500000,500000,1
112zAaRStXrZqFXoGWVmKqMkr6MbiXZ1D,FALSE,0,10000002,10000002,3
1126WRPBumwXybTqFoBN44y81F9YqYMnAD,FALSE,0,334000,334000,1
113JKENuxvGdxffQPPAuvrpymWqfLsM4S6,FALSE,0,1031,1031,1
112WCBhybLZtpK2KbcGE8RasRLkbJsfVSL,FALSE,0,1930,1930,1
113w2yYrqb2HwUdqTQYsAN82ce94erR1E9,FALSE,14806,14806,0,2
111YnZXRgcBvmxfSKmLkotF8psXLrkum5,FALSE,0,2730,2730,1
112qFtRpkJr9LognZ5kAynLxP9ggvHYfUE,FALSE,0,33599,33599,1
113RohiFqbVEjJwPCThP65NiLug6KxdNSb,FALSE,0,502819,502819,2
112QkcRt3LziMAvAbYDKNe24qPAbtxxviN,FALSE,203533,203533,0,2
112gApSKwH1h67kV6mUzkFujD427VjAoMY,FALSE,0,921424,921424,1
112GJmEdRKQXpnMAbSnsXmtLfHHXxVLWHm,FALSE,0,709,709,1
113vPwiHijYT43jBqNzXAwFPrx6T8ypV6Z,FALSE,0,59277,59277,1
113wB6uMEsWhQTDz6hpNB6zgkiMCwxZtqM,FALSE,401924,401925,1,3
113rpyZdtQd5byShWy1so8LtLoYwKgF5C1,FALSE,546,1092,546,3
113QP4td7zpiWinsJ4S4TAVhT5CybPP6qq,FALSE,0,280259,280259,1
113oZppShPhjUckpNjzQCGiLU77fmkKCpU,FALSE,500000,500546,546,3
112ztYxKCUYchRrFMoeCXvZKvpB5yQq9QE,FALSE,0,997890,997890,1
113e8BFD5JGLJ8uFd4MQG8Mp8oRmXi1rsS,FALSE,85158,85158,0,2
113FFmyxiiDZ2dxJ3i4V5xDgwjea5Y19ov,FALSE,0,5310,5310,1
113JE9oeqys9qB7HJbwXFHj7Y7iLVcJeQb,FALSE,0,526054,526054,1
113iLDkDShfC4GfCE8eRjctxzTK93Mucgu,FALSE,0,4488,4488,1
113GSQJFpZHgp41visR7v66BRfZYi37cwz,FALSE,1476500,1477420,920,2
113pkMtdiR1Aby2HKu3uh1CqkgempEeg7F,FALSE,0,41258,41258,1
113hRKVyiCCiGuEdtDH5McufKJz7btSYMJ,FALSE,1719360,1719361,1,3
112LChoaMjkgyxXw7joUFTEymCJiuiEXdU,FALSE,0,644449,644449,1
1125nY13AGwQDVYj5qjqz2TZqtLkdM7jQJ,FALSE,10641510,11987118,1345608,2
112qyr1uaJMCkfZQXnCYgiaXo32TYfL4a1,FALSE,0,2500,2500,1
112scXroZ97WXMEW1CAZJuJa5nJjnXUo7n,FALSE,222167,227940,5773,3
113MAehShWY8xf2L9o5rM9P3yUgTJbBiRg,FALSE,0,262813,262813,1
113sPXHCj2u4dhDprKpb6qBwfPxBGY9m9z,FALSE,0,100000000,100000000,1
112mZYuNnproxemHaAxcvtxjvgFecaASK6,FALSE,0,1044862,1044862,1
113zWXgXerYkzbfBK7HQDUVmbJzaSjeobD,FALSE,0,10585,10585,1
112K5jLc5vYLSQsfux9622UzioT1nywJmX,FALSE,0,2256,2256,1
113fAHUyht3mNZtWS3vuYoywgGJVvn1AUz,FALSE,0,758,758,1
113fwD5x8CbXSiLbwjSwqkmN7a1ik8Ztio,FALSE,0,1816,1816,1
113xc4p1bid9NaRrMNb3awASLKUmXiaPDj,FALSE,196332634,196332635,1,3
112QPvbwSY7apbmrSsL42p3tXZBJUUVctB,FALSE,0,2500,2500,1
112EhZ5DdEa9td2rosEJzRhsUvR5BJJ7te,FALSE,0,5109,5109,1
113mLYyCRjNY91z6SZ2fdQ9yyib6uFZsZw,FALSE,0,10141200,10141200,2
1139os6BFzXEg7cqFHXA9gAKT2aJXf7hGj,FALSE,882257599,882260875,3276,32
113fVBVnjWt32q2myCmzxrdxLBrQU4yA9h,FALSE,9135100,25376128,16241028,4
112FAcQL7SBAQGuwEfiCm7iS2gnLWg4SN8,FALSE,0,546,546,1
112cfmPfb1zt3LD34sf8tPv7AiSw7j1Aow,FALSE,0,7867,7867,1
113aLsLb5Be7cDkLRsBQ2YEqBZs4TdAqmX,FALSE,8921281,9100000,178719,4
113s2zAR2fi8WCQnA8QXLRGyLBj6FoKLxt,FALSE,0,554,554,1
113bHadvXS7JeBgzpQZC5aZH8K36koZ7o9,FALSE,1112810000,1122810000,10000000,3
113QmDhPuC2Rrp3NJ2VS7d4UTfdj4ruHYX,FALSE,0,3850000,3850000,1
112wamFiVc1siirB3kXmaWukbYaMSaMVmA,FALSE,1338882,1338882,0,2
112mPx4iWPxfgASiCeSMvAnTek6AQRFSUm,FALSE,0,100000,100000,1
112pbdmnVHpPQkXdJQAu4YYBQsZS6ocbTw,FALSE,44363686,44364724,1038,3
112XLqusrMRTJEePntXkYVxhmq7NWJdQaE,FALSE,550000,772807,222807,4
112MXCHySqo3CpaKH2ruWensjGYSUcsfLC,FALSE,0,73852,73852,4
113HoqtGTyJn6ED3LDbokJopLp4ntD6B12,FALSE,11966176,11966177,1,3
113cZbXs6mp1Niz7bzvsY5nPwPxAeR9xW6,FALSE,0,4048500,4048500,1
112eTADjKrq3ymmSysYYVSHXCuaDWZKRF5,FALSE,0,21688,21688,1
113MGokB18HVWoFbZw6cyHWNU1cMp2wNJ,FALSE,7089232,7154738,65506,7
113gvdMv4fNvnHrknhaqgT8mbhYGUgJbbj,FALSE,0,153330,153330,2
11326sQwiXiyok1YnFHz9UWuzTfQMGtMcw,FALSE,0,1,1,1
1137rAvC89CTRe2T6Dj1RXnzXzzuoNkyNh,FALSE,0,11359,11359,1
112qaVJF56PLhRG79yJCaTdknSUUczV2zZ,FALSE,0,150000,150000,1
1138Sjt3tQBmupY4NXwQ83YyLmKNPP6aUJ,FALSE,0,4146,4146,1
112iYvVBgtawN5e1o2eCyAq5J4JfKsweKm,FALSE,0,10254,10254,1
112jVdtuF7Xz2TgyWtPCMZqHGAzTUe9YQy,FALSE,0,1067694,1067694,1
112jMuuERJLYhFMKspBbCeFwDg8Dd8jVNQ,FALSE,0,6002,6002,1
112GEe7yn8eJBAfZGJtabCeoe6LSk9X4sx,FALSE,73856443,115359309,41502866,29
113qQB9xyTncyxA9wxwYqeWJYhKYDWboMd,FALSE,0,104512,104512,1
112XRdJYdqFkR5zTJu4rpC72UZ3Ln3UmUT,FALSE,7286944,7286944,0,2
113UZRjj1ay1KvLr1oNymSViGzLsfkoBx6,FALSE,0,1930,1930,1
113QGZUXH564ZGEjnyZKcU8SZyXKANypHF,FALSE,88700,88700,0,2
112gmS5iocUtcyPsMT8SL3n3NtxAfEkrq8,FALSE,0,61388,61388,1
113sdNhzxDRwDmt5YEnT33Cenhpo24Xv8T,FALSE,0,2801,2801,1
113BqLgnJYvXo8A6sssgGvq9NRbUrrXgKv,FALSE,65799510,65799511,1,3
113SycRzNP7HqFPazgMJmnmZrQrxT2FiEM,FALSE,0,546,546,1
112Bk2JrQCowRr8ZEuULsJGCgkgP5gzcCp,FALSE,0,1190,1190,1
112xaweAHymzGJZVgPtnkJHc7X1WWtz8XZ,FALSE,0,75690,75690,1
112KwoxCnPAPgvq9HgaJFspYiDy17yjEzM,FALSE,0,100000,100000,1
1138A2zEST7QpaEKr2XmjvEYDV1MCpvzr2,FALSE,0,587,587,1
112WEoSwkmoHTAkxeJ34AzU9agA3p1wzhu,FALSE,0,1435,1435,1
11111111111NVTa6z1KSCfm2KwS53,FALSE,0,5500,5500,1
113FNkWU6CXGX4CjV6yAeSKmqre83zXi21,FALSE,0,4572,4572,1
113joWEmgvyaENZGuf2bvDSG5dAK1WmDNj,FALSE,0,5430,5430,1
11283CzWYChrTkWmkWmxbEEuKCR3Px7KzB,FALSE,0,215338,215338,2
112s7jrAQ6dgdmSN4NFKihM6RvWuzd1Jqz,FALSE,0,60000,60000,1
112V2iKQKxixAwSYBRs6jXuVpGmebfQeSV,FALSE,0,7566,7566,1
1116c4Ty8mcb7MUpT9eWbQ22X5BBvWtms,FALSE,0,2730,2730,1
112e84iVCNnJYS7Ss6iYy1HACo9n1RVyMJ,FALSE,0,5798,5798,1
1137v5LUcP75uk38jiW1fWK67NRnr5SEvx,FALSE,0,7442,7442,1
1135dj4tBbRKt1sUuk4QL6Cke5LUkYm5Ng,FALSE,215290,573352,358062,14
112aiXFmcijkimWxqqDFZABkegycaAN9Zr,FALSE,52033,52033,0,2
1132in8btjVbeCifNkHusE1ubA5Fqd4UB9,FALSE,0,42764,42764,1
112GhXA6iTcZ9L2TqJHd9KjSWsiCouYbUp,FALSE,0,180649,180649,1
113efuRh3t5PQcWzWTNpDpyev8oQrw2gqD,FALSE,2319928,2319928,0,2
1138oA8Rkku5VrGvr8MyeD4bWVPFRbb2wg,FALSE,0,83999,83999,1
112izwmK8Dge8hnMm4Lw1fz2V9at57pH1N,FALSE,0,77664,77664,1
112ePDjSttLfCVXDm2TvqjWvNUinQs6MQH,FALSE,35029,35029,0,2
112gMkE2dob3iiCFdXtmX6xqaTeajk28hS,FALSE,0,5500,5500,1
112f9qY31a5jUDUWoc94mogXC7nzdBSEcs,FALSE,840000,1030000,190000,2
113Gm9Fd9UP3hPLVVWNQhL75UsorwFTUAG,FALSE,0,63763,63763,1
113nTypYePEGcMNrsBZ4vnnXTzojw1dBZ9,FALSE,0,1001100,1001100,1
113ATw6mo4RJYjRGP7euResEiQUYUo8HbX,FALSE,0,10901,10901,2
112J7vfwiuX5x7LALg5bubczXqgKcDAejd,FALSE,1092,1638,546,5
1123LKdf9LHvuPt61Ae6hHZor5mdNwakRi,FALSE,0,98230,98230,1
113BFqERbQ9cG775zBfY798jg2bchucQat,FALSE,0,8081,8081,1
112u9LH7GQvepwK4hhPnNUeEgg3onTY6xz,FALSE,0,3136,3136,1
113PMUyEj2zffSUvE3NysJR6CPwoHVDbPn,FALSE,0,3063186,3063186,1
113BDNKPnSCTBnUQ82dpcwLWhDC5baerEc,FALSE,0,544067,544067,23
113cfdUFjoyhQHXo2aLtpywwr4P2F5h4gW,FALSE,6428243,6478087,49844,13
113YsdJi1U9NHDEc3a813wSiRZmZyyf5UR,FALSE,0,1000,1000,1
113rGJXWGYqBsMupM4B62vMdXjig43mry3,FALSE,0,546,546,1
111GkGPPbq788xM642BZxp1kAmTkTWLQ,FALSE,0,5500,5500,1
112tymkxWQRivfPNfveJRggnJbbGmCfRJ8,FALSE,5460,10920,5460,5
112Fg8CvDcdG6Z7w5v1aPmShfMxDuqaKSi,FALSE,0,10000,10000,1
112NLM8UMpB2d3JvyQCRMAn4bgftt9bYJT,FALSE,3276,5460,2184,16
113RBq1C88n3heoeLT6tQHLpXEsemH7f49,FALSE,0,10000,10000,1
113YGtdiSqRYSHm6PcvuxvSjQH19j2UVXT,FALSE,90509,97348,6839,2
112wMRatVxPCF7yCndRaqstqZrM8yKWa3b,FALSE,0,1397760,1397760,1
113X1Tf4QXNBJxNqGqFeqbVfuQscbdNYaH,FALSE,0,19690361,19690361,1
112bbxFbV2puU6YZGbq32s6DmCtFZN2DNk,FALSE,0,6048,6048,2
1134ptzjbgr8D3rxdLxRsBqQVdLUQ6ttNC,FALSE,646794,713841,67047,26
11121VugW2A8eH1sJWoY2o2QU5jJkPGjLe,FALSE,0,546,546,1
112nGCE875mHcNY2v1j8KgcbUptN87YS9F,FALSE,546,1092,546,2
112rzUsDDSJzAHVcR6RE8QRHkjPsTByTqd,FALSE,0,2500,2500,1
112FVoRAWNQe1Xk6sFcc77eWbZhtpKtvDk,FALSE,66575,66575,0,2
1122dnuWPd4Svky6RfhxsSQTA2i5hn9ZmX,FALSE,30766576,37762268,6995692,10
111112BuYUNP1WSguVMswhVQJGXm2auEw,FALSE,657261567,657269441,7874,458
1127dsufnejgCobSXf7gotDeQKcAaDj7to,FALSE,11157417,11157417,0,2
112dWA3zioUVxt2wk6SGbq14xUFPCQod2i,FALSE,117188,117188,0,2
112Z8EmsJMwECov3sv2jCKYW7Y5mqmFQnM,FALSE,0,3843,3843,1
111Gk4AKb8G8xyJ8r1eze5tB2Dms684m,FALSE,0,10980,10980,2
112d8RotcURQDVegfsCEERbR2YzzwCwsZz,FALSE,266924,266924,0,2
113DMNWD5dBTaqkak3DC6RzKJsiphWegoh,FALSE,0,14756,14756,1
112DZrMvCGRSd1Avhbb8PWC4yNyvXN9HSR,FALSE,0,587,587,1
113ySaEk2DDXVyMohmXzdULQARb6Vqzjk8,FALSE,2361286,2361286,0,24
113UVqKYWxTLMcadyiW7CVhUJWozeh1c9K,FALSE,1252792,1254976,2184,10
112Kwf5LsF865KAQUK7u9xQbgk2ieVAjgP,FALSE,0,10483,10483,1
113dXDv3icHeA6BPsdemK6uH68uUoJZVTR,FALSE,0,147295,147295,1
113urmwQsLFyRCjxD8mJmTg74NwYDezzGL,FALSE,4267,4267,0,2
112eDFRt6szD75fyQujysJqXTzjTtusP8x,FALSE,0,687,687,1
112VAYNEHX22a2Rmk2cAKytCYmMBXBAV4D,FALSE,435261,435262,1,3
11333VBWg2ad6SKqsXx8yLJYCMPJoPMLQK,FALSE,4382261,4382262,1,3
113S9A6HMAQPrqWTMKuDnZFJmc7m9Ziy5D,FALSE,0,20000000,20000000,1
1138zsrEzAF3Gif3vovUxPgbHy6ZQQmewX,FALSE,0,1000061,1000061,1
112w7mrv9zoapXSe7Pt8F9p6MVyNd6zjrE,FALSE,0,799833,799833,1
113G4VxACQyyCFyTKgeEsvyWymhQ4yhV57,FALSE,0,1002215,1002215,1
112SEWsCkDDkHhW1H53eZBZnB8GvVuQGrQ,FALSE,0,1002030,1002030,1
112jSMpUvUFS9cDJERZzrh42j9ssmoTVVt,FALSE,1000,1000,0,2
111111QS7uV522AseVV6Jqs7ZTb5Ewa6,FALSE,0,2730,2730,1
112HM4xDC9VwiihD9ZXBsUbYsxb1u39WaE,FALSE,0,47055,47055,1
112Y6FqfpT4z3Mot9JNJ7NoaSKAJNfSKtH,FALSE,0,16793,16793,1
112nMKSS6BmAaLyqsaE6Nmzsuqk1pqNCiS,FALSE,0,8418,8418,1
113dnHJwa3mn6WeH6No88hJzFKe8Zd7iCn,FALSE,0,995896,995896,1
113WqEc4KNCSgJP2mpk5J13yKNJKGTSgb7,FALSE,0,140456,140456,2
112eBHw3v38Fk732GEkrjZkjdksD39SgXD,FALSE,0,87948,87948,1
112hZ3JERR4PeMXsUE6XcjdhjEsUpDSvid,FALSE,0,2500,2500,1
113a5SK4iaUM96zyCjwzFnbvdKyHFtp4WH,FALSE,0,1000,1000,1
112NT5PLLZ2eGY4be7eXPcmHYUsWBvGSA4,FALSE,40661,75501,34840,6
112n2bPwWY2V9VWEen2p3Lq37pbQfpeepp,FALSE,0,40196,40196,1
112WLLcKEL2FugzBHR5gtKsuZH5frrVw3C,FALSE,0,212076,212076,1
112LTYoFQ68DYLvKjjgjbCEWUa6HV7fbQd,FALSE,0,100244,100244,1
1137b9gaCVvsNr3JKqXxT3xy6rUPHrzjz,FALSE,0,20507,20507,1
113xUMqtpMtZW9LrLVRW7kkPdrm6dyNBCm,FALSE,0,10000,10000,1
113aE5f5xaJMPqK97no1YUmyD2vNqLNSz2,FALSE,20923293,20923293,0,3
112bmk7UjFTcAsY7kqqp6TBmAy67AeF3F5,FALSE,0,16701,16701,2
112gMjBQHtbSeEYhH1PRUKSVWCTTBBtGnH,FALSE,0,1000,1000,1
115v1Pni9Wg2dJKPY3RY7CERAimoFsRbbp,FALSE,0,808392,808392,1
115eV5NJn2yYfteokGdZzB8cELGGFfTmfa,FALSE,1115832,1115832,0,2
114hBvpcuV4Tj6W3WExPrwCGzgAnySUQuX,FALSE,3861,3861,0,2
114HTv5zTKJxHqNd4EueVqbKC41E9JSYHc,FALSE,10009346,10009346,0,2
115i4jLbYvH8x6cUusKtn35EtXNJRpneKK,FALSE,40019592,40019592,0,2
114BuJ2ogbtnshSiP3SouyzbvyPChpDwMF,FALSE,0,7550,7550,1
115PVtZa9VtoREN4KgnQTREKJS4bj5L5ru,FALSE,0,123286,123286,1
115Ekccdf8CJeV8DCm2dJdz1v4TX2P5dt2,FALSE,274627,274628,1,3
115KZexNV92JokqB7i6iqyb2q8i6hc4HBV,FALSE,1092,4914,3822,11
115cbuGqJqoTBxEMSQbCznvvmew9hXwwJL,FALSE,0,116785,116785,1
115J9hHFuRKHhs5981s2tH1K6e4KngVfos,FALSE,0,936960,936960,1
115jZgRH5HXRiVnVeTX9nkBpfaKY9gH3Dp,FALSE,0,28715,28715,1
11595fMNXwSG4xspU2h5CkNZ9AtYbz47Rw,FALSE,17449314,17449314,0,2
115KwRBBdnbZSNtqkDJVW389Uwvd9DAKs3,FALSE,657209,657209,0,2
114oNToYxGoeSMTxja4rJdedrqMFGfZ67c,FALSE,0,10000000,10000000,1
114EwGCduwWiDiYctrAfbRWkhMLTaQyvrM,FALSE,0,10933,10933,1
114FVt1FQshAerx6dKAtCcw8EGkSGhcx2y,FALSE,0,1208115,1208115,1
115rzH22ZdupZPymCGKTiLzwBd3eEoC7Bp,FALSE,0,776,776,1
114U4GaHJYMuUR5yQLtgdRy5shyxqsuaTM,FALSE,0,13840,13840,1
114c2VuoJ6kNdUJWV6xDidsJHp2vojdat2,FALSE,0,9691,9691,1
115aDGhrhcRYQmUv4CXjerYifBvzwvNTia,FALSE,0,645170,645170,1
114PyD9zFcjC7neMgsPozbPZQBV3H7J6Vf,FALSE,0,32487,32487,1
114qpDnTBQ35WNwsP4DLVAjimK7znMJrpK,FALSE,160000,161638,1638,9
1164F4xxrWDyopFzCo3gaoPiBppWF6Lbid,FALSE,0,809768,809768,1
114o6ECuCXXZp8mS4BtQtAuj9a1jbSTGjw,FALSE,1737477,3909322,2171845,7
114f5vuSH9Cyi1RenHvUspFD5yvsQuLUa1,FALSE,0,546,546,1
115iJAjS6uSbJWBtGzKFRvFVcGjRjeP9Sm,FALSE,0,2086545,2086545,1
114bLNCSW4YyD5Vi45yNCq8YokEHjRwFRN,FALSE,0,489502,489502,1
115ZSZofWNnZTGHJQ6EmfM74mjWkBSn5gs,FALSE,0,1000,1000,1
115kTgsAzgNXhZQ3YRTbkVGGhXHwGB3cPm,FALSE,0,70623,70623,1
114ST99hTQ47kUWxtncgkDATVAgj1ukanh,FALSE,0,2471670,2471670,1
115ZzEBAiW6aNhaqCQbEyeMLoUHCyRoxxo,FALSE,0,171042,171042,1
1156SA4SxH1PdfGivXEw27tHce7JA5WmAx,FALSE,0,362532,362532,1
114SgeHiikB9CXs3keDk4mocnQTwBm1zyK,FALSE,0,8758,8758,1
115mTFpbU8Z5fogUqvwrKrwFYCqctGRv9L,FALSE,0,3175,3175,1
115FZ9LHqzDbeWqgb9JBTqvHAzQsMhWtTY,FALSE,501629,1005945,504316,3
115jR2peeTUg1SFFhVKxAWpzL1jqx1Wqff,FALSE,0,1531,1531,1
115d7JanCqg8EMzMVEQfJmRXXstdnbVJL8,FALSE,0,546,546,1
114ttmqQL9NS6fE8wHrYAEAvLhRPGww9pa,FALSE,80145616,80145616,0,59
115zuNA6Gsyn4B8qZcJ2uGmSFNvNC6yQGg,FALSE,0,28404,28404,1
114NuC2boVMnXunPW6mB2JxB4jgvxjnhPU,FALSE,32131,32131,0,2
114GTj1tmf5NDMkvrvEurtKiARV14TSgK7,FALSE,163420,163420,0,2
114X49y1Rsqvshe4N5c3pMYkuLaXqnuput,FALSE,0,709484,709484,1
114xzL47kBLg8MqF54KU232k3868WnjmBD,FALSE,198480796,198580000,99204,4
115oGDMqz22Yrt6tBo1egUckAnJWLMCAN3,FALSE,0,478920,478920,1
115sWnPvx6yfv7n8g66V94fuUpyiTRnmNH,FALSE,0,24489,24489,1
1168R7wudV4CSX4dDUJC4SGkWMAEM1vswY,FALSE,0,337764,337764,1
114TPhsPTyAnw5r9byTkwvJAdsr5iDwUb5,FALSE,349980,349980,0,2
115GrcueEJfGwpE1H9yKXp8C69mH2hk39p,FALSE,0,61335,61335,1
114X722sxktaGAExJQ8GexQh54ZN99Hs2e,FALSE,0,500000,500000,1
115pi3iWTZ9BYXYPNCQDK2Meg9n9DijMhb,FALSE,0,1646930,1646930,1
115BVqyk9cNVDb7YB9FsuThEPPXo6dH7m5,FALSE,2890000,2905462,15462,3
114wnudUcCTt3HBnKiPHRceJZKEPxUaj2y,FALSE,0,4418,4418,1
115KMAfVxfBzfENU4afEqTPfLQfAAcKafY,FALSE,0,817,817,1
115s1hjXhBmr2QppoqTGxsGhZzsuyXebaB,FALSE,0,7291,7291,1
114PPFQhJ3yCuFhQSAK5dAZZg7WYKJGHKF,FALSE,1092,2730,1638,7
1148hzcoMEDR7vaHJtGPuNr5SQcjRi2G94,FALSE,1459600,1465800,6200,4
115y7VPzFdjjoWe5qpDm13mxKAEBBYvsig,FALSE,0,291070,291070,1
115fcCj1LmTnu1Xc41YJ5Jg7PvZD4L7GnG,FALSE,118860,118860,0,2
114eSZeYGYKzkSXBTLSvj8PWtD3irBxqCC,FALSE,0,112500,112500,2
115VmaAATj7Wg3RW9pf97JJrQcpAZpNRo2,FALSE,160000,160546,546,6
114erzrofwczTtz1BjkYQgaJkeakZT4Kub,FALSE,0,5560,5560,3
114eijStjtTMwi7V2k1rD6jhcovNQewSiP,FALSE,0,546,546,1
114nvMLv1Xagpvhbk8m2SrpxhzTWxSQGyx,FALSE,318574,318574,0,4
115HE3ceCJxQN1LVQhFFuiiD6cBNiWFtHK,FALSE,0,2066,2066,1
1163DJUWQMLU15PvmiB3vzEQrhC9K1ZsET,FALSE,0,2500,2500,1
115bLsQa6vs6cJnVUr3vZYPzjComfMeYvM,FALSE,375404544,375404544,0,2
114VhF7eWZ3PVuc2VQzm4mu6aEFt1khV3L,FALSE,50000,50546,546,4
115YCrDDBoniZEViTMz4QAdYaBRYVRvv4z,FALSE,0,8250,8250,1
114MhgSWjqt1U15FDCG59xG62XFd9Q1NF8,FALSE,0,70336,70336,1
114UGofuBnt5rQw2ex3xi8nLD83cpaFDiT,FALSE,0,50900,50900,1
115DGJgeDQYpAcPoh47FTp6q7Fx7haQ9Ar,FALSE,0,47785,47785,5
115KnkrvnnS7zkTF5zqTL1YnqGtCfoLN9v,FALSE,0,46827,46827,1
114LD6oVeLmyN5YnjiyjrC1CKNYzRrTYAw,FALSE,0,201950,201950,1
114UfDyoPQL8AW7zwBiu6adNao4uCUTHMu,FALSE,0,556,556,1
115s9KqBZUuqpuRvBuwXc3JtRm3YXA6wfL,FALSE,24881,24881,0,2
114dawNqREcofLAxq47R1XcPfRSsAb7jJt,FALSE,24312003,26078086,1766083,109
115QJwaEw58Rqv1QU2q3Nih9mzpdwR6dYF,FALSE,0,943,943,1
114WnUNS81B33FcaKbL9bs4d1ZXUC5vW1v,FALSE,0,108322,108322,1
1153DJaxMv6t7QE9MJ3o3sBCL57zmoqZca,FALSE,0,375453,375453,1
115WY1A3BbirRh8WJZVGyimHSxSx4CW4QT,FALSE,575000000,575100002,100002,5
1145BZbwWnN5tDEFoWSFaHG6KdnSnpUHFT,FALSE,0,4812,4812,1
1168vxStoTWCHrxsJcWJwy5wC7TzcTDyNr,FALSE,0,1800000,1800000,2
115QrjE29T6g6MHgmiVbrUfs7gNQAoUM6q,FALSE,0,139272,139272,1
115y6CEbJWKbHW5dUixNWFPnZTuq95WDob,FALSE,0,29003,29003,12
114qq2n18n1MYL1GKo5VZaS4hdTfKciLeV,FALSE,0,5362,5362,1
11661uBUYuZboSVvy7wXmHWoweckzQ1K4c,FALSE,0,575687,575687,1
1167VNEXaG1p9dKdewa4mmCcMihtoCKqRj,FALSE,0,8291,8291,1
1144nj2ixZS72Tb5t7ub9rDP62ggeMRNrg,FALSE,0,9619000,9619000,1
1156m2otRqdS1hFxpMHXe4tZT52ieXNxit,FALSE,805566,805566,0,2
115YQyTm6G7rrA6aWVARmVtzJKvntAgzKb,FALSE,14750000,16365000,1615000,5
1155S5oJGBSsbLYdRRiFYgn9pCiapHqkTY,FALSE,5021781,5021781,0,2
115NhN7CuCVypwGD3kbr4qvRZ9uKaewH6z,FALSE,0,10000000,10000000,1
115jouLVbgwz2RPukMAjihwypTohMZDXW4,FALSE,0,54372,54372,2
114HjdGuD7VnPLsEBy8JQ9dkYn6zZw1bfo,FALSE,0,1964,1964,1
114rZUZMU7byTTQKsN8F1cNsGAzwZCMTh2,FALSE,0,5000,5000,1
115DcgE27wJ2KsyQq4Bxw7sukCVGZLLvU,FALSE,0,743041,743041,1
114ZBwnB6xNsYmComWGXvsS8u9pKYJ4TYy,FALSE,723000,723000,0,2
1141xurnBkTh45SXRDgr8irSYRENvv4vi9,FALSE,450000,460000,10000,4
115oaUpKc4MZWN3rx7JJW3DWYmXNuchRCm,FALSE,0,356007,356007,2
114J4KdUbbaJwaUddAAGrSbg3kK44e6ykj,FALSE,0,916275,916275,1
1164af9VMboYoW7MUHGkNQBznYHWgwurSu,FALSE,0,1884800,1884800,1
115tbXcC5ivgmrVeMo9Hrx6KA68zThWp5k,FALSE,0,205070,205070,1
114YaBdBb4r9c8mXPzx6DfAmkKnmRc9dVe,FALSE,0,30050,30050,2
114p5uR3dmssvjmJXLdDYfnQAscqkv8gKv,FALSE,0,355467,355467,1
114APeGKGVvFGiFEsAQtCeRzBMRcBYhPdJ,FALSE,76355,76355,0,2
114o6UjpWKgGWCQFq2xyhcWCrXSBHbBZZW,FALSE,0,132636000,132636000,2
115g4ouWEad8zRMogfDEFgMWf6ajT2LCWu,FALSE,0,596966,596966,2
1146TCf9xBPsTcmFWxVyeUXmHgCJ1fMyPm,FALSE,0,585200,585200,1
115Rn4wfmVCTfmGiiK14Dgh8uGKV3h3y9E,FALSE,0,28265,28265,1
115gEBrbDjfgMd7uhKy6qwH4sPLmoa7Aij,FALSE,0,2557,2557,1
114fjnRLJxobYzg6pQyTJgKnYNp5CWbpX4,FALSE,0,9219715,9219715,1
114dTRx8wDFNVqhXjEA8g597o6iMtE85uS,FALSE,0,172937,172937,1
1155V5YWMfLUHCCkAuDgiHiaL14NJQ8NZd,FALSE,0,634,634,1
1141upwraMnK59r8U99ZDpS2QqSjTwNn6R,FALSE,0,704,704,1
115yoyBjBvkExvm19snu9VX6GYzSaWRYne,FALSE,0,32021,32021,1
1167ZqFTgBjronwW7apyqHunPW75HjFQCK,FALSE,0,10503708,10503708,1
114FDUv5DB2jyPDo5Netm4FopJr4hGG18g,FALSE,0,12330,12330,1
114RaNcWzaXCmXdYV7YccJMZsA8r4T26Lj,FALSE,438914,735842,296928,4
1142C6qieD74HBvT2M2ZGzcPGai9bKwjyR,FALSE,0,2172637,2172637,1
114MsN6BBTQAyPy6f4kuD6ot3g7G9hBbU2,FALSE,0,7156,7156,1
115ixjy7AZShA3mouMtnLFUfgw9W5s5HCs,FALSE,0,629353,629353,1
115g1AzUqD49azNmcfA8ywiHGY625NiyEy,FALSE,1490000,1490000,0,2
115QTdMefxzVqswhJmTQAfJpcJkSaijzPb,FALSE,0,10399,10399,1
115ZkyjFE45r1dkQkptC3PPQVwsBzd2rKy,FALSE,0,30103,30103,1
114MaodGvjHLgyrvvg794X1b1PdW5wYDv6,FALSE,92274,92274,0,2
114kaSBrzv7iypG7WfwXgdwUTZWJQKaLoF,FALSE,0,31338300,31338300,2
115Y3CDFsLYseS56woNukWSnMfBEXvaLRE,FALSE,13000,19000,6000,4
115MjGxqnhBthb4mCqPL6cNbyDwTKQ6hfm,FALSE,0,1467,1467,1
1164ZpkQYPo6iNAUHYikogKMqhHVwJMbq3,FALSE,0,200195,200195,2
1152pYj99Dm8bdLZTghy3vzScP9ZGfWSLg,FALSE,0,141981074,141981074,316
1144kaD7q3Bmww5KB1bkoS5TcwNZQwkZSZ,FALSE,2400187,2401179,992,11
114rsES2cYTfN62t5f3wrUTMFMBwgJzDRg,FALSE,0,1946519,1946519,1
115XN32E4hZdkXcsFs97oqSme1WPGMSHNo,FALSE,7446,78946,71500,3
115YRvaAAN6C6BD6pu7EXbmP4QFPXRdnkn,FALSE,623274264,623405300,131036,31
115YBYLzk5c3YYqPA7yMQTxjGH311yurk6,FALSE,167490,197647,30157,4
1143zpas3FhSwBY3nZcjdWvfZu7cSQooYb,FALSE,0,10000,10000,1
1159rqJeo6zuKnrf3emPgwVrFVTEteXWFR,FALSE,21764312,21764313,1,5
115WEjvExfR5WM2HD37RLTHp5pKJ7LST5T,FALSE,0,16946096,16946096,1
114B4BDHGfqAKoWmxrfESJ5soFqo6jnhHH,FALSE,5783,7092,1309,4
115wJGACPgmV333sibeYFUZWe5jnn2dA5D,FALSE,171579365,176233934,4654569,32
114yn5h8BE9mcdk5BsugcNhZEhqvpYkV1P,FALSE,0,5500,5500,1
115m1ymqptFTARGyRz7A2Y2UHNoV9r6Tx1,FALSE,0,5975,5975,1
114CA2tKn9bHSMiqCRQJsaUSW8K3k7jrTB,FALSE,0,394123,394123,1
1145PaE6R4QZVtGQp57QLRAMyq1kyiqZFt,FALSE,0,34468,34468,1
114dR3tn4WQLWniD8bD1JikBaU8RZG53rx,FALSE,0,101195,101195,1
11642L4yqCkAYyB5N4k4Dy7jtkLkRZbTFi,FALSE,28938,37128,8190,121
115SAWbL3egyi8zXBBX9RAY24QXJccWWSY,FALSE,0,71670,71670,1
115hkm1nzi6ZaKqeCWfoy2kS6gnCvk1JDo,FALSE,0,795254,795254,1
1163Koj9DdJErKG2UVShJ5pfeKVGKDEJ4k,FALSE,2647,2647,0,2
115rkYC3Yzmrgb8nDGcCQUAGzcLM54qByz,FALSE,0,30136,30136,2
114reT19cTdpHq3f8J8vxVpzHX7ty9Np9E,FALSE,0,3000,3000,1
114YQd2G2o1cLDuauVxfPJnZpJdFnbA5T3,FALSE,0,3475012,3475012,1
115QzyFxupjD2jYTBmbXZ2rHBaRvMN5Xi3,FALSE,10975918,11000000,24082,3
114inuVLuK6xXpqKLpua3T9g5kAdqJ23qg,FALSE,0,600,600,1
114jU2LzSuccaoEkb6366PsfkxLAChbv9F,FALSE,0,8018,8018,1
114cix3jAAMzyqxCP76DkiCyFZN4M8EcdS,FALSE,8737855,8737855,0,2
115zcJQAaHGiKG4XKD3zw9dABZ9wMRpUdY,FALSE,0,8020,8020,1
11493Ng25BzHjP4fTZqSrbhsrUGqbNoVWs,FALSE,0,546,546,1
114fWTCrcWrV2GSY8sbW1pMVqdnNHYt9Jw,FALSE,235062,243701,8639,8
115it5smMPjsHYVSZxXUjhTCxNoJJCQ5iu,FALSE,0,5480,5480,1
115TszHZdE62zGr5bwBYbiJJLE83ht9Dss,FALSE,0,15648,15648,1
1147SweSLH2UswLGXowYyoKHkwyY23CY6h,FALSE,0,53947400,53947400,1
114rmzj6v93Y18AmKViyWxdRVX7cUNtwya,FALSE,274980850,274990427,9577,13
115XiQeD3qBSwsGSzTeZyS7bYuSEwinVCn,FALSE,0,1375500,1375500,1
114tzUQ6E492H7EqZJKRKD3yNE1LMNahih,FALSE,0,618900,618900,2
114iN2zu3kK18LYBoXGSSiZPPruBx278gS,FALSE,0,1000458,1000458,1
1141jcdALKsg5rLkwpmGM2xWLJg6eQioFb,FALSE,0,16046,16046,1
114bp78BAnoiTa9BTKH3sKJq7PwgRYntZy,FALSE,0,517834,517834,1
115NGa9iUQmqyAXbpBVf4NCZAvE9sk5DHh,FALSE,0,6000,6000,2
114EHH6ktNYMCbz8EXJfpY7DzR9warRLSr,FALSE,344178963,344698836,519873,33
1151DrCikLmdmVWzAP5asQMhxuLV3USv2y,FALSE,0,13232,13232,1
115hEA6KX2XKWNVuDLV44xwdX5RPb4WhHj,FALSE,605748,605748,0,2
115FPB5847bmycP8oBX4dtqZHNRDyFNevm,FALSE,0,148477,148477,1
115vzfCd9852ibHVjvEFpBL1RgDD5j6AH5,FALSE,546,2184,1638,4
115r74Go3ouZjFbPMnnKnAAauUCSaPziHA,FALSE,0,43795,43795,1
1148F4RQPST5YYNCUpav2xGtUR4tU5Pm6k,FALSE,0,1209,1209,1
114x8Q3YJK5M1zHfKeW5sG3Bdorvi67Zui,FALSE,0,1296800,1296800,1
115btvYoqRwhv5m11TivR2Ccj9MPwiavv3,FALSE,0,1440407,1440407,1
1151VpjZj417GgjZpe5A7KVrXJ42EEoW8u,FALSE,0,230171,230171,1
115Ui3b38nS2mTGvS8HvSpMzet3Wzp6gfL,FALSE,0,44075,44075,1
1144PsaEvHmjJ3XzEZnAwi2Uexz5R4nyG3,FALSE,0,2650100,2650100,1
114Qq7K5jGHbHgPSa3uFVZE39kZgCH5aZo,FALSE,0,1547,1547,1
115MjibDQk3GkdLudTqVPt88QngCVdRsJu,FALSE,0,14161,14161,1
114WFb1dafKfT8c46S4AjaL79oNaWGnb2J,FALSE,0,550,550,1
1146CbujBctQwF9bdDZCiGps3LtyyP2cWY,FALSE,0,996420,996420,1
1145HiFgcnk6H9raCUa7Wo5MoiPsC4m9jK,FALSE,0,5500,5500,1
115PXG2yNtYn5p1oEnJbcN98ZcBrBvv2FQ,FALSE,369200,373892,4692,2
115XWknxTHGqfGNE4rhULG9K3wvAXyaio3,FALSE,0,654,654,1
1165eLjzhm5h5redHmqwg8amwC5Dcft6UM,FALSE,0,2730,2730,1
1149UhJn8Entd3rfRCAWmBQSuyqJpF6Aes,FALSE,1146,2839,1693,5
114yn7YocvxsZ1uBLRSZzDWDCidKT7nbFx,FALSE,0,10000,10000,1
114Rdv4XcWQEV1EN7kiipCriKr6EmobUi,FALSE,0,40885,40885,1
114NwNob1MjCQxustmh8FYg9fmf4BV5Xuu,FALSE,110264,130132,19868,3
114UVTLGkub1cXbt7s1n3wnLFT7uBDdHh2,FALSE,0,1070000,1070000,1
114z755m7NVgJCk4WwqrXdQpvCvqLbxuQK,FALSE,138297,138297,0,2
115sZbNhv5GriteGGe7hx9HZbvuoY5YYM5,FALSE,0,6916,6916,1
1164DNpFNhKRxDRKWK6DYXuLB8kVvLjuKx,FALSE,3708200,3708201,1,3
115HzA5x3FAuUtSK3anxLZAnJSSYem3945,FALSE,0,342142,342142,1
114X9e9odYXfX2pe4H4ukWphVwA8RxSDCe,FALSE,39365155,39365156,1,3
115PnbbPGyC5M3f3vop6daU5VpFdKenDBL,FALSE,13792671,13882677,90006,8
115JnSdVrRKG7pk3JX4yVyEGfgB9qnJVPP,FALSE,0,47571,47571,1
114SXNz56xzAtFNHwVtJSDrrvZnyp8U24W,FALSE,0,41332,41332,1
115vfbmBUR2CAyukgqfFxqSvdmk9XXh42a,FALSE,0,2607,2607,1
114mzsSANRCPX95H6h5XMP4g1oUsgw1jiy,FALSE,0,13009331,13009331,1
115r4kcC8tLWNUmU1synz6qFJNhVfsfuqA,FALSE,7760,7760,0,2
114A6ot3zimHVfz5tYHrHP8HBFqZH7NY5w,FALSE,0,5577303,5577303,1
1152UWY7Sq4zfFu1hu4GjPggSs7apazdh3,FALSE,0,10000,10000,1
114B56asyjhcExRSTCcLk5foMQ65arQ4oU,FALSE,0,645000,645000,3
114erqZTfZqvPYwqUhRKgMoaSaTwfyGe3p,FALSE,0,4283,4283,1
116162QH9ahqWHidPPrR9H5ZefmgN4ru3q,FALSE,0,1000,1000,1
115ef7sbxS5sJksBTNGNAm2TtEdihMrHHx,FALSE,3829,500546,496717,3
115nUVvvBCHc1jbapdnEoup6Qr9phuG4KQ,FALSE,0,1053000,1053000,1
115SuuH4AxHbTKxgJW2qat5rsvdy5EnGQZ,FALSE,51000,51546,546,3
115h5Ph1THLgSnb3C7eLw313vB4v1EGCWR,FALSE,0,7550,7550,3
114Nf7cDBhDGgGGxxdpbFmM2kco9N57G2q,FALSE,559847,559847,0,2
1162RFYaSo8HGMTHM6UyYYYXrx3oTsyW8D,FALSE,3260,3260,0,2
114ThpJ9NVuWFndgiVYSJAfRctfN7MLK8u,FALSE,0,1247,1247,2
114L9TY2taiaHHkmniNhvF74V4iZTFha34,FALSE,0,24194,24194,1
115jR4gHJTX5ycimd2YkbPR1Z7AiDXmdDb,FALSE,50000,80000,30000,3
114jDYjzQKC3VmXUnCsN69wcL87xZp4rta,FALSE,0,10445,10445,1
1165J9eSDHf7np5xoHL6WdaxwtYXAnmJv,FALSE,0,677905,677905,4
1163rAYD6xPJabTRz4stCSagM2Ko76aouX,FALSE,0,1918,1918,1
117PfnjE8CDtmH7PLzkSAvAwaAm54ciSc,FALSE,162214700,162214701,1,21
115v59NpxmHvdzEaA3EsfE1aHtoiYYh3aj,FALSE,0,534003,534003,1
114aWGuxEyHwW55mT9NPZzRQnSabQEngKs,FALSE,100000000,105223400,5223400,4
114hYfbBA9yaFGq3x1vTDrHgfbbH2XwtnK,FALSE,0,318332,318332,1
1153UTMdq5JGhprFkjyw8Pb4TuYusedEWA,FALSE,0,369165,369165,1
115PE7A8vcu3gGcmgAaDXN4KdbniU88VoG,FALSE,0,18204,18204,1
11R2Wvt8D1ehQjjgr3QYeUJKaUNtHVAUQ,FALSE,0,169322,169322,1
1159f3aBiRCyYLTE33Ld7QxomcjfTYMaCZ,FALSE,0,400000,400000,2
11AgrcrsWJbM5vBzJY5fNV6tAfsB8uRYQ,FALSE,0,1800000,1800000,1
114rZpzZs3eJYTzaTFfMrJWYUseYv86qzY,FALSE,0,21128,21128,1
116H8vheMb6WJp9rLgqrLYCNHVuc22Pxb1,FALSE,0,989,989,1
115mm31WNwZGu1f76SDrQFzm7a9Kj4Q3CS,FALSE,6532,28092,21560,4
115qjkgkqGyBJTntPijosVD9y7k9bEykuG,FALSE,0,14600000,14600000,1
11536cNVuqNg3BiYj9BXr2VXFsSrZjtEnG,FALSE,8206889,8206889,0,2
114kXS6FLKpzG7MVirbSDBch41GEsvxc4y,FALSE,0,25386,25386,1
11E5LjTkutvgYdjkzYbvNPrMeH2WvATjG,FALSE,0,440000,440000,1
115rDJkKtrg7tXABwacATpWcdzJT6YSaE,FALSE,0,27518,27518,1
116GD6utfCVueNLBrYor9PXJ8cBUe3TA1c,FALSE,0,41817,41817,1
1161bgygjGaENaBdjDa9vb6L6Y14E8KaeC,FALSE,0,20303,20303,1
115SN2JD1pa86aGXUu4vXsMrm8obLMcvRa,FALSE,0,4320,4320,1
1161ck9NeNC17LZqy4cbeeJuHbx5juoDiA,FALSE,0,2481,2481,1
11RmMhRD6LAvg7vnYTP2PgdQJ2F6muQkC,FALSE,179669,179669,0,2
114dGsjGHtkjzN6d9hYyCWm5kW4TAz3Giw,FALSE,29288526,29291410,2884,12
115FyUHC1yHRJ1ktPmkMPAw7Kdi32jViho,FALSE,0,5991744,5991744,1
11CnMFRovB3WX1xZN4PCPPnxMNdkbafS6,FALSE,0,453915,453915,1
11CaopPA2UKMKgWMcbLavzn4SnZSUx1Dr,FALSE,0,85851,85851,1
114r7tE1DwRTpMpCpbfDbAFoMKP7wGr69M,FALSE,0,5660,5660,1
11AGhvRmBZZLL6osMS8H2Kafg1Vp7P18t,FALSE,35528718,35696218,167500,16
11My97eSPHrBkz6NFYuuWyt8y5gHdM8i8,FALSE,0,546,546,1
11621GyoFVfAj21zSdhGUMNyxCRCfLP58,FALSE,0,1000,1000,1
1152jszE5nvuK4Nhw88B8MLUorE6YomXp1,FALSE,0,2852,2852,1
114mpQUALCPhAsDMyG4ueyMz8d4mPX3fHa,FALSE,0,13427,13427,1
114rB4devVzy8gC7dkPLymZr3WqQ94SCHm,FALSE,1047,1047,0,2
115QBtDrDtWeNQbVjNgRta7qN2ur58BnY5,FALSE,0,3530,3530,1
115TSzogZYiqssTeNcG97UECzbrr32jDip,FALSE,4069017,4169017,100000,20
116DxasvhwTRwz15s3yLJmZBciWUs1knce,FALSE,0,595,595,1
115uncX2X51gGFBCwMip3tvQR68vDffFhq,FALSE,0,40431,40431,1
1151QK6f88WG8ZQm8MTBCnXVVBhPagFTNb,FALSE,0,133577,133577,1
114vAsi3fx6WqHdVosKJqD16xeNHaMtwLM,FALSE,0,1000,1000,1
115hFVrg1hLV8mx3T127oPE7K2R91qrRi,FALSE,1715011,1715012,1,3
115fycabJA3GyZ2HXpECWFAHkg3FsLg9YZ,FALSE,0,971667,971667,1
116zzojDfcfXQUqEwAUd4yezwexKa5boD,FALSE,0,3208,3208,1
114g7NWkB9hkbwDAHDEu7A8L3amdBX8UNp,FALSE,1268099985,1268104416,4431,2203
11K2SYahwsZhJ9B1VcwZuCrDe1BVZ2Xmx,FALSE,0,1,1,1
1164oCd9PyEhWLrBp8MXrowNPQeGKBne3k,FALSE,5242,501092,495850,4
115Azh3HWJRxfnLjr32Jk4AcXpEpPfteki,FALSE,2172783536,2172846000,62464,2
1157pHMF35A7Pk5eWxdscEpu3P2p6sur4m,FALSE,0,39607,39607,1
11652WPrym9Y7rVhZBAwtnffy5vcPQDj8L,FALSE,0,670,670,1
1157b7vGcwvvhqYNf4zh1RJWBJpxa1C4xB,FALSE,700000,700000,0,2
115b5ynhWqAEE5MrCoxKvvUCGxVwJtef8H,FALSE,0,23890,23890,7
114xNH8Yv357oQ53WcvML6DMoVTFPpPqCH,FALSE,3000,3546,546,3
115e5BZbzAL71ThoZ5RjsGL1tP8ZNj4FkV,FALSE,0,5327,5327,1
116Db6TUSMPMwMohvnwx1mJHn3adadd6PW,FALSE,0,5000,5000,1
11Nx8Q3q6AVpngygRuGwpGaY68Fa4Hgap,FALSE,1091847,1101734,9887,9
114xLeb5BQr77RFor8RhCwU5Qrm2eLKeVD,FALSE,0,358897,358897,1
115PRjTUxZkKwqAZj11pPYmBD8CvUZ1kLj,FALSE,0,27122,27122,1
115AV39s7jxNEfZdmX2xDubYAZh9m98E8a,FALSE,0,75690,75690,1
115VfKBTyYz8TdiT5aakEEWJPXh141Rr8c,FALSE,0,6010,6010,1
115qxGoQKQZWdacUJ1U6FKkwDwzrBcShsS,FALSE,0,21706,21706,1
114n4YFBpY3pwzPJL36qMuYvquF3oYNDPi,FALSE,0,4311,4311,1
115fAATqwqy5NJBwDhn9PFrbVdGptjFDnC,FALSE,0,220000,220000,1
114x2XN28fLBoKqZ9qQZfvzvV3oDBN53Uk,FALSE,162982,186321,23339,3
116EzVZpGVVFwmeyuAVHf98cigTa23a7bC,FALSE,1242260,1250000,7740,9
116HAhY4Pv1QQQe4ayHGLFdmh1htGyVDUK,FALSE,0,273765,273765,1
115qVQFy9uGD2bSZeZHSxVtsTiJdJuTXNP,FALSE,5100000,5742705,642705,4
115TJt5UJHXdPMeGeQn1BPezpnjnzF41CC,FALSE,0,250000,250000,1
115RX7sPnf1VRJwLWJYEFtdEn6gq7b2Asq,FALSE,0,1759,1759,1
11QLwPKiNccdxVDRe615DTm8TVyKNowMC,FALSE,0,144258,144258,1
1166MrvqF96yK5sGNJseCmLBpH6RCEhCM8,FALSE,0,16390,16390,1
115EHNrERjg9qM2JRFa1eqfcovXgnvd7Dc,FALSE,1515119,1515119,0,2
1159Go6iASaWfNqVmPgh936e889L5Eaikm,FALSE,0,3600,3600,1
115ssHX5qjp33ZHHpS6jJ6gHDWmqXyzQvM,FALSE,0,6692985,6692985,3
11616ePhjFbUscR3QF2GNKbjpf2vcRXTsK,FALSE,0,1014,1014,1
115JVypgYci4G1DZ6aGmZCcabsGoh7DvX9,FALSE,9553,501092,491539,4
115TcLj1foGRkz6iegHF9XP9pcjmVmbHz7,FALSE,0,8008,8008,1
116CymWXvb6JMJzzxReupcbYFZwoRbJywe,FALSE,0,641100,641100,1
115xjQfirgRzsYhd1kw822vSyw2mjP7Z5s,FALSE,0,766750,766750,1
115b9b2DJzP5Hb8e1ZKXW7JUpkFNBPvuDi,FALSE,0,56140,56140,1
114ZEYuNXxq9snapbqy4Rg5jXqDabt3aJH,FALSE,62735,63906,1171,5
115mjV9D5MpX2SPzPGKCwE7evfQzd56228,FALSE,0,3081310,3081310,1
114dDjMA3zUAofxgFww2DfmLkUcM9cSj7Z,FALSE,0,9999920547,9999920547,3
114sfGCRU16EQBURSZ8atY4ynkgFyq8QyN,FALSE,330800000,330800001,1,3
114kFrx6BUcb1Dp94EUBFKmfnm2nVa59Z4,FALSE,133792,1008092,874300,3
115LRTLEp5SMnULwJFC5QqfnD6zxAsqJRm,FALSE,0,10000,10000,1
117oen5rgheZHuDgeaAvwttCEDfCUAi2U,FALSE,0,5295,5295,1
114gUXsXAWiMTSmF8hVtkWyEnEbrDTBogn,FALSE,2973117,2980272,7155,12
115YxFt9QCYnK8gY2h6AcP6esoSMRm1RPx,FALSE,0,197393,197393,1
118tSB1NnDBB1A58RfhPoHrEcuzMyEqy6,FALSE,703321,703321,0,2
115kuGqP4qqJhdbJLDPeof51khDJH8BP2W,FALSE,0,708,708,1
114og3m7UFATkaExgpE8bxQWbAGneN7jrE,FALSE,0,1934,1934,1
114s9wWY8sbod2o9jpn3bfgGpLGooA5Ygw,FALSE,8187744,8187744,0,2
115kc99yfbnJmXuemUEkJKneu8oqA7fFtL,FALSE,0,17473,17473,1
115bthBXVvHPLMxiQ4jCECfrkCtMGohazi,FALSE,0,106690,106690,1
114ZCh6QP8uDBhMydPcobvQX7XrWqtiekB,FALSE,0,152839,152839,1
11MNPFKjaXYHLFdNjDt9NED63zmeGQvVR,FALSE,0,17160,17160,1
114u7GKUMHAhzYXzscKgXuafJXTKER9YqH,FALSE,490001,495626,5625,3
11N4voXDWaWAPrZg3te8GGQBqpM7F76GQ,FALSE,903,903,0,2
115weTAdFkpCmrLbuAQdFepB6WdXAvomVv,FALSE,0,96993,96993,1
114dy9GETPwurC6DNfjyMLs7AzoUuLe6dZ,FALSE,0,520310,520310,1
115GQiYq7JdeSR5sdZjrd2jsQNmPRkJJke,FALSE,21960319,23303000,1342681,2
115iD2Wa2ecCjYsQhLUZEms7EEKKiWuFFV,FALSE,3634096,3634096,0,2
1162qbsKuFucq2uF5cwKCm5XUH7pNZkqzP,FALSE,0,136953,136953,1
119QKuQwYxeAVjpqeb7swuciB1md7KHBD,FALSE,0,5668,5668,1
11MqAqaej2yXagyis5v3wRhu3uEgSgpn8,FALSE,0,6480,6480,2
116CYYCFdCZKDcpqBM24q8dTbY5So7TjeD,FALSE,0,473475,473475,20
116CS6wPWcVg13XuVrwCBPzwep2iGdxecR,FALSE,52576,52576,0,2
1155qgKTznzV16ziSyTWa7hiRBttj9hYpv,FALSE,2814101995,2814108336,6341,87
11B7o9cZew3EKY7LEYVvKJNti4dxTcesK,FALSE,0,2500,2500,1
115R7o6TdD2HRxLgazacgxdmBRgsvBigJx,FALSE,0,6275,6275,4
114mi6ZiEFEUvqkU2p8aeSKppaiJ6zG9pt,FALSE,0,18087,18087,1
11653mxqFR592DuLbxDWk1hzBS1wJkn1RN,FALSE,147460,147460,0,2
116EUmYwMRDuetx9GQmDKoSwEQfTbqh3im,FALSE,0,17543,17543,1
115mDfbBVii2N59pwXq6kupdNnwNCsQ7er,FALSE,118864,118864,0,2
11CxE383VoY5fmf8JaNayY2zT95fN9WkS,FALSE,11055890,11087945,32055,3
11PPDU16P4giQz1er8JScBrruepmFbCwZ,FALSE,0,23820,23820,1
115qha4feTtvAhELqcRKYjpYCSDsPWF31r,FALSE,0,8310,8310,1
1168v1b8DyR63wWt9aDDLBgWuLZaozUGua,FALSE,0,4354,4354,1
115fydJUxL8MHq4fhdU12u6wXbY3YBJh6U,FALSE,0,1000,1000,1
115bWmV5PPhcMv5N1ymBGG1UQnpY3c7vC9,FALSE,3000000,3534046,534046,4
11Jjgknd1sdQ7k8sS2T8rxkR2NYcwBWX3,FALSE,5748479,5931673,183194,13
1164HBvHBdQwoStUE6CsXvMWM8FgPGNeYT,FALSE,1092,2184,1092,6
115VL4Hn9pEpiqPZjmZ6zJ2JMRrK4ELajX,FALSE,0,55479,55479,1
117YKWVv8QhRDFpU5Ffnp9HCA9j7y5EbP,FALSE,0,306800,306800,1
117AsjsYjzBcA66KEL2vzNfquF4dAXViw,FALSE,0,1485475,1485475,1
115ys2LQjCM465N5SYofaVQZWiqEpG2JVv,FALSE,0,61578,61578,1
115oWDaQqGb4LCgN3LfHJLK1bKcRqw9a9B,FALSE,0,522913,522913,1
11RJhdoKeCp4K9T5K7s5LroZRJriUF9Lr,FALSE,0,20215,20215,1
1155YWRGdogusbH9xyR4J3cmMN2SktFSTx,FALSE,546,2184,1638,5
115SBHTWTmUv3aNdc5QsVmZwoaRF55d81f,FALSE,65310,65310,0,2
115bJJDBBT3eonLwVev6Poh6AY1trakHTe,FALSE,0,579,579,1
115eyMzd6HeLoaPcwXAnvPWM2vPGH1cwCa,FALSE,0,27681,27681,1
115HnUU1FMCy8eRrz1LkDbmEFeJF8GkpLL,FALSE,0,672,672,1
114nXbnQbsUSp7q5akkV1qo8pjMdD88mQj,FALSE,0,6159,6159,1
115isT63Ay6vBv8YK49R2qXUrjZGVdYanC,FALSE,0,160315,160315,6
1163Fq7o3q8nkvtHnGyqvmR1MexNWMz4Ef,FALSE,954900,1118242,163342,3
11MyFz5JShqBAxCeWZrJBGdDEEb2ouk87,FALSE,0,40477,40477,1
115gvWDbbUq5SSfo9wXTpcCpCsqNcWm1Sm,FALSE,0,5957,5957,1
115uuJuSt7F92Gf1voESSNK7HBDPvUfeTG,FALSE,0,7113,7113,1
115pG9CQ6CpuT8DH3gb7eEqJeV94XKjuhZ,FALSE,0,55870,55870,1
11MH8DFSSYirsUqwcyTEenzcbsJ6xRuuE,FALSE,119360000,119360002,2,12
115Yby8hzL6Q3qYXWskzkPcPs8qGdry5tT,FALSE,0,341038,341038,1
115TGQaVTuxBQfCkPgiv1uGhChet3YNCjD,FALSE,534300,534300,0,2
115QE7fbnaLLgVoMsCRtbpDnCP2RRmmfvx,FALSE,0,26710,26710,1
11HPt7fVEsW6DphGbXwUDqXCjPkf4mLAj,FALSE,0,53213,53213,1
116Chq2yAhzjWVRC4j8ToCeyt1J2eGHMAZ,FALSE,47420,47420,0,2
115bZQV8fZ8RGhcchJ7gp2aXCKN4Bb71p4,FALSE,0,34008,34008,2
115cpPNxjMrWxDRo7v8YSUtH2HrviqR2SL,FALSE,274482,274482,0,2
1156MkBEsvWiy8xazTUJQg5HV1FCuoVgXG,FALSE,0,3827,3827,1
114kch4JU13JRp7gfza3e3DGXR2yxv5YYV,FALSE,0,91131,91131,1
115duGV8ZR9kc5eHALUmHjeNNZppzRBn6a,FALSE,0,1000,1000,1
115NumC5sMxfqYmEt6Y4mvm9Y3rg2phgWV,FALSE,0,6960,6960,2
115ddeaJWGP1DMS9Bx4N8cHC72H5A1JCBK,FALSE,0,5310,5310,1
115BuZTDLFPmnGSUxSHQi7gfeAp4UA3Xg4,FALSE,44184,46368,2184,23
115SMJ8poUbc9dgdffuMki9rxM1xgcEdQv,FALSE,3000,3546,546,3
115YdoYFmFmEdwgJercSriWV4vwHRtnxTs,FALSE,0,70815,70815,1
11FfUywRcHwagRJMf7FrZ8JSw85eGhgLD,FALSE,0,8225,8225,1
114zyKonEdRuFJqqjYE9XE8jbbs9ww3szn,FALSE,0,37038,37038,1
114Z2syYQkwSxmAehchtV7krykWpsX9hW4,FALSE,0,9282,9282,1
114xED6tpiEWondUCZFwKv46K4UhphmxRf,FALSE,2370103,2551089,180986,21
115KFT6xLuiUQfBTGV6fwfieoVgSbrLvzs,FALSE,0,39219,39219,4
11EpEAfTNZh2tJsqWyEQjRw4TjFfX5rZh,FALSE,0,958,958,1
114dUt1d1hi5tXfkMr5wDbeJm6QdbZp3ju,FALSE,29300,30546,1246,3
115pVCt82gqHWxWehDNTTS1SThCCKojGEx,FALSE,0,42880,42880,1
114zX5iuN3FHKw5ycK1UwGDJWC7UYWny7b,FALSE,0,25000000,25000000,1
114gaTbxiM85gvNZMmAgnADXiMTwBhrYgy,FALSE,0,26115,26115,1
115ADN3h1FRLgowmeB2tpCk2GcwKWZvjWk,FALSE,0,12035723,12035723,1
1163vyZ17qU5dx9hsRuTQq3JJbtGFfhm6i,FALSE,0,546,546,1
114wE384v5Xj8sAkTpZmPCjMjubdzcnXWU,FALSE,115119,115119,0,2
1157wr8CaTuhn7GRgv24jSpN1ha8QRRc8S,FALSE,0,65790000,65790000,1
11RzGpd1EmMuSZR9mhKEVLAVAj98NLt8h,FALSE,0,1092,1092,2
114goQZAAnrt9x6JycLaF4wCoZjk1xbCvj,FALSE,0,10000,10000,1
114o7BtT4oCKwtDxX8hqFbVZJxzuMZs3CP,FALSE,0,11164,11164,1
1153g7czFFbuicYH9wHqmsPTNfZKK3EbB5,FALSE,0,349211,349211,13
115SC1Q1LZGcmqimB5ikTriuNjR7ZhZsxZ,FALSE,0,292154,292154,1
1154aPkaCG6hF8qm72v8zhWtbJgr9hWvdF,FALSE,0,435673,435673,1
115BzVUwe6Rhw7dtsxQRcGYyCspz6jcHUo,FALSE,0,6065,6065,1
11A3Nxruw2RtaE9pwd9TJ8qrQvMLBmP96,FALSE,0,9390594,9390594,1
1162gsVuNT9UooLYTEabmdzELwn5W8ur4B,FALSE,0,704,704,1
115S7aV97T9xFPPqWmBsyeSezGVrPXCoHJ,FALSE,0,2000,2000,1
115duHuZ5QgnJKZ79G1FA86NQMaNycZxg4,FALSE,40546,41092,546,3
115dSq3xomYtFAU8JqX5WnsQrZPvPxCavV,FALSE,0,883413,883413,1
115JoLj1sEX79aSvmHdpmbuoJxksDN1Voi,FALSE,0,650,650,1
115WorVHXJ2cWPNjqNEodoxp4jd9MXxGRR,FALSE,0,31650,31650,1
115AKot6sPJfDEPaUuJwHPeniR3p8hmbVw,FALSE,0,2089,2089,1
114aJhU6GfxhTvFy7uPJZxafXCop7fmUtz,FALSE,674694,674694,0,5
1152brnNqaB7o4TsNHM6Edni7TnHLKhSpc,FALSE,290804,290804,0,2
1158TH11AoGhAZT9iNB33CQy99XSaJwjtV,FALSE,0,18233,18233,1
115PWsocpxJn3zpYmfS1NqzRHZ8ngMrgi8,FALSE,0,576800,576800,1
115YiNdaHVoK3JHQGorXFCK83MiN2oeJDD,FALSE,0,28644,28644,1
114pLyYhkBKHcAakz634WWkjXmMW6eCdXR,FALSE,0,9798,9798,1
1167ztpLYZefQ2WNS8YZSLjBkthAos3H5s,FALSE,0,195005,195005,1
115zkz6Xu6KXRArDAvc4UtAFBBkceDXzaD,FALSE,0,438000,438000,1
114aYr37skUL4SGXgT1GANeCr7oGJvGfBY,FALSE,0,548,548,1
114ZJTYH9fT69DQ5Z7jALqoVdrFmh4F5uT,FALSE,0,8195,8195,1
115dz47RA49NoVz497NC5Q1ZWazqfzNT7x,FALSE,2399,501092,498693,5
115mNoE9KXJpdv8Eot6ZmQcf69tHsb6qHU,FALSE,0,546,546,1
11685gHrdoWuMdDkSBeBLsWhAY7khbGZYX,FALSE,0,38181,38181,1
1153csf8xMM6ZTP7pRMMNqA1QqqDCeSbe6,FALSE,2637900,2637900,0,2
116ABvYxzjBkcSx1uyN2PRVX8ZPQmrFV9h,FALSE,0,235801,235801,1
11QRNS1fa6xPYrPULoUk8yG4foLU1CDms,FALSE,0,900812,900812,1
1154Ud1CijAjRoTjXsVsgqJLQ12w147czD,FALSE,0,917000,917000,1
114ZDEXMVY45n8RZeFSZtRHD2PCsMZxjBv,FALSE,0,67515,67515,1
114maWkpVgoykCRvbxWum9CW1F5RPEjNqa,FALSE,0,546,546,1
115JL9ZPTpCw4u1wUcMLBsse5ZPpQz1Sjz,FALSE,0,779620,779620,1
114zRfzcDyYrhmsiWjeFpHAiDmcw8DnGSe,FALSE,0,16605246,16605246,1
11FfEhKSNgpNSbohrjfc2g5s26iL2zC7n,FALSE,0,173000,173000,1
114ws1WmTymXzaehEe8RmkYzUjJ5oVbu5E,FALSE,0,15323,15323,1
115HzLgF7Z3p2VpaqrA9KxbP6PqxYvJWpk,FALSE,0,2011,2011,1
115pcKRGpiYsP3sN3hGBzYRRVR3uXRoKQQ,FALSE,947830,950000,2170,2
114vkXQNnzbFrWamWvZL7BfFKg7WgMWM8f,FALSE,0,3077,3077,1
1151oLCfFoy9RH1YuX4i8RhKwJzkgfhagi,FALSE,0,23597,23597,4
115moYYRDo4dqZiqsZywzve1Tt3QSU4mun,FALSE,0,1000009,1000009,1
114bLamMo8ftKXTC9LgrxRwmJNj2aaoiei,FALSE,0,4229785,4229785,1
11RNnRqN5WMkMkcMyb2ZEdv2Axp14brwh,FALSE,3962756,4015250,52494,4
115EpsBSKYYgYUM2Vhf8ijwqKoiV4WAMMG,FALSE,0,3445000,3445000,17
11CxuPyBGtRsAJugs6C6UTFERTyDy9u4X,FALSE,1583709,1583710,1,3
1159LfcWcDe27Z6xf97huBPfRTxso4Bhk6,FALSE,0,600,600,1
115x2ZnXAefNYkL2fXNSsX7c37WzgeNQBS,FALSE,0,6825,6825,1
114tG2JHfbRsJGsc9AiboedTNztZEoN9Gb,FALSE,0,10000000,10000000,1
11QkSZ1qvtQZPDqQTLtWBN1mxadZ5duki,FALSE,0,1126,1126,1
114fYuBvicP6mNHshHJo656tnJPdXiZJwt,FALSE,3798892,3798892,0,2
115drB5sv4VfDqU1FoKJfkhwnJcABb2ExP,FALSE,16514,20546,4032,4
11NsD9SrPJA8gvVHJqjjZabaGy9necJ6y,FALSE,0,15467,15467,1
119XwEPTryyc5QUo4iHfgyvtJ7aLXX2Y7,FALSE,0,1,1,1
115bShRbcsuqupnQv3DAqSHLxU7yrSREFn,FALSE,44240916,44240916,0,2
115ntY446LG1Sw4E9EsGBU8NGihPBMXsy3,FALSE,0,200469,200469,1
1169eZmZcCa9559HeDTvFhT5hhCcUWMZqc,FALSE,546,50546,50000,2
11L77npsmWPFCFbUB6LBDFie9eZ7KKJLm,FALSE,26118,28638,2520,6
114jEVyqAAGeKcS5T4biTo461hQty8UCFL,FALSE,0,76770,76770,1
11676U3J4sbyr9YUbHtTFB5ybfLLE3oA32,FALSE,16498,500546,484048,3
115eVETRFWXVwqhxQg2TFu6GrbvNWGEAvd,FALSE,0,256905,256905,1
114gteVi3JHMmXQRbb4mjaM8hfb8sjDxo7,FALSE,4984600,5000000,15400,2
115Xe2jDnpxWzqmjD3q9VNCZm6W1YdMo7K,FALSE,534359999,534359999,0,2
115cy897NAcxHHWcT1rfxaiUuwZSq1CxyB,FALSE,0,724,724,1
114rzRSSBcs5cu5XPA3kSyE4D3g8JJ41Hi,FALSE,0,610000,610000,1
11N5HvYqH9NceqnvTK97UWhxaS2JEubCn,FALSE,0,26704,26704,1
115UDcoA71fFoBoi7hXqQrdoEV2Skp2AVF,FALSE,0,70353,70353,1
115HdL7dZ4EDFbLTd7EV1KebDbNfJcinjF,FALSE,56278920,56278923,3,5
115bjBdtbTivfRW6LjufLj1RyntaGGUCJg,FALSE,0,548,548,1
11q8hvTQrFE5iAEPRGfhsYFxxn8XXmChb,FALSE,40546,104368,63822,10
1167Q21gAKAnSVEuiG83Vb9uhnE83uzy68,FALSE,46515,46515,0,2
116BXH5JZoxJppYtbvdvjTr6oyhsqqkQcz,FALSE,463561,463561,0,2
115QdSjUg2dsE48nY2ySAuNo32kRR1Q1kv,FALSE,0,470000,470000,1
116GVLpzRxDtq2ABNziWkjxrffWgduodzA,FALSE,0,110261,110261,1
11fYu18qbAH8AR9uxWW3e99BRrTsgaoHW,FALSE,0,327323,327323,1
116B2GGTURgS6fgFZjBupbFkTyLrWWrMQ7,FALSE,0,998133,998133,1
115vj9T22PKUKuZBpoDyd8L7zSgeF3GBnB,FALSE,0,5500,5500,1
11t1HEKMfDsePqoGjyfwhnAejpvDr6VEs,FALSE,0,1760,1760,1
115FRXb8Xe3KasVcS7j5h3514npxNXy4rj,FALSE,208310,226965,18655,20
1166ELvXhKmf4gq4SzpwqdKBUUbXYEnwjr,FALSE,0,140600,140600,1
1156hc4dHuFHvMAQsSoACUZvj6nTcUarfe,FALSE,0,199950000,199950000,1
115QaFw6gG9FcYnxp6f7Adj5tCLJWHk9ZD,FALSE,2539907,2539907,0,2
11VMrUd7rTYVetg5487xMhSMmuS5p4Syg,FALSE,8543469,8679049,135580,2
117apT6NYxZohVUTvrnMdBtfAbijTHhN5,FALSE,0,1,1,1
115iQhHV7FSvG25ARNevKJ9LGJ4HLWunBW,FALSE,0,1537190,1537190,1
115xuAAkYsHcS1L8hoNAta5bExYRtVqt4p,FALSE,0,1001227,1001227,1
11Nk9Viir4hzyi4LvzPfkqDza5txPWCSD,FALSE,0,546,546,1
11THYWc9MVS9x6WzSDWMmzAdSp8RoEW8w,FALSE,0,22000,22000,1
115QKKfnbgLq9VtcMWstPK5MFeBSPEcYsj,FALSE,0,185955,185955,1
11WJmjXi75A5AoJFhn7sYB3EzBeZWSUU6,FALSE,21976,21976,0,2
115QqF952fkHQYsVEuzWBgJox2myVo5knF,FALSE,40000000,40000000,0,3
11o2xzZgcAhKQtd8RUjVhPgTRWqALXpD9,FALSE,0,64191,64191,5
11P8hRzjxUoQTApfxCvpt9C2nXWBJmSbF,FALSE,0,97491069,97491069,1
11kKkugQqMQtmCfZcWYRDAYMAWSN1N9uu,FALSE,0,1000,1000,1
115MHgpRHMBSPYs2E79vnb34y7xhh1bZhp,FALSE,546,1092,546,3
116FB4jV7ZwFCcfsNU7Z7tWNrieak8CxjW,FALSE,0,546,546,1
115gTNEfiJ2DmhrTXUTFvUK71PW5GPYMdw,FALSE,115602,115602,0,2
115VjSWKeMsXNGbwjcmaqqtNzM3br1SKhT,FALSE,0,10000000,10000000,1
118DUrwxcCW81XZev16TW7bSF9ahvfAsJ,FALSE,0,1000132,1000132,1
118zpx1isfSwq2RdATUqyhddUq9oqgSvP,FALSE,0,16360,16360,1
11s4iVnVWDMM4dcNrzLnCRLU1rSTCADAL,FALSE,244750000,244750001,1,3
115N5kLMNdAVJPELzYwSEcixSzztaBoiFs,FALSE,5015011,5015611,600,28
11uMD8bguawvZsZ7SjV9Zpn5nVhCesDt5,FALSE,836051,836051,0,2
11fzS8UcMHLiTJG31cvzYoC3ipsER6m1w,FALSE,848840,1044806,195966,3
11Fh79czsQbHYPfjoJBVLafgwivjhc2QR,FALSE,0,5000000,5000000,1
115fHUDAQmPmqVVdyg5p5776VowMs3buim,FALSE,0,331830,331830,1
11ArcuFermentumSedVivamusXXV4ECV6,FALSE,0,2,2,1
115Rg6gjyiT4Kr36UQoeJaQqfGKAAMLCca,FALSE,25435636,25436443,807,75
11vKT27SMYJLdepdbA9kCVBtSie2cCB4D,FALSE,0,10490,10490,1
11H3tQ9E9wg6wdGGBQtvbBFs92ADc6mEN,FALSE,1140260,1190260,50000,3
11ConsecteturAdipiscingE1itYQHEPM,FALSE,0,2,2,1
115phfYzskJV7ZqshDEQELsxtEhqHYH8qy,FALSE,0,1260811,1260811,1
11TKVestiarioBestDresses1111okbAo,FALSE,0,600,600,1
11682SFh3LU4wVEtt5UrgW6Xi8qT6j8HAP,FALSE,1175487,1175487,0,2
115NvoxWUHFhuUQdijXhSCPuLpy3oM1M1p,FALSE,0,444061,444061,1
115fnBuY97tKfFNR8w9LPqVKTWJhY5riWG,FALSE,0,16957,16957,1
115aYw7KnGFUdad8AsuhJpi2SEcxZ8e9aQ,FALSE,0,100000,100000,1
11cYTBguYWANEs3ZPWFnSpBJ9VQu8c8wj,FALSE,0,300000,300000,1
1161EyqmGKNbLRpNLgN2SATTDVYcTVk8EN,FALSE,6741010,6741010,0,2
116CbPKu1RytjPyCQS1Cc8BUVeJDzYvgSd,FALSE,13101092,13108736,7644,24
1168zPYtTVQE1zfDYtYCppNvFPmPThegyt,FALSE,0,1315185,1315185,1
11RemovingAMot1eyAssortmentXQ5k5E,FALSE,0,1,1,1
1163vkAGG8ohzXvT35x1q3eakboEACCuL4,FALSE,0,2320000,2320000,1
11b9KQmpmexZzcnWbUeiiEVPUbBy4MMt5,FALSE,5148414,5148414,0,2
115mdoU1Ysu7h3htQGt2jvzUGn7yE4KZwb,FALSE,0,24380,24380,1
115G3purKubEhW2pTNo7cwfDFodibfzgSz,FALSE,14488,51092,36604,5
115jcp987ewVYALgN2P3y8S5AqM7a2HjyZ,FALSE,0,6935,6935,1
115kDXJTH9La2rQ7qsBL6QQFfTXzKB1xrh,FALSE,0,21335,21335,1
115id4mfmJ3j6L1f8rFzaFR5ZhkT29NW9t,FALSE,0,38422,38422,1
11nv8L3vCQubJJ3frBVrXLR7PChT3xUG9,FALSE,0,8652,8652,1
1165f6zjrXjJVjwymgnojhxevdFCHGuTZg,FALSE,0,3081,3081,1
1168gbXnJ7yNgBt74qdqifGaQdnY9QaMBw,FALSE,0,11789931,11789931,1
11vzFGq9yhiZiYFvY7AvmDc6h8uBvsMEc,FALSE,147188,147188,0,2
11a9LRon64LDxy9uprsYpKvT6FZUPagoK,FALSE,0,33407,33407,1
115RrYdk2Ma44Xo8a1sreTs8X1Pb9UFF56,FALSE,0,763136,763136,1
115FqcgXimtsbegWh5nQqPXKe1GX75jCE2,FALSE,0,100000,100000,1
115DwGjMYZCw23aeVx12DCd2HHX4j3EnMy,FALSE,44184,51276,7092,22
115yS8QytoREhh6WKLbmX2yCJyB6G6dKvn,FALSE,0,21953,21953,6
115kt7fBoJL7auGqhH5MSkg7iL6AJmwqAq,FALSE,719448,719448,0,2
11gq8NDy9m316CivvULBpJabhYw5ARwiS,FALSE,0,233870,233870,1
1169RkGMYZJLWy7cUKLzSAN4REKnvsyj8C,FALSE,184709152,184719416,10264,357
115uNGuvj6rG28fASLJsnDyAJv2wiRc5dc,FALSE,871575,871575,0,2
115DEZ9iRtEiiWHg531EExDCAXRDoJtY5b,FALSE,0,11000000,11000000,1
11UugyJU3x6ssm1fv7AendoijbP7Z25Yj,FALSE,0,394350,394350,1
11627PRVhhYwkfdCUY2KYF6F7qE6mRsTqZ,FALSE,100000,126304,26304,4
115oovfiy3LmefEs6C2HxSv6YyV47Jj6GU,FALSE,540000,666000,126000,19
11Zn1H3FLgi5cbK953iK7Csbz1Kwkybyb,FALSE,0,8795,8795,1
116a3WyL2ZjwuH3qMkrm1sHwqHjeWsQhh,FALSE,998726,1091542,92816,37
1159yRik6BwLUVCndLyTgw2JpM94c5pdt5,FALSE,0,310000,310000,1
11hoRJMZXY9fSf8JzhGw7hVgNTBBTN9Xa,FALSE,0,19562,19562,1
115VzsAKWJLD1N3WiF6eDwXYEXsGqVq7nz,FALSE,49800,65700,15900,2
116GNeNjpmcb2YRM8yRVPusEftqE1nvCQk,FALSE,0,50566,50566,1
115pSrXECvtKihYb3jGh6JMVvETDK56Rqm,FALSE,16434,502730,486296,3
1158V3wKVHohXzGWWphrkaRZ7pm8eWEqct,FALSE,426296,426296,0,2
115QoE1sMSDUsqi6dk9WNGMxvPRUp8xvmZ,FALSE,0,11837163,11837163,1
115pdBw5ES4Xj6tMd38YUzpdUDYmkun2PT,FALSE,26761,502730,475969,3
1161Jwg3ykVRNS5CDNdKYmV2dF4HH1uWGD,FALSE,45119,45119,0,2
118Nwqf5VHChHxVE94A2axGK4qni12pzx,FALSE,0,22354,22354,1
1159Nt3MofRqVLDziN3ZmcDMdvwym7QexN,FALSE,0,1682,1682,1
115oL1qR6pUA1Fh38dVDZUhGh5GpERNv3s,FALSE,10516,501092,490576,5
115iuncUASxGZfU41nP4pz3EKo9NSH7Whe,FALSE,0,12567,12567,1
115zn1ccZjSKaNGPfp243GqMb3STPcCCiB,FALSE,0,100000,100000,1
115AjhmRhhG8nQJdf9R6ZdHfKC1MpRvb5P,FALSE,0,446978,446978,1
11V87Uv6L17WCHSBFJ6GiBhkdv8nC284H,FALSE,0,546,546,1
11iEiXm5VzEbDbQnZHgCyGctLps1GwNTq,FALSE,7887038,7888135,1097,26
115yQZJneZiJgauaTAGVJ4LuCVHuJw36yQ,FALSE,0,10000,10000,1
116FZvgynRSMLn895UA9LB3jY4M46aHewV,FALSE,890000,2752679,1862679,79
1165VVLVQXEvko36enuhnXmzmupZgtk4jc,FALSE,0,23962,23962,1
11EkaSw6hDtRpfUjdgbt23Tvct2CEFdga,FALSE,191418,287849,96431,15
11Rp1kr4udAf3M1V9b9uQ3uod1vGpxNTN,FALSE,0,658378,658378,1
115g6ucPobrcA7fMWYzcyeKvDQYpXFBDkW,FALSE,0,223920,223920,1
115bUVsBExVgRXqs21158Ngc83hKRMBdw4,FALSE,0,7357500,7357500,1
115CMUUQJ6SrQv9gzXCnqyuBYNHkHQa9eQ,FALSE,0,670,670,1
11HMApBHSWPuHF2TxrQurPNxQioF1DgUR,FALSE,0,92329,92329,1
11D1oxahAbcVVg2DgrVXTVfzVb5RvGSHm,FALSE,117291,117291,0,2
116HMb4UikSt65wCqqjp5FbUAJjMUxEsaP,FALSE,64456,64456,0,2
11XZdYHj5eW37fbm3bQbKif7bpqaWCVJF,FALSE,905729,905729,0,2
11tvbzpMtkzXsYdh87GotZqeKBqX2FkPn,FALSE,0,492375,492375,1
115bxpTFGktzaUKq15nsmogT4MMSUXGYbA,FALSE,0,18625,18625,1
116DQFXdptVt3HsVrX87B9zKYUECHhP1gN,FALSE,0,4511373,4511373,1
115huJZJhvC12yAYM92mQ4EKJB6LqUhZLh,FALSE,0,10614,10614,1
11f5swcDfsGkCozMXf57ohyNoBsgHcFfK,FALSE,0,4200,4200,1
11G1zmM8sLKUd9FGYpAMXij72xaxMwbtM,FALSE,0,10852,10852,1
115MBshFrTnckHXMnUqHDWnem8meeAsLGJ,FALSE,0,12733,12733,1
115soeWHjLEXEvJLPbLbo5sRszNE3hNYni,FALSE,0,73840,73840,1
1162Xgb4gFXct4CVp3vSwopPgmZcQ2jQN2,FALSE,0,890000,890000,1
115hagQbK812nuA1hrPYz2QPFCXmB3gsC7,FALSE,2281395,2281395,0,4
11aYtHEtrw6eKK94C5XRCAsrLq9CXUwXe,FALSE,0,1247,1247,2
11L8fuGFoqxasAdTavzXXdmDfuEXUbWU8,FALSE,1000,2000,1000,3
11MrMsA6qHtayvD9RnGSGi2EhQkseej6F,FALSE,18437,18437,0,2
11MmHYM7CtUGro7Kv9VxkzfbXGJyWjM4a,FALSE,0,5739,5739,1
115vbooTX1fBq9iXNny8L3RNpHiEjVUm4F,FALSE,0,109079,109079,1
115zLopXhbYuW9XwQxt4okyPc5DAdCYSLE,FALSE,0,10000,10000,1
11YsCtZqE1sLs5i9GjFAbQApwDKDfoGiG,FALSE,0,1536,1536,1
11AMidHxnY4BtYeHJJgDTV5rrvLBASZEd,FALSE,0,8094,8094,1
11Bsix6C88527LkS8Zj8h6w3Xz8C8BNme,FALSE,0,7243261,7243261,1
11AWaLqXQxkYCEKW2UBjaodeZkMFojWrT,FALSE,0,20000,20000,1
11BJaBPgJ3aSV3udH6PQRyGNhi7vgA1zw,FALSE,0,200,200,1
115VZtW7eCjp2JM1GG4xerMtTWP1CXRLb3,FALSE,0,700000,700000,1
115qJQb4pzf3hWUsbcG3ZiFMaMpiNuyGWt,FALSE,0,955,955,1
11faRSHncKq88WqJtz8Vh3Cq5VtJMkzCC,FALSE,0,817284,817284,1
11664Stzi3RVVCykUF6n5YsPR6oU5JyhFC,FALSE,0,61767,61767,1
115o5qLbdX1p153QbUcRnJJctiRD4hLK53,FALSE,0,801,801,1
11h95YVxRqB1uBzDQPa71kdwATvcfpNe5,FALSE,780615,780615,0,2
115iJBMPgnphHE6nf1uzzYmCQFQU1zXLqS,FALSE,0,1004395,1004395,1
11X5UUvsvQqZ8bbe7WNR7TDjW848EVWbN,FALSE,0,2319,2319,1
11srndoJkVBHYHDiaNfodSZtCtnYruVGN,FALSE,0,31747,31747,1
11ojR7bUvjkRUcjHbVR4z1TBHQ2CmwAKP,FALSE,0,2000,2000,1
115BxdrBhcwxNKupQeGXVjHbspEJrAHYMa,FALSE,1092,1638,546,3
115NwP2SnA4zBXrtKSy7h2eU1SeNECx4ZZ,FALSE,50866819,50866820,1,5
11qH5LvY1UF5jGrUDJ5tLtk7vSu7STGRN,FALSE,0,10000,10000,1
115H9jbcrjgL7hm18HWvASVRx1hxUdu7zy,FALSE,0,915,915,1
115AzrazGcd5YAFkHPtCnPxbc2Rwx8uqnL,FALSE,0,2804,2804,1
116H1Pv8NHSXpqGivuhM6PRhNqrFEx5ukS,FALSE,32125308775,32713561893,588253118,467
115GNG1kpzQ5bDZhPJ8hy4Q6pmGY5wD96p,FALSE,0,100000,100000,1
1161wx3k9VReawPUsnSr5sGHaw8G1GaFoB,FALSE,0,2544,2544,1
11AmNrUwuAmnsqyU12xCTGYzXk55YrVK4,FALSE,0,914,914,1
1158BYTrGGHeoJG7PLQLqxr6HXpvecrgjB,FALSE,0,1000,1000,1
11tAiBH274qqovhigHSajDUvU79T9guG5,FALSE,0,14211,14211,1
11Tec6ZMwGHWX2RH5Z8MnnjKTMeVAcNmM,FALSE,0,16884,16884,1
118BUZ2nKxUUxwjEpozNyNMrEnkbEyEoa,FALSE,0,1389615,1389615,1
115aWRfedfGAHrd34PquNWLjnBsPxGXDt4,FALSE,0,10303,10303,1
117CCgnmYMsnWHxB1vEMcu73dTRmBLBfo,FALSE,546,1092,546,2
115FDBiQNfmCRSPQ6YJgtB9DaN9z9Tn3N8,FALSE,0,10507,10507,1
1156EpQrnT2N6pgitCa8LQEJRpQ1HKJVzK,FALSE,0,15125,15125,1
1166Bc63g5kKGGDR9EXx5Qns2oMD3fq8mU,FALSE,0,15000000,15000000,1
11Lv8435bDbNJ3Z2MDB7GfbZVLRSyKzjh,FALSE,0,53465,53465,1
11BFBX2caUadtkYL8zUre5C1yDnVJqTt8,FALSE,0,27800,27800,1
11bjXKSTaeMQYD5dUhkCCFuR97WMfC8Nw,FALSE,127010000,128258000,1248000,10
11LxYjbkdBWKasdBWvo79itDHbNaH2Cch,FALSE,0,5480,5480,1
115LTKR4qEYYbzdB5aiKJqc9qNd2H35kt4,FALSE,3763337,3784185,20848,31
11gKjP7SyGN8dRmrJwUanmTLJqvdVT3Hs,FALSE,0,1000,1000,1
115Mp2ouFFFUh3cRcfjMwxA3VfrfF5cebg,FALSE,0,74000000,74000000,1
11FermentumNisiEuEnimXXXXXXYAWwhN,FALSE,0,1,1,1
11MAGBzE8QYei9Xj2oye5KEUpbjPsbFi9,FALSE,0,4000000,4000000,4
11tnwasm4dJJbTgEVsMJHXWPnJe3Kte8j,FALSE,249217,249217,0,2
1158ZKi56979qkJDVbWSzBTv8C5ENmPoYT,FALSE,95437,95437,0,2
115k6LagGC2dC2DzkmzgZ7QDq31nxy1c8w,FALSE,247108,296082,48974,26
11fcAMviVrwoJbYuHcZL43RMWoTcRMghq,FALSE,1236798,1244442,7644,42
11JEH6YAtvKSRTFseYaFxgvtcmoDkx6Ft,FALSE,0,7943,7943,1
119YxrozHWAQFbKGzqwNCTPPxcATFPFyN,FALSE,43217,72367,29150,2
115FhcydD65tLpPGKHbm1EaSLETWQQzghy,FALSE,0,560,560,1
115hVu792QNXj2xgbUNLHUcKCNPc8cr6yD,FALSE,0,8231524,8231524,1
11cTnjPvkARjAcJSa3MX8maWFNboxwuws,FALSE,0,701523,701523,1
115LhCbNEBpguK4tD6X6hPuYXx5k1Eo8s7,FALSE,0,1666,1666,1
11NBFLpqBimK1752vUD5eMfvRjAPmuUK1,FALSE,0,54613,54613,1
115fwkjTw3Y2V11UiYPjzSGy776dvTYcAo,FALSE,0,592,592,1
11UNN9creMKWPo5GfdXcyU7Miu9taeike,FALSE,0,42312,42312,1
115oMqiaDxpFRny5AG1ijSHMZyVXXGA5vq,FALSE,0,88602,88602,1
116D1XVFFwHujZhbpj4X62vfqKHgYBemQ6,FALSE,0,500000,500000,1
11eTDM7DX3QPjerQuUKcfYJ5dcJTCapfu,FALSE,0,1016515,1016515,1
11tYiS1yU391CchGxuQaHQCMpushsCTkc,FALSE,0,500002,500002,3
115ULxw5aeK9U5fLboxiKyrg8ELN9V5XaK,FALSE,0,343138,343138,4
119YCELGXS5joGWx1YkhSSGMi3vAcARqh,FALSE,0,714827,714827,1
115grjZ1Shc9Kfctm4BGsDZDNwgjf6zEym,FALSE,0,149919,149919,1
115ABBn7NVNjafqb5hKpnzKcUjTLusXNkU,FALSE,0,546,546,1
11Bgx7EEuZa31sBwGVyHGe7YXyVuZh9gZ,FALSE,0,5747,5747,1
11BkVV2BhjH69T5CoXg8Lt3TNDSy5Lp6P,FALSE,58000,65092,7092,7
1162EbuoJrMyHp5mhEYtHACWifonMkLY8L,FALSE,0,45310,45310,1
11wcywduLphZg8tLJEUQh2Qm3Cs52Mmmz,FALSE,37462,38033,571,3
115We1wRVrzKcoxMmG79CJQJydeqk6wXfd,FALSE,277407,294023,16616,9
11hfhJFYAzhbauXEKJBwqTcywr3tGJZ65,FALSE,0,7950,7950,1
115nqvCXoDN2Lv3RDi1MWYdXCLJt1TeKt6,FALSE,0,3030,3030,1
115U1sA1DXCzPQX9xSmmAddM2rrDZB2qP6,FALSE,0,5500000,5500000,1
11JKv8jsQJndGJJb7uYg7xZoEfrhScQwZ,FALSE,0,5500,5500,1
115H27y1Dnb6uxzJ7BRmb3RMU2P2Wpngao,FALSE,950201,950201,0,2
116DBUCaaH9vpyHLrmvGahNpFVGoUsAMi5,FALSE,0,93333,93333,1
115AffcfKCoE3whPwjK9hydVJYHoxHfDnN,FALSE,0,81033,81033,1
1159wvGuS9iweKQxMR99SacZk9UnM6hgXx,FALSE,0,49896779,49896779,1
11KPECshyHrqdgUuDK4PZZmVH1NgeEy87,FALSE,28879,29426,547,3
116ADomFnVn824xYcGB2eP9mFnH5ufRqgB,FALSE,0,85530,85530,6
1166U4PK1ri8MKRFt8aoDVFgNzpM7gV6Jy,FALSE,0,322502,322502,1
11xKuwU95MdbyjVy8BZbPjxnmRKWZpY6G,FALSE,909546,909546,0,2
11J8ugm2bZ1z9nfozK85nqkygYEaGntLv,FALSE,718004686,721394494,3389808,22
115mJLKRr3KbySLHU8bLNn2gi1XHvsUUnL,FALSE,0,3748071,3748071,1
1165kz1RTRLkQUZD8ZkkDiYm7nvNYwznf,FALSE,0,451380,451380,1
11KJZZssEjW2YkM4CreKoAnfajNZdAS2W,FALSE,18956,18956,0,2
115xCr3Kh6WGAQHENFuZryqN6cdyVVMWe1,FALSE,0,5480,5480,1
115fwCQMJmioc9N7kLen9Xov5ZcnX5L4LC,FALSE,552692750,552695521,2771,33
11CTuDWdSdw1mzRqxT3CQujNtPSQ9H5i8,FALSE,0,1000,1000,1
11MankindRequiresThatTheyXXYj2Awk,FALSE,0,1,1,1
11WB8GskzeqgwwTWJw2oLSyNTe7jL38u4,FALSE,0,4546,4546,1
116183HXCf1kVDNpx3RSyWfwSuWarEboMX,FALSE,13000,22000,9000,4
115uot95EBMzFXsqusamhHnM8S55cVpwqj,FALSE,10685300,10685300,0,2
115Z4bC2zf9rSo1xTPFkz9hkSQvERRjpj2,FALSE,0,223072977,223072977,2
115XJYFqKSc2KXXsFNbBw55dwqwuzFk4wf,FALSE,0,1694,1694,1
1168o8PzwYGsJutKePjGuartrWW7U6P7Bj,FALSE,0,8383,8383,1
116H6gwJDoRdM2ZW7h2as54i7Qg3zQZDzb,FALSE,0,1000000,1000000,2
115zAFBeY3Nt973hqWw6XhcL1kEivHxQNw,FALSE,468145,657595,189450,3
11nPibkK4SczP42fWo3ySYqihYXAzLUyv,FALSE,0,3745,3745,1
1168BUy7dB9F15pEpZNADfqsjLitKEDd9h,FALSE,3852,3852,0,2
116N1ySNasDhN5sGLrxKvKPxEDggq1LRb,FALSE,1167222,1262276,95054,33
115gaY1hGRuCuZfamNVc9F9QhaNwm8RuEU,FALSE,0,2000,2000,1
116GqyaHSs2dhY4dUNnYzLXiah45B9DssW,FALSE,96211,96211,0,2
1157N284WQ7TDpYMhy1tpKheo4N5ECiaZx,FALSE,0,206181000,206181000,1
115ZscuqWoYc8Q91WVCfDfDrGCR8oHArsJ,FALSE,0,2175,2175,1
11CsetU63iSsKKsnhWDSb6z13mvFd3sn5,FALSE,0,5480,5480,1
11G5pPdoENihwGyBYPjUL9Xr5T4EMLJvF,FALSE,0,14210000,14210000,1
11MassaAcErosAdipiscingXXXXWdVXh5,FALSE,0,1,1,1
115MfhJjgAWUgjSj27w1BWRaqxCRJRB5cr,FALSE,0,1,1,1
1156LZJgxTDLucpBxE3k3BYKYXuCTb7sqL,FALSE,0,1262173,1262173,1
1158qtjZ1Y7YBpq6KHEWcFkBded3HpYeUj,FALSE,0,367044,367044,1
115UheJCuQyU3yiwmVeV7n61bSv8H6j1Pi,FALSE,0,20040,20040,1
115z5MiLPSscJAC14XyvXhoCQG65BHRppA,FALSE,2814,2814,0,2
112hdSob91utgmpCUnJz1uGfW1ZHLWx9xA,FALSE,0,10156,10156,1
112r9hAPAT7A83AwHR8cg24w56MRuWAUVf,FALSE,0,1595,1595,1
112GjtskqmCHg79eJc4r253qwQLtrDWj3w,FALSE,0,600,600,1
112NqkZajuJ3wbviVWc7zGRK2FN7chfaoj,FALSE,75110400,75127760,17360,9
113e9KmxRERfN8cdiaaxb4gj8Fd3ZmTvJX,FALSE,0,13398,13398,1
112XJeHVtqdv4HgXxVC5cpSQULkchvzTvo,FALSE,0,128728,128728,1
113qrwMFyJSMJuDuv9wzJuEzBej7cSoT3J,FALSE,0,3700,3700,1
112hWrkB1LCQ3b1Gf98kZzeAyru3MB6Bh7,FALSE,430030,430030,0,2
113wDCv9sBpsAQ3htNHhQqFYR1N7Ro2qtM,FALSE,0,272458,272458,1
113e3Ga3W7jfHTF9WxWunxniZ9RJMXbrev,FALSE,0,2058,2058,1
113acnWswqVVMobN5hY2qEJcuszRZBtxiR,FALSE,0,22388,22388,1
112Qps3J3CxG4yVKydEbrs9MvY1Dh1vZ9e,FALSE,20816780,35200000,14383220,3
112cvzjmco3PL7kvnqF5A8rzkMwV2WJ2eT,FALSE,0,548,548,1
1134f53L9aas8xpVtJeMvFoQ13h8XBr4e1,FALSE,0,110430,110430,1
112TwjU9ohLKBfSRNfGMAvYDK8a9CgXyj8,FALSE,0,130000,130000,1
113yfv4UcwyeUqTtzxaNupDV9u4vnJGwkS,FALSE,0,26125,26125,1
113qrbqaFvncfCgm5UrXLdBiE43rZRfnxd,FALSE,0,622,622,1
1142X8NCT4tdGmGdgxYkz7dVBYAVUDEEJ9,FALSE,2121239094,2121284926,45832,43
113jGtaELoK8VgP3rVxLeAmZTL2tGumHeP,FALSE,0,4435,4435,1
112pvXQyCWFFAobsFSZgQxrUVAaAMjwJ7z,FALSE,0,442700,442700,1
113Aqe36TZYXmpFzYr9AwGcmMffrTVNc64,FALSE,0,9990000,9990000,1
113ZLiXqCAdEdtN7V1b8EsjwwGJ8aruqQT,FALSE,0,15680,15680,1
112v5QbDG2UutcnxoiqtVgYnWvh5ppaJmC,FALSE,171514607,171514607,0,308
11448yLjgQKgyijPBwVeJzYFUZxGbEboEm,FALSE,0,2469200,2469200,1
1132HLhVsUU957qcWTJ86Wa3t2NCptKQQn,FALSE,0,20311,20311,1
113ksztk1DM7L5anCQwV2mV7wBY7vgyvu7,FALSE,0,823810,823810,1
1146c2X44HSQ4MuC6273V82fe9XGjPhUGF,FALSE,472062416,472062416,0,72
112pcEPSa1zZBfBvv3upepz5U2WtKK7Ft3,FALSE,12203779,12203779,0,2
113oa4XPyhEzLHzPAn9FroQjvNN2DCKG3K,FALSE,448503,448503,0,2
1136XZoqX6UbSqoFtAmquZfoyjBbGPqAAf,FALSE,64093341,64093341,0,2
113WXBes6u9EXgTBHsqbrgGAUqZr3YwAmr,FALSE,14488,51092,36604,5
113S6AMCr9REvSZpTi155VntFDQUXGfYxc,FALSE,1000546,1001092,546,6
112Ge8VbTH8BTmNE9BZVFpZS4Gsz7yZYw8,FALSE,0,1020000,1020000,1
113Th4MEStkecMFYsEBqTA2SaDKL48bpwe,FALSE,1681146567,4277787826,2596641259,13
112gHNn6mFnbmNWtXNWWPeQt8MsjqpbAHx,FALSE,23587126,23587126,0,2
112WG7go2VJ7wUCnCPS3PE3khn9im77Y3h,FALSE,0,2256,2256,1
114FBiJy9NvuXZZcQrDJtqCLfPn1gtYus1,FALSE,0,1100260,1100260,2
114EUwvGNzJvcFkGgVVmPJUb6oqjktxJzs,FALSE,0,5480,5480,1
114DRvcJz6ycHtkLMQC3Lmq1Z9qVh9p53D,FALSE,0,6102,6102,1
112YRZv7LEMAiNXA6k9kFgFQSrHweZj4B9,FALSE,0,13343,13343,1
112YxJxU2kiaRBMYrtDV21y2dFLXZViNsK,FALSE,0,93830,93830,1
113jJZPuSLjLnKVWtahMdZdW6crZvUk1gK,FALSE,0,3000,3000,1
112Ndyhn7wz2fqJ1GBfkM34CJh6EzU8BAS,FALSE,0,7437,7437,1
113W1VFTGToEaKeFmagYYYTZ2mdQxoGmwN,FALSE,0,716,716,1
113cXo2vQkFqRo92ehTsCpzyFH9AZQQjqd,FALSE,902000,902000,0,2
112RJA7QZmhYo8XybixadkzhHjg9U7ikrH,FALSE,0,5000,5000,1
113Qk2rdrTaVKq4oYfpFmS7KQv2FSebaGK,FALSE,416238,416238,0,2
112masxr3jw3D7KfpurgNzP9DM5k61awty,FALSE,0,33229,33229,1
113FZ6Lz6jhbnzXDbnkuwnDiYRdehmH34t,FALSE,0,29345,29345,1
113PVdc6UMTXCsd1iXy1Sxe5xSBWd1UjdT,FALSE,0,5000000547,5000000547,2
112yEG7WrMg16Q8kdTFUGqjVcVaWezAFX2,FALSE,0,997736,997736,1
113ZuFme7eYVKv8XVcr7kLhvBS91gpQnGa,FALSE,0,1000,1000,1
112ENa4hqceGYYFPtzKYZYR3atvgekwAjB,FALSE,9670000,9797020,127020,2
112u4jtkjr3YXUzjSkzfgauY1e26CvYo7P,FALSE,94000,102184,8184,15
112unrUVGdFtjCC2sgjJYijty19edSWkUZ,FALSE,0,852558,852558,1
112ebqi9u98ktoioXHLSCknNEXD61GDw4,FALSE,0,405743,405743,1
112HU7gLCNhyyeEik3fktZCnsWm91JLfkd,FALSE,0,75868,75868,1
113bsKnKV2m4G6hqhnzDg1AuTzMC4hdyPo,FALSE,150823,150823,0,2
113P7fBsgK8ma2ZH3xN6NCsyb2w6AVE6fY,FALSE,101638,102730,1092,10
112YX3s4DMhgTJurjgTnvma3BMxFJfsSzh,FALSE,0,3105,3105,1
113iiv56LFmi2PcbUBgZQ9dp2BYKibbTRj,FALSE,911031,912123,1092,14
114BRz2f6HP144Ny4rnFTswge2F62QqVoh,FALSE,0,35609,35609,1
113wmmRUcgiNGeSKAFJ48YGJ3YBeKpasW1,FALSE,397696006,398367411,671405,586
114GDavUAemDQtzTvtJpMWDSvFBGmA2bXi,FALSE,753000,753000,0,2
113sChH8h3CSjWragap94tx1k2wkh1h2bA,FALSE,0,249582,249582,1
113H7r7DWk2ucNuZfcCZqE8Kt15NtargoC,FALSE,0,10000,10000,1
112rk6rg3csQfMYf9kBSqDwamvVWLoBESd,FALSE,510920,1000558,489638,7
1139TkrCmJHcKax24Doe3Cs8zpuPmLkTkc,FALSE,6596,6596,0,2
112ejhr9vQYcjp7sR2433TJM5PYZY3VG7K,FALSE,5800468,5800469,1,3
113ejnYEATN1rzUjQ4FYaNy42FH7ywvaUh,FALSE,0,95221,95221,1
1143En71bndPNEg9ii6BqtYC8PUBGBuUVN,FALSE,0,557950,557950,1
113DXyp3WMCAq2KuVTEWtZmPEX7PYdgtbs,FALSE,8401,8401,0,2
112jGHNaRSvsnx4UDYkR3kBEt6vwYh1EeM,FALSE,13926,14472,546,3
112xLBnzGjSqNHcG1D8BK6B7Xu18yqeeXi,FALSE,0,11614676,11614676,3
1148Tkvt38rsbu8mM1DtMRpVLctN4jTzv9,FALSE,0,10293,10293,1
112PkX3F8KLkQpm1c1wUNoGivWkFN5izV2,FALSE,0,39632,39632,1
113njNUq6j9swoixryQGcuMHUEFHoaqHZm,FALSE,0,5000000,5000000,1
1143Qby3VQSKBKHDpmnSU5PEDP2DFQkHEc,FALSE,0,100000,100000,1
114EgCLeXohX2u9kJXau8DqyiQKJsUpoUs,FALSE,759471463,761712952,2241489,258
113TJtC2mJ1WZgwqfdJHh1t9GKqUu4DdHF,FALSE,0,91894,91894,1
1144HUkpN78J5kvDoeWfDgyRaaGD5bSW9x,FALSE,564678,2238795,1674117,2
114Bj2XpSrJgn96NUwFc1cjpeuA2aW4t1U,FALSE,0,587,587,1
113HqMhLYKG1HZLKFC84eKgVjEdVmrXLXx,FALSE,0,189129,189129,1
113MUPTwKD74ABVix98bqagejHFhK4SY55,FALSE,0,15479000,15479000,1
113co3N9NHipzYvbtoDLA8NBHe5fdG4AWS,FALSE,0,94699,94699,1
112nnPg98VG8HfgKaXitZkDbfHNJfMQrxH,FALSE,0,3000,3000,1
112WGfACSb9JK3x3vHx9yA82YeEe1m55Kq,FALSE,0,5000000,5000000,1
113euVXCjtKaw1wdoc7xiLbhXtPetq7vLV,FALSE,0,100000000,100000000,1
113RyZiJvnpa3coutF7hpTjrffGCF2cKnY,FALSE,200346,202530,2184,10
113ENUSgj7vFBSF5YPbndGYabb1ck8AVkm,FALSE,0,38460,38460,1
113ESqbYboTXavgqgcDZboiXGKXBtsDvWE,FALSE,0,28700,28700,1
112Vf2Enb1KWBsoEDdhn5Fkqb2oU9oyqqE,FALSE,0,10000000,10000000,1
114B415QLu1hdbn2zQgZz5DdZF3gpL2bKo,FALSE,0,5916,5916,1
113Lyg6hqzPNQRgathRFhZC69cQLxNKu6E,FALSE,0,94570,94570,1
112SparrYz8WU5fay9GiE2XZJAFuHrURpg,FALSE,169000,191000,22000,3
113JU4f29qbcfDNhb9K89u6qFmibBpdFf2,FALSE,0,418766,418766,14
1142DWXcCM8qhyPAE5f7t88McFFPBryCFR,FALSE,0,1000,1000,1
112Cw76PRryxGJ1v4qPNpxMNV5YQ9K737n,FALSE,0,72464,72464,1
113WXd47WZafCkdfP2QYxmCpU3aHeoXhDz,FALSE,0,616930,616930,1
112X2o2ifSFQsiu69Jtbc7rJvbbhoHUVTf,FALSE,3026556,10880546,7853990,2
113wnxmX92cnaEKvBeyvcHyLPHd18tarq2,FALSE,0,17581,17581,2
112B4B4f4DAb57Z93Lv8ffUEuW4kc96SQW,FALSE,0,14097,14097,1
113CRFq24Q4a3zVwoVf8X4VuVqbRpBVhCB,FALSE,5646,10546,4900,3
112KNVRdNKSmVR1mMo32Um27L2uvRsZQit,FALSE,0,15000000,15000000,1
113NVx7qgHQKwCcCWsaQNMZFe16Kc2Ksee,FALSE,0,9767,9767,1
112nTgZcAzLhpGmxa4WivMsVCs94eqqiTM,FALSE,76701,176076,99375,10
114BVNmBNBWhdBJTCh5nKkKpgw8DcJM1nj,FALSE,0,1000,1000,1
112EDkuWh9Ciq5w36AUXzjcy6PDLNKL6KU,FALSE,0,43018,43018,1
1148DqUxxp3AJBiBo6bXAjwLVw6nX8WyY7,FALSE,0,136371,136371,1
1137qoEegaqiP7myXdHf2PsZyEcCwRg9YK,FALSE,0,55477,55477,1
112aGfsxQxfdDf1XCeaPZrjfCeHP1MaU3n,FALSE,0,19137613,19137613,1
112UyquBvTQxqfENb9QN17hFjjui5rbNxM,FALSE,0,5066000,5066000,1
113Mp9TLS5J5m3yZEa2DGHNK1k2Gmawcok,FALSE,0,129171,129171,4
1137758GJdhssUdVuwgWWHpewr4WjSd4mU,FALSE,0,1916404,1916404,16
114DEu8Joc5Q5N85zKkp4DnJW1KGQxAxz,FALSE,0,13193,13193,1
113dE4xFUMSTNZgScbPtV595i3j11hzM3D,FALSE,7457047,7457047,0,2
11349VfeQWsv82heTZb2c9HDsSmLmxmdkc,FALSE,0,3456065,3456065,1
1137sRsyu2aRThamDCXh2mbUa6odUwZQwH,FALSE,0,6100,6100,1
113xc1jgLqyL85WSZYy7TG1xYgy2ySwzDH,FALSE,231620,231620,0,2
112pMietSByVLZgnERW24tbDQkdbmvhBvj,FALSE,0,97290,97290,1
113t95kxWb8ARYrZrNVoUHgwqPHxuFkgY6,FALSE,18202668,18258942,56274,3
112upbyVetHuwW6qhSqtS2iFhpgehLpN94,FALSE,335065144,358599294,23534150,79
11423mPs16cFs2BnMmnTH73d2Mdx3xPJNV,FALSE,0,121265,121265,26
112oo5VF1q46w9mNGhv8b4kB5jKT6Ueg7D,FALSE,0,7368,7368,1
113pVQ43TYWQeoBEnd525ckTGZqntTs9CU,FALSE,468481,468481,0,2
114711ybm87SZZzGsPYyM2WPG3BBZThe8A,FALSE,0,12090036,12090036,1
112aYarFQYnN1mQn1w3XBHzACvqExnyAmB,FALSE,0,3473,3473,1
112voUK7fwhAQSZXrE3bWRqkoHqkhPBnRW,FALSE,0,103710,103710,1
113xESbk7BWBpkz9Xv8RhdypWcm7VEZXPf,FALSE,0,52895,52895,1
113ZmYBRet9sFxhbGS9fmBgNC3Q92dDt9w,FALSE,0,3750060,3750060,1
1144UrNQiRNQDE8JLZzGW3MAk3MjdGMELu,FALSE,0,18877,18877,1
1142s3Y6txdhDQ9XTR7mgi7jpaNDzefKTM,FALSE,0,17656,17656,1
113reF1w1ZSfd3QMiRkPs3GAJ9e6Efogqs,FALSE,0,4470000,4470000,1
112WJ6pZ6WMDNbu2zLfJKY8ujvJvNHedfu,FALSE,0,14843,14843,1
112f9BFgDWsFk9Ab8MFu8z6P2RiTLWwhbn,FALSE,0,4280,4280,1
112KfgYK7FV7Ny4aJW3QLXrt6eXeDbPYwZ,FALSE,8717,8717,0,2
112nZWw7XjidvnHvS9umBhwRNhKmpZaEAH,FALSE,0,7622,7622,1
113KjhvDfEMAwTMmQXoXrU3JSBJyTYp9xk,FALSE,0,19742,19742,1
113PUo3jQCQhgBNTeEK515VB2uykxadRmA,FALSE,0,29708,29708,1
112Ezz8tGNESaqfqx935DXcsnKc3Z8ECAd,FALSE,2491680,2494631,2951,149
11477pFZU5UnobddGTGi3y9EZqhPW89CJb,FALSE,2288565,2696664,408099,112
112ewjQ7HrfQTQfy9SMabWu3SAidknvzAE,FALSE,7738506,7744509,6003,10
1147LCKaB7ZWpzGGKTXMUk6amwkJEENZWE,FALSE,0,7800,7800,1
112S3jbb6QwN9HZc9gRxc6MJKZDDW3Ky51,FALSE,0,11764500,11764500,1
1142MWobA2zFi3eNFw6EwCkDsWVuKrgjEF,FALSE,280000,285460,5460,24
112QTixtKMJsks3iPPJkiU1wGYn1XHdxhi,FALSE,0,546,546,1
113p8vLn323vqknFKzBgNjiUMzoaP1e9HJ,FALSE,0,2583,2583,1
113WDdd8jiTt3oBviURetNSTCjT3oBwpDe,FALSE,0,21181,21181,1
11414orRm8wT3yuE7nP4mfRhycWETxW3MG,FALSE,0,635344,635344,1
112qjrAjzWB9FGzmNdYXgPNmyse7tiy4uh,FALSE,0,548,548,1
112nGKFcCbpveZT5bPRhBtNDSBrgmS8wzN,FALSE,0,27320,27320,1
113V5gNjkBP4ukwTsX6JBEQdStPcUSafX7,FALSE,100546,103276,2730,3
112vwGNUs3NrTBeopiwcQoayronozSCDZM,FALSE,358734,653036,294302,36
113xa5hPU4AAXkEsif41iMUEcqNWtvSwDt,FALSE,0,5480,5480,1
113F255JxmDBKV2gWuYJg1uZkX1Jn8wWKS,FALSE,0,125000000,125000000,1
1149sVTLnyMLokrseqSETu53g7tNqnDmAw,FALSE,0,111380,111380,1
112aXeRGgrCJUhunans6HGWe5SjChSXqYR,FALSE,0,76486,76486,1
113932GmbJMKS7XvUddMvCvoh6vz2Tcfr1,FALSE,0,5500,5500,1
112zozXqnLPheN7vveAY9JYAHrr6z2ZBVU,FALSE,3298656,3475972,177316,4
113AgaU35yAhKaJCmavV1cpNiHdAKSLCN5,FALSE,0,176890,176890,1
113833akbF18Qza4Pb8gVp3BvzXRWga1Ta,FALSE,0,2984494,2984494,1
113nq5UfLRsRT4NRQ4dqU1dCKrpJrZh9hq,FALSE,0,298877,298877,1
114AJHCqSXKFsYJFwfyvx3ebZBjXv1pJ85,FALSE,437637,437637,0,2
114FZhHELfGJgccz4GbCYE6S7HSNV5kzU7,FALSE,0,41259,41259,1
113NcVBdjEJoZYQbzN5PeymWaySMxYSyX1,FALSE,0,1001265,1001265,1
112HqjUwYTBKn28oQmBKYDDe3NC1GGSrb6,FALSE,27524419,27877158,352739,33
112dyQwQha3hMbweHX89mMZFgk6VPTZQZW,FALSE,0,35736,35736,1
112Ggu7yAPeSoLLS11FJV34RZZhTTE4cxT,FALSE,2540,10546,8006,3
1148tQFrCLepWRzsxKyGBFHXepSBppyfqc,FALSE,4276762,4276762,0,2
113Wb6APnyozk1Qo7WzyAqzu1YWd44dLcd,FALSE,0,40948,40948,6
113C2fhyM3vfsx7C9E59WHdaDZXSvqucQJ,FALSE,2184,2730,546,9
1149zgBeaqHDKsUaVgWEU9rQNMZ7F9JDKQ,FALSE,0,37714,37714,1
113J85ZPDGQRh89BKBXsoMP7AHBPZjtFvJ,FALSE,0,16277,16277,1
113AorNDZBA6UMrfPJSXRYUTEQnAfwUapx,FALSE,375738840,375744740,5900,248
112GJHxs8vTmSVjsTDHw3AMfUXpa7aspXa,FALSE,186100,186100,0,2
112KdABL9AVKADuHbahhysBpLeroPxndH4,FALSE,0,290954,290954,1
1141asnC4mwip7ZhvVkVw8qaYvaiikfg45,FALSE,0,15000,15000,1
113igoXx6XAMYuJ4cqvz8S8mwsUiBxkYAW,FALSE,296500,300000,3500,5
113HwYxxDP8ScgTKiYhkc2r6T8pBoePGth,FALSE,0,7300000,7300000,1
112igAssXJLACB9k2VnVR3ihGKPCuUJap,FALSE,0,336414,336414,1
1135qtuc3XNUAkkpzRKdAuQLXnfNzjHkVr,FALSE,0,548,548,1
113mD5Da1MxywqZUhLQu7z5eDkdiEhDCmo,FALSE,0,5500,5500,1
1132yAKnwZXukfSUDj5cy6DygKtufrDJEL,FALSE,0,364504,364504,1
113N1gnKENTXRmJbYHJX4fZbUgwaqeqjpB,FALSE,40065738,40096988,31250,10
112cPWuTnZC3zo2UnrR84nyw19C3bsdPCF,FALSE,423657,423657,0,2
113sYZzgXamzxuSeJ5TU6bJR5Ax4tohPtX,FALSE,0,16508,16508,1
113ase9Gf3yXzdJ9hCK6qLfiazLQskRuqV,FALSE,0,546,546,1
112BoUwwizu1kRAXhHbPgxoADTLpwF2TR8,FALSE,1088347,4223800,3135453,2
112JXu83Gya79My3XL1bsN4jeTbMagWsAe,FALSE,4197430,4201034,3604,134
113aM3Ji7R9ViLE2NDW6SBtxe1uPYxyZ76,FALSE,0,149869,149869,1
112F9XYxEQraRYWD9X9dbWdx5agLUYniLo,FALSE,0,30458,30458,1
112hHiiwUZhYKehFt8esgVvpt8Z6o3jRgE,FALSE,3335084100,3345491416,10407316,40
113XHy9ZfSbSGSSyeaa3TKfMFaWzwSHo7M,FALSE,119232203,119489814,257611,14
112h5r8nXEL3LK5utX5LUkEXbQZeTGGxxV,FALSE,0,11991,11991,1
112SjNLJz4mo3hPk5DUJvRsBg36SRt7Mwc,FALSE,202395,203435,1040,3
112ZHPTqtseRmuz3yjbERKvZQ4RStAabT8,FALSE,0,33050571,33050571,4
114DvzQZ2YJ1S4TkrnnBpj4oL668YomVHy,FALSE,0,121479,121479,5
113M2gt5fGhwqV4ExPVEskBaYK8o4uu19V,FALSE,0,520335,520335,1
112UFHk6THiQ3dJVvzo8BpAeUTu214sosY,FALSE,42952510,42952510,0,2
113FbSzYE7HiAqxWzAwLkwcdPrKPJXdrqn,FALSE,0,2000,2000,1
112APHaJu6uS6ic7UaMiPJwh5w29b9MLMu,FALSE,1227786,5088300,3860514,24
113e8SG4XE12wbTQ5144TQsvNnSmDmPVcw,FALSE,0,2000000,2000000,1
1138ksLxDySy5nyfekKFi2jsu4kxZdgLKi,FALSE,0,853907,853907,2
112pskbGfVDBfs56jEBDeUU7MM8n4yBR43,FALSE,0,26442,26442,1
112ryp4JVKQGZxhDwjdbJh56zXr4X3Bb57,FALSE,0,5000,5000,1
112r57fsDNYeYGUdG6rsieibLqYVwiThaa,FALSE,876400,876400,0,2
112SfDBrNNCeBSqNHJYf9szUHuAKNK739m,FALSE,0,529258,529258,1
113FNUtoP8uctjBBuKnmNS7SmmBdaKiXDq,FALSE,13541610,13541610,0,2
112uS286Q9ztEcG4mqQSY3cMnN8ixCpTf1,FALSE,533637,533637,0,2
1146s8Lj752nvNkU4kdkAGVnb1xwFRYigm,FALSE,0,5000,5000,1
112RjGoviMH8mxW6AmEMdtRLSfJGLrRSYm,FALSE,0,1000044,1000044,1
112ZQqDdtHhgHfNgZ3baGDimBgWfCQ7N7Z,FALSE,0,194000,194000,1
113tTSav6sttef4DrnEgjdKWMjLod5Q6hk,FALSE,805860647,806587098,726451,8
114BUjzsPCKaa7SnqEjshuNXstVLH4sS4p,FALSE,123629,123629,0,4
113TyWJAz8xeBRaP8xQv7EzSsAAiCN3vZH,FALSE,47189,78765,31576,3
112zCgUP8npjUctUaoNT17LL37zDbknqfh,FALSE,0,627416,627416,1
1143DXmiA15s4zt9XpcjCo4C33RreV9aS5,FALSE,5635725,5635726,1,3
1138gTTXYCxv4GgwE1PeAeYXxPs3jDBdEx,FALSE,0,488449,488449,1
112rcpvAFE9qEgmxL4t1DBs74PufCojRms,FALSE,0,226020,226020,1
113czpYyMevk1LKzwnYLgEbX9GwWdkb9iJ,FALSE,0,2500,2500,1
113JszNzTFkG2kqhki1iGmxuPUiLWaNMCT,FALSE,0,28694,28694,1
113ZcoW4r5xH4kKcXbmnp4ASA467fTAAue,FALSE,0,100000,100000,1
1139zpRXprUNLHmYmawmWVi5Wgb6eP1nuo,FALSE,401092,406552,5460,6
112SbpQ6cTq78i57JJFQdaxmAC2KJmUykT,FALSE,0,102730,102730,2
1133Fhi61kc2QtBEyYsujNTBcirwic4uSZ,FALSE,0,554155,554155,1
112w9MhBtmrHwvKT3xk6BNQ7Bn1kCyzmNG,FALSE,0,3682,3682,1
113i3BhQNzJ4iTPgNgWWkam8YWwJpTDZrh,FALSE,0,10000,10000,1
1133xfNfiLxttVgevt5yT3asbV8bFMgSjp,FALSE,77514019,77660522,146503,20
112EX3it8TYTAN8vKinxmBbsyfkMo18B9S,FALSE,19889980,19890526,546,11
113sWbW7hbB3cWg6GhKuWUmcFT6wcKjfQB,FALSE,0,5000000547,5000000547,2
11438bKSQL8qjyeukHR2wLJL7qM46M9tT9,FALSE,58535051,58671116,136065,55
112RXEVSzMYQ5kLQBVaBy4fr4AQHZTnxtc,FALSE,3499,3499,0,2
112SUNLYajSFj5mrYsEnoz1WZJRXJdX1uV,FALSE,3226000,3240594,14594,15
1144kpXLNSf5G3URhqJdFCPk5CFQmwtQXF,FALSE,0,228570,228570,1
113Y3Cod7rEabq3LAgTG4ZxsToLzCjTNaW,FALSE,0,7564,7564,1
112PezD7YE2UFFwYXCshULF8FJrofitZNB,FALSE,187886,187886,0,2
113vy5X9Zyaixc8GEz3RcXsAvCLca9FpLA,FALSE,0,662,662,1
113bicQLr4rVvLD4ouiwvpBM7rqN8YKuq1,FALSE,0,50892,50892,4
112NW9Gym38MyDTV5WV6vXapWbkn7eSdR7,FALSE,0,29191,29191,1
1146uAKUfBA6oPQc8QL5LFcbzf4zwkSxsZ,FALSE,240861183,240861183,0,2
113JRGgXepdcpKHn6n6XdYAEkAnraTmA7G,FALSE,0,146032,146032,1
112KVgh8EQMsE922SzVV7fB5qTLD8rwzdA,FALSE,1126734,1346567,219833,33
112LNd8bVoWhtL4kYtqd6SKMPkyFdBpqdV,FALSE,0,566103,566103,24
112EC8jNypwjv8FZ9LtSjc4tvAs6U5pW1z,FALSE,0,634,634,1
112wVk4gJ4xYe4bonhaMxPHQhfHbwHgptW,FALSE,0,1000,1000,1
113mMGjrHUtFwUY5w4dGUSKxwnPT38Bjtk,FALSE,0,1491100,1491100,1
113YuJjMWX1k4sXHGEDzMKdx5kYPpmYmnV,FALSE,0,2661000,2661000,1
112UFmDFCkvh4TZHm3ynNL9Rg3UeS1oHoe,FALSE,0,125289,125289,8
113fj5nLUowHBTgVpqsky9khSPsjtCwZuL,FALSE,0,817,817,1
112GiLTacyWKi4jHbeNrzBs7itrS8BcJZJ,FALSE,51246,65246,14000,10
1145KsCNjyrkSeUbQazh69ZsGhbtXeAtCK,FALSE,0,100000,100000,1
113GJBtihQYbpKQRirQFbHc48ZhaWjdAub,FALSE,0,121400,121400,1
113GawnWzhu9W7ghRnVFkxwyE7Tpwme8Lf,FALSE,0,85000,85000,1
113SqKPsvzUWMRqDoUYSubm13uJSsMUxXS,FALSE,0,60312,60312,1
11458vsEVcvxbeCqsuVVxWhGeCCqs6fCjd,FALSE,0,62700,62700,1
113Wou6VybwbRQ5vx2T6Nt84J5qNB9qid3,FALSE,0,20241,20241,1
113TzLN1mZWbaRScdbDWdnanctx8HMX1eT,FALSE,0,4219,4219,1
113mDm1dtZAgaBxCqGPEbEDH1faSbE5AFU,FALSE,0,3480000,3480000,1
113ncdW3xczcWKer8picgdKebK8AhYPMiK,FALSE,0,3000002,3000002,5
112steTK3Xx1FUvjRuwZKhNWaRB3KwZsdF,FALSE,6945,6945,0,2
113AeyrF5NcVKPxwLciQrVZxj598cYtR3U,FALSE,15274,15274,0,2
113DC9uD7yKe7VXG1Jf9ESVB3oiQiYrJSk,FALSE,0,52200,52200,1
112h5E2H4x93XquXEPTZAyS7hLxGaMRYQz,FALSE,0,7400,7400,1
113HUbzBaaAPTQQ7mpv2PSitBhoYuvtUrG,FALSE,0,1299,1299,1
113YoBmnufyYRnwyFY7nM5Ef7JULtTkKiS,FALSE,0,995892,995892,1
112emtVXqfRqV2KJuB1igcuDUR6X5JzFwS,FALSE,0,7081,7081,1
112MDkKs6BWqJ3BpNsuRCjyWFKQLT9k6jR,FALSE,0,1068,1068,1
113q7PWgNgmWYpMvrATDLFtk7DAxMSYzk9,FALSE,0,4157,4157,1
114Egx33GpUYAjoymQDAPzJufA7RzpHAyJ,FALSE,0,6000,6000,1
113v3XHCv1vb3ENL8gsKymZF3VnKra7sJ7,FALSE,0,1654268,1654268,1
112JTGdy6bzVzW42kU8Ghbw7cEMaWkNXpX,FALSE,0,665,665,1
112F8PdaMiJH7qy2QtHBz8FtZg4gpYPKkY,FALSE,0,26000,26000,1
1132fkoT5FVPDRsiA6kGvbzTNzWDnzs1xv,FALSE,0,1406762,1406762,1
112SZ9dHBz37EWMViS9jkXMm8sLGf7QMwY,FALSE,800008558,800008558,0,166
114CmckxnvBQahFDHqZqKAWcasHeL2NGcV,FALSE,8655,8655,0,2
11378oTDfeRUiZaRiVwNHsdDyvmz7Xt7W3,FALSE,546,1146,600,3
112XbKsTbH8rodzGz7dV3CRw3sGDwXopD1,FALSE,0,11151,11151,1
113YaCwrVJHsP4eD9dywSK6ypLtomRePY,FALSE,0,550,550,1
1131uSp9Aq2vf5kfxUCaP68nFsBoSoKByk,FALSE,365022534,365022534,0,117
113Bc9kziSdEAatNnqrpNUZEuKpdg76X9w,FALSE,0,247443,247443,1
113B5SF7cyQQqcaDUtP1yb3Dwgez6zeRNa,FALSE,0,22020,22020,2
1137wsthbgzdA248pNTtpNrs4yQxurhFA9,FALSE,0,30000,30000,1
112oXXaFAgBAe9Xqyoim4ryfbgE96zjmxg,FALSE,0,10964,10964,1
113cjHc9e9CLUeNRnUYsBQvzLD4nahieHE,FALSE,0,598800,598800,1
113Wtbg3eoxuQzbGEfW1ZMnXAbs58H1LRx,FALSE,520000,720000,200000,6
112BoqzpD6CddHfeXcng5fPVesSk5XBeaK,FALSE,0,1092,1092,2
112YZyPGiXt3M37Bvewbq3oF4H9UU8o3sf,FALSE,0,2349078861,2349078861,6
113P8DPRnp9bovhi9HqqnWXEQAUeEcQUnS,FALSE,0,5120,5120,1
112zEE1KhG3pxfGeUXPu19uhcTpZ6EyGVT,FALSE,36982619,36983165,546,7
112pEU3rNXVvjEdVY7QLdyY1zSRSzE7vY,FALSE,168763,168763,0,2
112WMkUjfK11jLnvThvN9oZkjr7s9JECtj,FALSE,2737,2737,0,2
112h88RiMKXf6y7vkKda1bSLbd4oUBvBbk,FALSE,0,1014355,1014355,1
113iSPvXUsjxL368shMFBmLHY7QBBEni2u,FALSE,467333,467333,0,2
112uw5wmonV8nn2zT1hZme6w86PcRpPPcw,FALSE,0,17359,17359,1
114AFPWCiVmyBDLTBuJnYCSD84yRG67yBw,FALSE,0,32329,32329,1
113N4Xx85T1PKc9FcK3bAGLC32JeRUYryh,FALSE,0,5500,5500,1
113KjgvvqBNEqNbcVcVkeUZLwvrjKBKeoh,FALSE,34675,35511,836,5
113TLPXLxNmRFCALgWAPMpLMeWMyNHmig,FALSE,0,5500,5500,1
112ZpapmRZKJfQrjUvccz5nd1r5eMbzveW,FALSE,0,500000,500000,1
1139CYQPNS3T34oNMGq7TSUHYLZ2SgoyCR,FALSE,0,5500,5500,1
11439LQJx1XDpvmC5wyuaTrAbRo7zxEn92,FALSE,0,113029,113029,1
114CJfEpBqVzHnv91Bx6jwYFYMeGmiUx15,FALSE,389018,409225,20207,11
112GtcnxKpZVf5MzJN7k9LPesGPL8ikJ93,FALSE,6891028,6919649,28621,3
112RGH8pgxfeBX4iiBLuqr3nhpcszgz5DA,FALSE,546,1638,1092,4
113GuB1aAaqkskicQjupkyoPmG8XtUpTPD,FALSE,0,91900000,91900000,1
112X2qGc6ajMc244WvAUoFLN41dxAy42Mh,FALSE,454141,454141,0,2
112uSN7we6Eb19v1iMzgm3EUYUGepd4Sg9,FALSE,795036,795036,0,2
112Rt3JDGmezmtmJGLhzYJACFuJkkKMcFi,FALSE,1123167,1123167,0,10
1139hdppsV5fVLQTN6MFf917agY8Jo8sZ7,FALSE,0,21844964,21844964,1
112CVC8GYYjYE1nUrBpP8kYaRaFnkXe4Y1,FALSE,0,15500,15500,1
112Hcwm54ez7zFipBVoSYnGtSYGqYTxjDH,FALSE,0,5260900,5260900,1
1147N7YK1KwseA2pur1s12Urr6rQcD8CFn,FALSE,0,1000,1000,1
1137AQGpxLs3g49ZXXt3gn2uhAQdCBHd6t,FALSE,0,48751706,48751706,1
113zUTPGxmkWfNbDkqVDg5ruDNF8emRmR5,FALSE,0,2503572377,2503572377,2
112KZiCo8KJwyRZJ5CzFXfPm79XtECNmcV,FALSE,0,113133,113133,1
112Cs9KUfzHTwkKrLcT3GUtrgg73P9jWcn,FALSE,0,2149776,2149776,1
1141s3qUKqmf767o3NN582bXtxDWkqkErR,FALSE,13261,13261,0,2
113EUeSx7dsHHRPeHJ62sn4cNTvCHQ6xrA,FALSE,0,207655,207655,1
113Jd1esbuS3Z67HtYSmUXARLdvJAk1hH1,FALSE,0,6000,6000,2
113YB464LQPzSSLj8KRWctVniHv2Dibg8Q,FALSE,9006996,9006996,0,20
112s8WehYcjaLn6oTX44Hvs9i1rZ566h8h,FALSE,0,1000,1000,1
113bMUoVomNDcNyvv1YLVF97dSbDWaEx4A,FALSE,0,117757,117757,1
112kKrGm4ifzu3JWL6HxZx3Qy2Vi8vAZZv,FALSE,0,16150,16150,1
112YmuQyXH3G2yooYJoBnVCkKV13TLs1xW,FALSE,0,1080000,1080000,1
113xhDKsKWZcPCfuwgoLR8r1XNfRwXthJ,FALSE,0,203263,203263,1
113wkzUS9cxbNBXRgHibseKUTQiq13x587,FALSE,0,36102,36102,1
113LELArgQc7NxpCVfVVKKVjGj6akjbUS8,FALSE,107160,181404,74244,49
112spMjGokot5i3UV9t7pxJkkYAgYaRnj4,FALSE,95968,95968,0,2
112ZtVkVbG6YZaSamTgukxTp8t3H3Pwx4R,FALSE,0,5500,5500,1
113Hmp1hHxbRirzxxyqMog4gdHbBQp3v8K,FALSE,43882,43882,0,2
113uABDEXB8QP38tmHESM9vcaaMguseDqm,FALSE,1142788,1142788,0,2
112TBuEmyfsjJU9c83bxGdxhxAMZPM5wr3,FALSE,0,3000,3000,1
112yS9CUWSYd3rv6YmCXrtGjfCSfRyc3En,FALSE,2000000,2010000,10000,3
112MGd2j5PxErjG34L5Wkn5javqdxpQ9ev,FALSE,425100000,425100939,939,5
1148VyuU1dziDJXaEYc4p3WRsFuiy48dUN,FALSE,0,1070661,1070661,1
1145MMLQtHYRj4c6uzeK2DefRtuDb8sXag,FALSE,0,550,550,1
113984fAvAgxP45niFh1zpaaW35gWBMtZX,FALSE,0,8886583,8886583,3
113s1d875qakVkr62CV2fNKqxfXCPh2W1y,FALSE,0,779,779,1
113xMYu7Q8i45KDyk3vVGjSfwjycqSKZSn,FALSE,0,50000,50000,1
114365zafKAuQrtmttDvFuf25ra24ELhNc,FALSE,0,15777,15777,1
1132nKwQ2wkWWTyYQaMapzbrye8giQDawY,FALSE,0,1000,1000,1
112Arx8xRMjPo4fpb1FNfGkfjUpueUFF9G,FALSE,0,168200,168200,1
112hQXcs9eiJRUrUz2pBr5FR2c6QMSYVec,FALSE,2520788,2520788,0,4
112pWjPGvk8rqmH4ayWWaeWnVnYaDKk8Ti,FALSE,0,1231,1231,1
113Jv3QTwnEh5MQ9tR413z8A1iTvd3BuC3,FALSE,0,32196,32196,1
113XQS4aTxNiJX8PbbaEbg27JqCmLaBdDc,FALSE,2778434,2778434,0,3
113Efw9YUmmKcjjUBE7dEbw1me5ej5xGYN,FALSE,0,1000005,1000005,1
11489GhsPXv6FP3MqvrM4c47V5zSMZGdGo,FALSE,0,76037000,76037000,1
114DCDJArz8rrQxG3APeLN5yj7hNuVCepF,FALSE,0,634803,634803,12
113wPywPKRqGzbsr8oL2RMTQJAW1YKRTxi,FALSE,0,864569,864569,1
112pgj2GETeYrbWjTZanjGgQDqScGkQtwt,FALSE,0,14999040,14999040,1
1139uQwhEPjSB4cXdkJqwRxo1jYwX55Mjq,FALSE,0,39465,39465,1
112QYTYgXQ2bnxadXh5q61zLru7WFD1aAo,FALSE,0,59079,59079,1
113PQzoCHKQQKUM9gVrRxNTtykUdUNd3yz,FALSE,0,643594,643594,1
114A8UqHQg97WVe4xfzobwKTz4EQwqEzKD,FALSE,213510000,295510000,82000000,26
112bQLaJvdYBJaL2SwhykZoDna2DSDjYeE,FALSE,0,489294,489294,1
113WZoKuHACs9D9rMPSSGViCqJbHTPhR9k,FALSE,20293297300,20293307300,10000,3
1143qbcW9amKSyhHceso49EhjpweBCtBc1,FALSE,0,49160000,49160000,1
112g6HJdEgu3AiPivY5QhsWJVnUKiUAR9T,FALSE,0,3554,3554,1
113L4NnTm3pZpXkDsugrVaJqekZNBDbtEk,FALSE,0,83326,83326,1
112sa9U5eGC9Tqi7Hev8ZqNC1jWwYyknv6,FALSE,0,1150,1150,1
113m9dyJXnjsZBo56zdSLTGKnbHfZpVXiE,FALSE,0,40000000,40000000,1
11458G2Tqg4PB2VCR6y54T7asx29UFYdxD,FALSE,0,1000000,1000000,1
113mszVug9s69PS93Qx1Aj92AnrC69Di3g,FALSE,941902,941902,0,2
113MqQ1yDtZhrDjwqcBqkS2MujF7Rd2Xkn,FALSE,0,8670000,8670000,1
113bsyPbfrWnkDQYhogxC77cgyrGQ1bpP3,FALSE,0,1981137,1981137,3
113J6fjrUuMLcDbC7uJLFwRnqYNotEXpmN,FALSE,0,10440,10440,1
113p2G8xrCoAQZGqatXvEfL6iyFuUM9ej,FALSE,4742600,4742600,0,2
113xcnGDivDeU9ByhY4YAMEEorzNHJqh7a,FALSE,0,160244,160244,1
112mnTWVUaB8aAJdYvDTyEPHqGYYT5rwHm,FALSE,104309476,107310778,3001302,2020
113Git8P8JY2wEFWfhidTgYZUx2NRSeymB,FALSE,0,1000,1000,1
112r4tfeW7Ks9t3zynJ6zGz5PF5Siue9k6,FALSE,0,3811,3811,1
1137JxcuBv4HmgC96JxRAEsPMjS9MK5Rx,FALSE,0,30000,30000,1
112X8j2h53cXVgHeAyRKScG854x2MAGaZc,FALSE,0,677,677,1
113rZG2jBLn1KrKCHK9xzLu47Cb6TZ8693,FALSE,0,1002854,1002854,1
112JUZeJqb684X3Mi2hdkj5MnwQqyHAtr2,FALSE,220000,220000,0,2
1143vKvYX3eiDVGL8T3MSZwwyozdASBDCC,FALSE,0,803817,803817,2
113iPA3cQ5wr92jedDv7CBF4fok3WBFu37,FALSE,333574,333574,0,2
112NRGWuSF255hMqsKJKtQtGq94MHa5GNd,FALSE,0,6274,6274,1
113hLKCp8sHzQjPto9Ztghi8NhpKhr5iXp,FALSE,0,952,952,1
113cDzHgXEbEb7ZSDmavBrBwPUVio9gnoF,FALSE,546,1092,546,2
114QqSmYKgGEA4CAgAqPFPXvxtNwGxanvc,FALSE,382949,390000,7051,2
1134re6nYsMTeU1X1mQrMw1d9kmyBDosFn,FALSE,0,41423,41423,1
113xGE6UtkUHSRSnbzYANuKK8tbfQLkQ4h,FALSE,36034764,36034764,0,2
113EtmzZpNVAMG33t1uAC1TYgvoCYqhBap,FALSE,0,126582,126582,1
114fka35nqVBT8sztVyWFvfTENXpzYESzP,FALSE,0,497802,497802,1
114d71sdcskCRGXpKZryzxyt6xg7rUozVn,FALSE,0,229207,229207,1
112nx5S4oogXwPnDkcqp4m1dXc2WqYk2br,FALSE,0,5500,5500,1
114QRVeFXK8ioWNggFLoGDA7cKXJX6WA3b,FALSE,0,34900,34900,1
114n4zbYrqA2YzNHXqPyuxhfhbEG4zJkBZ,FALSE,4100000,4109060,9060,3
113EKCfGuQTjPvs1RTg67mNmaYQLESKpB3,FALSE,120699,120699,0,2
112iuYD5v6SAp2YcCdb21AWUsCyNDhFWEm,FALSE,7366,7366,0,2
113JxBrDzgve4DhE4Mb5Zph4rmxWFhubKP,FALSE,2951641,2951641,0,2
113C2BTuis5XH3CKGdtYBmtKtbEKipwa4,FALSE,0,5480,5480,1
113eBtTF1h3nqNzjnbERrdG6VmTz8yoRAC,FALSE,0,134293,134293,1
114p1fxvCFqd9JQzBAZRghNsZ7vLAVh5J6,FALSE,0,4973,4973,1
113GjjiNBxwxwDdYM4t2baSG6XCPVTt3vZ,FALSE,0,265631,265631,1
112yF21KUnWLDEJMtdiHwC3F8epMubVjYu,FALSE,0,41854,41854,1
114ka8Dnw5UjAzPLjU1YPmTvY6jsU8zRwA,FALSE,488093,488093,0,2
114eYdG8ESCfjMsqbT91EweRyrTr2aQux7,FALSE,0,2581,2581,1
114m3upRFds1eD2LNPHFiyM1Ldf5VgJTJo,FALSE,0,92422,92422,7
113j4hD5sRyC8L88qLyCiDXQpJbz7MEDRn,FALSE,20992432,21123956,131524,28
113y5HdK659R5qZ3KhRc6JLGdxKuQHjN3y,FALSE,0,7448,7448,1
1139wHETpi48kVogGaexXt1VX1BbiaLeyJ,FALSE,0,2270,2270,1
1136WVwSkiGSvsknJUcNiJnDYNguY4ujSj,FALSE,0,72660,72660,6
114BajXKCHqbh9XnQKw8U7RBfgVcSHjpNz,FALSE,6822772,14020474,7197702,4
114dAwA56CVzpDDZ2ugDjRMhQYWL1Hx7ZQ,FALSE,0,797792,797792,1
1138LJJmMyXrNGsKHRJgihXcWKUAeeTKjS,FALSE,0,25310,25310,1
113cRKJzFTQBYT1gwZeEJoXx21LfNQKRsQ,FALSE,0,19758,19758,1
114W3SjhfnHDatu6DnmprSLyKNTdwYM2fS,FALSE,546,1146,600,2
113355qWw382fM6HW5BDxmEzJmbTQR2DKg,FALSE,1729272,1729272,0,2
114hLm22rutS5VkJguotP8ZedDybt727qh,FALSE,0,227590,227590,1
114n5qfmiwEfezWQW1ZYHcGA7qkoSMDpgx,FALSE,3676,3676,0,2
11372sNPRFAHf8tRiuHVUbrqCCxEAGVLp,FALSE,0,1929913,1929913,1
112yRmNT7J684KQA4GGoFAbC68FuxYC51L,FALSE,0,710000,710000,4
113JEuuLq5wcrErw3s1pdVHgNPqgMPWF98,FALSE,0,7444900,7444900,1
113njseZAxNM7y2iaFzP2RLuZMjREwpeUY,FALSE,804411,804411,0,3
113Uy5nXBcJGNbLYJzU9nVCG3wgXkpVhAb,FALSE,0,619,619,1
1137yUHcqtz9nvQm2BiBK8ijjgzhihwkQz,FALSE,0,1000004,1000004,1
114hr7VW6KhNV5tnGaBXXfWeGpBWj8t56g,FALSE,16002420,16002420,0,2
1136m9RXTHTsn3yejbGL2JVsgx89YgnGQ2,FALSE,0,915165,915165,1
113fZTtYr1mBJKcSaTCiv6ubHC8nRMdcpy,FALSE,0,174630701,174630701,1
114X57A2aSDSKS85A8G9KpPF4BFcUfzKsr,FALSE,0,20000,20000,1
11348D93u6a3nBegKo3YEx9RFfy5Q9dXQ6,FALSE,0,12866,12866,1
114fy4pGMpG1SiCu4Vi5z9LaVUiB3Yt1rN,FALSE,16580,16580,0,2
113XP7meWj9w69XWB9yxZGHGAqmoHYBJuS,FALSE,0,14337,14337,1
114dewLvr4u68JykgxoeESvUqDh4pj2Vjp,FALSE,0,31714,31714,3
113K7krag6ey3MssegUT2MHNDHqR3ayzpe,FALSE,0,1000036,1000036,1
113NoAPXKdUk83TmL3ZUyCRUJZ4H4Uuh9J,FALSE,0,10908,10908,1
114EtoZ5dYUNHbQAZHZViBwH39s7kPrmbV,FALSE,0,10000,10000,1
114YpdJFZgVmWYvbDx96f5i1jDYzSra3H1,FALSE,0,6618,6618,1
112mKPDAu5SeB8PSLPCPyKuHH26AiX5DuP,FALSE,0,625800,625800,1
114iUVgbr855prudGpFTyYSUXYxe6bkkD7,FALSE,0,31385,31385,1
113otrC3TvpPc7gnxt9LirvhU1TVpo8kC2,FALSE,0,10203,10203,1
113FfXJbadUrMMDWny7LwduyFeQFGsYDbW,FALSE,0,2189,2189,1
113APaC1cx2w1NYry14DmpAkndGNvrS95V,FALSE,6896690,6896690,0,7
1135GYYoomoyGUkPAtyboRsrJzV2mkFtHu,FALSE,1092,3822,2730,9
113bqTxeVJV7Y25TCyEBvkUWDT66d9vcR3,FALSE,0,747,747,1
1131d5jYvoPAdkVoTEv5kcC2HDmUhqe2Y8,FALSE,93510000,94448929,938929,2
113c8J2Wh9u2ki8Ahtfr6kfQCuegTHeto1,FALSE,0,1696,1696,1
1146sndZXZNwoFniMkKHQtT3hfmXRJbDmU,FALSE,2162200,2354320,192120,4
11378NdfWJi66krLuSCMczw4HurpD4TvTG,FALSE,0,4098838,4098838,1
112r29WkUuFvHbFUjDE2gzqqrFeoGRG6S2,FALSE,0,132687,132687,1
114UJHA2sVLFX8FbvzokW7RiBnargA7q8m,FALSE,524603,862203,337600,4
114BfojJ3eQ23bteneqDbZssgqk1qRn5ZC,FALSE,2528600,2544229,15629,133
113yaWxEjgCo7whGn3NPvpJ1LjBaXwrypr,FALSE,0,597914,597914,1
113k3pLyvek8EuUFmqHnZ52wLhDzYKwL4B,FALSE,14069511,14403700,334189,8
113fsP94GajAswE5a4fSKbziDxo9UEoyop,FALSE,0,108311,108311,1
113cduDoYJMY31Fe8ijNtN14N6vWz22pav,FALSE,445775,445775,0,2
112zS5opwcvnYw7LJUfdQT5MTuEkN2Cxa5,FALSE,0,1617,1617,1
114kuWiwvxbpTETuSqVyb3ZnG58nRh9o2h,FALSE,0,280000,280000,1
1136tJsmjSJCH3bCXWkVDJw49fLi81k2UN,FALSE,6562,6562,0,2
113tDm6Lkw1Dv5FeQMAr5aJBHX2q6tq7Z8,FALSE,0,5847,5847,1
113Qba4W83p7XKJCBAYdDXs9Erg9ZZkWek,FALSE,0,65979491,65979491,1
113aihWXvBZSdpnnE3jQmbkGFHfucbbNK1,FALSE,150000,157399,7399,2
114coGc9Q4d9GvwEKqVUz8oE17zBjhZ9wm,FALSE,0,10000,10000,1
114iRbTbhryw9sJRrwUJ2MKBYit9bRxTGt,FALSE,16236108,16236108,0,10
113FUYW88UjdK1CMDUuyLtggmSDxeVVJLq,FALSE,0,546,546,1
113bwngfqLahVikY3rLhuGzYf6PUjhcGEu,FALSE,0,13230,13230,2
114a5eJsmyA7W7pMo9SsaCLtMDx48zfvie,FALSE,0,1280,1280,1
113qWzSjuFPe5Ky4U3NNPrLUknq8KDSprg,FALSE,0,939,939,1
113Ce22hKYoY42sYyXtQrxkFbFv3r2kKLu,FALSE,0,5480,5480,1
113rvPhTkue8ny5AsZGuc4yWzFp7bJwx6T,FALSE,39371,39371,0,2
113ph2aTjvdAhJdFb4pvu5MXzZWbozcgsg,FALSE,0,80063,80063,1
114BHtLLusiSbT45TtUCBZ3nbagHfpMUVi,FALSE,3185261,3185262,1,3
113ACnymaSS8xn9qjmQJi6L45zPxvoXUCZ,FALSE,0,1000,1000,1
1148hTrHP7139uN4FsWoHLjFDJcypvEURC,FALSE,0,306143,306143,1
113n9stjm3VtYgKvLdRbF9tVzP1rYWYb8m,FALSE,0,88760,88760,1
112t6ybfN5MRV4cp84MW72EjfcoJgBKpuL,FALSE,0,97522,97522,1
114CxmuoDR1JuhZHo12fY2WBounMEWyFhv,FALSE,0,89430,89430,1
114aHmXaNaX4FgFLRzGX3qbkbKVgmK5Wzj,FALSE,0,991,991,1
114DmFE7omru1X5hzEKDcmos9o2ifwySkZ,FALSE,0,1000,1000,1
112tURhFf9zKocE1DT3McDGKZxWumdtm1y,FALSE,546,1092,546,3
114FxRT1nWu5HTmNjwCWHJ9LNGioLuF9Wr,FALSE,0,330160,330160,1
114k59QzWWmtva9bnnKjK5A5FwxqppqUvc,FALSE,0,126660,126660,1
113zdT8Aog3BfAzhvfwQWXDHBTFA6W1cdL,FALSE,0,2284099,2284099,1
1138YpvawS2A7reSrZBQCb15Sj1AGXocxw,FALSE,0,2307,2307,1
113m3Mr885pLjsBgGuXk23D64C48ktfxAn,FALSE,0,71765,71765,1
112r1eb3StRvXFb8DgfkunfuEdZ2sMbzD8,FALSE,100230920,100302730,71810,8
114mA5WVdiEKQY6dXkb7HLdfgL2CqGLS4A,FALSE,0,5480,5480,1
114d3zRzBmA61Q3QjVmpNyVWJANZAGGabY,FALSE,0,77164200,77164200,1
112tp2BY4JqYQzqEFAABP3pjnFjYZJ9Rb7,FALSE,0,63000,63000,1
112rffBn8SEpCr5LugLGFQkL1uJs1H6Ejb,FALSE,43316558,43316558,0,2
113qz7nvL4m5QLxEiwm1YDed713MVyhu3Z,FALSE,0,14509,14509,1
114J8qbnRfF4h1YGUH1HaPaQLwgEwr2fUp,FALSE,0,4742,4742,1
114X7ex6jzmKLuvXsDdVPSxi142AsSg5Y7,FALSE,480000,6680000,6200000,3
113FCD3XaUKnETnvnKLyX1azUhH7JYwnqs,FALSE,1403848,1403849,1,3
113Kr5B5Gg2fBnDGtAsGU3RkF9bdvRzgG2,FALSE,0,838966,838966,1
1149gYM3ZbfBMAe73SZmBmKgthbw4tUTHp,FALSE,0,2002,2002,1
112xEokWhQqsmMD6JEvAPPUUPsFnT2V2za,FALSE,0,10000,10000,1
112ud9FXZsnNXja9k2JdGEgVm2k7Sh4nJC,FALSE,0,850000000,850000000,1
113LovSZAzc9ymVADERE8DqFL275jUiZy3,FALSE,0,150000000,150000000,1
114PtdjSYWSMA2HmXDBYwrNExtw7GsXyPn,FALSE,17626938,17774781,147843,76
114huiWQjWd9dV55NNiBN99tb8hL4ijnfW,FALSE,0,27782,27782,3
113nCvUh2nSNGCzijfHv5iD2G6CtxUdH2b,FALSE,0,2034054,2034054,1
113uTKV1MmnkaDQkShdbN1KRi2sBxT2QDQ,FALSE,0,5500,5500,1
113pEnSyGLNUixRqGtt8gB8JF2W9wvKhE1,FALSE,19550000,19550001,1,3
114jpTMh2Rjt9aAqYHb3p5wagsjSCCjXLM,FALSE,0,5659750,5659750,1
1138iLRpDTtr5XVfpfJk6LEmgCqkEcPSAQ,FALSE,0,5500,5500,1
112hMDUZFCoT4K3NbbEDJx6dgoKC18W6et,FALSE,0,314195,314195,1
1144feuuXo5YkR65ng4Kr3bxUXvEyq8mDF,FALSE,0,34401,34401,1
113FCrFxbAQmNAq91mMuoKMswN4kJuUE74,FALSE,0,643550,643550,1
112wBDkvW1LVnoG27ErJR86RKn4DUwiyap,FALSE,0,250000,250000,4
113iQ7qDcYwCKSA2NQkdgjGFGee5H5CqKS,FALSE,0,59264,59264,1
112r926toD8DMnnb3hxVHQ1dZ3WhQAneDk,FALSE,0,1493390,1493390,1
1148p6avAAvghsDZapLKVW2jvzb5SjfMLH,FALSE,1961669,2211993,250324,11
112zuyYKxt88VBLmBVqZz3vpsFWLp4191w,FALSE,0,205300,205300,1
113XGizUKQ7p3DGAGKdDVqhaTy8mTUHCK7,FALSE,0,893758874,893758874,3
113ggETD5eNueBzH8VyTKcxW9JJkwvV1Ya,FALSE,0,22543,22543,1
114hdE1Dv1jfRFcutN6xQhpz45U7gzEw6T,FALSE,630000,630002,2,9
113LfXF7sjXZFcKm3UvVu5xknvtGXsgBpM,FALSE,0,2235217,2235217,1
114CQ7fPUgE6yFRcA5gMasvUhn6FaAWivL,FALSE,0,850000,850000,1
1134iBBe7oLJH6YwLiRBCMjiQtkFjRfoT7,FALSE,0,8984,8984,1
114g6TvePjbrdHkyUdQYvcvePmvQQuky5U,FALSE,0,5100000,5100000,1
11362hG8D4b1CTUeEN4YZYrrQYudgNzZi9,FALSE,0,12985030,12985030,1
113hEQ3f8hghGE3VhDXP12RtPTKBjm2j3u,FALSE,4904300,6203663,1299363,4
114ew7V1wLacfLhVnDxmhEWH2s8sdvcqNK,FALSE,0,717000,717000,1
114Hyg182T38ETfnrGUWisP7qX6qXaLuj4,FALSE,0,56819,56819,1
114CFf9i2YMXPCYz2R9mKazoBjFYMEhPbd,FALSE,0,715,715,1
113tN7UGKQSC5jtj7MhVLLgCJB9sXa8Du6,FALSE,0,97402,97402,1
113PxYvopzh2MkpKxYpCVhYkZH998xem9w,FALSE,0,548,548,1
113pCsT4EkGoFTr9jd678tvWDJP2ySxDBk,FALSE,0,2500,2500,1
113jBC4cAFsywZg2kB63dc8AbCrFamGdKU,FALSE,0,30430,30430,1
113HKuiNDzWnUW1CYd66XF8pTJr7NgNfH9,FALSE,0,1910,1910,1
112pZ4WbPwgXPFeq5cFCmm9bcyWBCgY3z4,FALSE,301691701,801691701,500000000,5
114AgoB88uqDy5UXHymMfGBiRLNqbpY26N,FALSE,0,184722,184722,1
114nsjQj5whVLFSX14CyFj8ZRBzSCpBWsy,FALSE,0,84662,84662,1
114m2JQo6TekVqDBWY5FAieSZYqnyK5vCq,FALSE,784733,799060,14327,6
113CpgU3ekinsxRhxgFfv1ZqGkrAsErUuC,FALSE,150000,158589,8589,2
11396S22iUwRN3bjX75btMZHAye1oyThf,FALSE,2689505,2689505,0,6
113PF7ShCKrHseprCVW5RLwTifiCyxAgTc,FALSE,2509114,2509114,0,2
114nZkcPzA1SRz4e4UxnhTe9nhRh6hgzJ6,FALSE,0,1,1,1
113tp9kkEMx1v7KiyVmtQuLpnB1yeR3Lh,FALSE,0,105074,105074,4
112pioJ8MpjxGuS4e2h2Ew3tBWzpkKx45Z,FALSE,0,75120,75120,1
114fvhXvN6FD35XZPdPn1nGAcW4nwoRg8g,FALSE,887110,887110,0,2
113XbpKmZmb6TUZH6e2vbNc285ss9nez38,FALSE,0,100000,100000,1
114MSTG6Haj9ALZW7mgZwW6F5JKi9dTfUm,FALSE,0,1817,1817,1
113rg2k2hWkgan1GJ9rNTtmRUKGgZVa5x2,FALSE,18809667,18829673,20006,48
114P42yZGeB3Y7bQJgtDsygNmjcAoQrbWz,FALSE,0,13630,13630,1
114cYjh9L8e2mPBKeJUtJvbzJ4xsadXtwr,FALSE,0,3391116,3391116,1
113Lo9YkRpa5uJtyhALpdo5wnv7KDL5sMb,FALSE,0,4334400,4334400,7
113apFwaTsmtzmax7RoUy68gnyeb39xTy5,FALSE,216885807,216915807,30000,4
114VMgsvVp8z6CEWz6RVUMifJajbxBN4J8,FALSE,1334920,1334920,0,2
113KiMfgVyasb7w1PYBik3wgY9wPoXdh1h,FALSE,0,52804,52804,1
113VjtebPkop6ofHKEedGwLZLqGiJutQrG,FALSE,0,5500,5500,1
114FUBhVyJ5BYcwiwttGi6Cc7kFMZwytmU,FALSE,0,18710368,18710368,2
113miBtHEohqrshkTU51PQwDoZiEsxVAwC,FALSE,16684,123276,106592,14
113mUfneaSDSmW9SendCmD53VKAEzPiS8x,FALSE,0,58860,58860,1
1144ghcBL3PmvtQfUcaU9N4sitpYjawtom,FALSE,0,5480,5480,1
1147TbyLKNmpSzPPnxgviCDC6KmQdx1PaJ,FALSE,0,1000,1000,1
113fuTa2oNQiwCRVGMYRMP7Jxb3cLvf68Y,FALSE,0,442710,442710,1
114LeUH6C98hMvgBun5YBYuExPUxCDSB3T,FALSE,0,965207,965207,1
1131rWVo9WU3uWZKxLi4C4ME3skhZCAgUU,FALSE,0,9733,9733,1
113LJuCYkkQK4yzQZK8XEJDFz6hfiQsmSd,FALSE,6894300,11161880,4267580,3
114QhNriYokPYbcNrjbx41g4hSyCsJ74Ki,FALSE,0,5626,5626,1
113x4bSiMGEEZUHB1MJPw1nQZFkj5T8ZCj,FALSE,10649799,10805236,155437,13
113RCt27x8Jyu1LtmEBZghpABDXgeGxbfD,FALSE,5405381,5415381,10000,7
113qEftmwop2mS79KW5TnsYBbe3QaZRrf2,FALSE,8630,8630,0,2
114MUukj9DnkawDhWGZXXJePHSv7RrYrRu,FALSE,1156738,1156738,0,2
113VyHXLTNLHYu1hRFzLjVG1CAc4W6MyBx,FALSE,0,6199673,6199673,1
114BvyLYYcfjVnxQ4JkMXErjpa4FvvquZh,FALSE,99900,100446,546,3
114kcEaVXDEiywTpGTZUZud73QGhDXRr2B,FALSE,1244708,1264708,20000,9
114UyftGELDpwhpDHCixxtroP76UAQtsQ6,FALSE,0,5915584,5915584,1
114cTK1HcZvQ4NNqQJ53Tsi9GSpYwKaFUc,FALSE,73271,73271,0,2
113DwhSghnZpSYkFWmXZn4JwHp72WZgXTp,FALSE,34084524,34084525,1,7
114jsiqoy87dsF2FvGDGgB46CCqBRKGrJL,FALSE,0,391517,391517,1
114keiRnbm3FYNTFgwEe5fHfVoWNFdPe5q,FALSE,0,24272,24272,1
114Mw1QJtPu2QkJtKQppkx8EpMnP8ncTzb,FALSE,0,17508,17508,1
113Wn7fXBgf1hBZFDcaDqGhug2UPZQ3RYb,FALSE,0,1167763,1167763,1
113QGk2Zg5vbjjPdRX1C5vnnv19ML9Ek5r,FALSE,0,6613220,6613220,1
113LXvE63n7ytwmLcqGVkSQSbNNu659Zvx,FALSE,53428,53428,0,2
114VHKepoUYtmMCw9TES5rMm5KvELPvXhD,FALSE,4037,18546,14509,3
112jgpgi9xHJqrsJyU2VeojcyPZHUt1J8m,FALSE,0,1173990,1173990,5
114FVrMsy6CXv4QRRdueZX8FXBx62niXB9,FALSE,0,2836130,2836130,1
113BJ46PEQLJbSR2DcQLjgwWH3b3sYH5HK,FALSE,96103755,96503649,399894,9
113VwM5oeLoTVitLSyTXdwQ1xEKTNyGyFj,FALSE,0,22816,22816,1
114JJGpYuRKQMbjt8pPBtWymfvtoWQEbcM,FALSE,1092,1638,546,5
113qJNqxEZu2KMyuwyt4WbFtnNJEmczRHH,FALSE,28938,44226,15288,134
113rM4B1R2mtqKArEopPUcEox1yCX9RLBR,FALSE,0,2952000,2952000,1
114nYfHRc9zUXNAvvexbsB22Bgmbi2U8XV,FALSE,0,9000,9000,3
1137AZaFcbLyfib9rhuoVVsGyC7gNAjSgA,FALSE,0,8160,8160,1
11373tUbPdh3DnpZLrpS5sYehvwMsc55gm,FALSE,112333,112333,0,2
113bJaLHUyM6dUyQ9BkejVWah3asrY153k,FALSE,44389,45085,696,26
114EX4fgWf3sQ5a14JMxfH1sDE9suuxGRk,FALSE,0,8758,8758,1
114HfG4MWxndboZRpsTMgoFkj5QhNAqejd,FALSE,8190,9828,1638,33
112nzQgn17rUzbNx6JcswD8TL5Cb2uPkQE,FALSE,0,144796,144796,1
11339AQt8c1gLRqAAc6mPb5CsMuiErRS1C,FALSE,0,8743,8743,1
113geo6kiftaKLg6Vw3hCiF1KsXJzMaw4T,FALSE,1001092,1001638,546,7
114Ze9gVDzNdMCWaE5F72m4QRQSUDV7HSd,FALSE,10845299,10845299,0,2
113j2z7b75zQDXQ7qaEa6tm6sH7eoVUatw,FALSE,0,10960,10960,2
113PRwoTRJXr8eskLwt2d7swCYqC2TEfu6,FALSE,7098,8736,1638,29
114AVvtsNeXX6WH7xJvEU61nGXtKngx681,FALSE,0,4892377,4892377,2
114EaWJrZnCxFe36ijTTKJCPgaEAfpWj2G,FALSE,0,11395,11395,1
112xQgS5i42QBXd1xHvYiyDABJS7HLACTe,FALSE,0,3000,3000,1
114mnzYvWzRPnw84GpJMerZBPQ8HrSmRZ5,FALSE,32166,37914,5748,18
114RwKYytLzNVJNiNLH7yx7VTMvSEWPU8b,FALSE,0,3770,3770,1
113dsW7pohawbbNAyXMj2UBTMFGL9qxSrW,FALSE,0,950966,950966,1
113FYRUbxAhuJZdGX2zZZxUhJfa3U94ZfH,FALSE,0,118400,118400,1
112pXzwQ19yMSi5kxYrj1GTTwE7XdSDDXE,FALSE,147272184,147273822,1638,17
113K7DKDyUutwBX6TRSJSu8ktbpf23qWzm,FALSE,0,84005,84005,1
113yJm1oSP7HEYoLjMHXw4h8UfPMo7fbBY,FALSE,0,1000,1000,1
113MJk32fonWyAiZoi6TVGUaGfy2aMKMvh,FALSE,21451004,21460066,9062,4
1138imGjaBiLazCYAqFMu94w2XaxTcgqAf,FALSE,13835,23016,9181,3
1144Widin3pXNHkN4wm9iZHjyGhnri9Sym,FALSE,0,4000,4000,1
113i539dQSQvmjXbBZQdkywDQRSoVCC1w8,FALSE,0,1000,1000,1
113U1DWRE32qR12sdkS6YrhGiyXhywLKCo,FALSE,0,6400,6400,1
113ysGjDie8f7RNkmBrGnUEtRnTFHHgVNZ,FALSE,0,7668,7668,1
113i8KvzLMgpWZim4vF9s8wBSoyUvQ4r5q,FALSE,600,1200,600,2
115YjMvniPWHZpaAwqVKmog28YDV4z7d51,FALSE,0,3683297,3683297,1
113vUs8gkPGup6PVf2hSdD9DUMgQuSVmF4,FALSE,0,1718000,1718000,1
114hm8mCqL1ygxJ2oitsfq5VrE9S5GrSF9,FALSE,2024247,2104600,80353,84
113bPDA4z34a7ZqgGcJQRQwPv3GUyjHw8h,FALSE,0,87517,87517,3
114pp44RESR59Ncg9s4tPkPHWNGttWRpFa,FALSE,181903,181903,0,2
114JdfCGAkctgQkKJ4Tpu4jbwAwBquQ7CU,FALSE,59044987,59420580,375593,56
1157jzSqVahvwc5imyKtxWRty7CyRDn54N,FALSE,0,1735,1735,1
114ENMwF5UUjMWnatfPUq2HQgURbFJdFAe,FALSE,0,4151,4151,1
115HVSrMjZYvQ68D9grXsZRoavxGBTkK5H,FALSE,0,3641343,3641343,1
115HcABBgw1qQZSCcBjCXsG1CETrz3AE5L,FALSE,143556,143556,0,2
113rkghxuW9iSFun4YVLKVLbWrboWtTAuV,FALSE,0,51262,51262,3
114x5E6ip27oqZxLbfxJJGmzkuhqGVL5nb,FALSE,0,961,961,1
113pMUXdXkYMCCSNAPHzW3VoAt9Pf4Bawb,FALSE,0,3713152,3713152,1
114NNyhXMfHtFDzzyi898Asr4L2pVQzNNP,FALSE,462260,497548,35288,10
114yvrGePU3mbUuweR95Xff2C91AzdXTCs,FALSE,0,389960700,389960700,1
114p5w7Tvev8T3XYAFCQgSVQhoiKpwtMQq,FALSE,0,1000,1000,1
113mjdECGsxm67E4urVxcAHaaA3vLoF7uZ,FALSE,0,639863,639863,1
115DZpF6u1yJ5sGPXuxWmewCiLBjZU9pSc,FALSE,0,261036,261036,1
115PDHdt7HpPw7bqkfoCNivXmNRj4esBj8,FALSE,0,688728,688728,1
115BzipHJKB8mBLZGV9iLGqgBujHo9NVLA,FALSE,0,546,546,1
1147oUqjq3fPHWeZhRNzi7dpghSSbsFoY8,FALSE,0,10310000,10310000,1
114Quwajo8peKB212qZD5bxeUH4g1FJro6,FALSE,0,393370,393370,1
114ioYiCsNw71g4mhj8D3Pv2aUAkHpBhjH,FALSE,0,51985,51985,10
114vYiTWcsGWzzPzUSSnnrKLP5rJuS9ayy,FALSE,0,167029,167029,1
114DkJtJ7vsSXQ712ukSf8qace9ZQNPysJ,FALSE,0,5963,5963,1
114M1Lm9aMqTyBh29brqZrBMGW3NQDEz7s,FALSE,4541027,4541574,547,3
115H7uLhNHz35PMoPFrD3ay3L41z7CeF6,FALSE,0,1089302,1089302,3
114uPsePSie4TV2wdHjvoJaaS7xTMXsp61,FALSE,0,2612400,2612400,1
115AyawxLPV84fph4dYAegFFDtvnB4DPP9,FALSE,0,200,200,1
113jJNYvkjeE1dJQwDJvs4ML1KJ8oNyrjR,FALSE,0,198000,198000,1
115CyEjNg4Km4RH1Wug34UvFsJiA3TmuNH,FALSE,0,283343,283343,1
113eR3PMud42XPUWVSamrLxuiRgocshiRB,FALSE,4722737,5820414,1097677,2
114W2AE6zfS4D7FjgeJTKD33Jbk7q4o7om,FALSE,0,143707227,143707227,2
114P8zqvWsJAuDzrheS6z8GTtwCfKfeBnF,FALSE,78491205,100380705,21889500,23
114dms5Emv5EByqWQiwx6dG7ZfPqf3Fje4,FALSE,0,40769,40769,4
113eyVSCACq1kvJ97HBLmaFw1u4yprC35f,FALSE,0,11334,11334,1
114A5cBxEVqVcRrwwcoPZU7qoDbcaSyqRA,FALSE,0,196760,196760,1
114BLCSAwV71ky2DedPC3Y1LCqME5nWX1h,FALSE,3000,3546,546,3
1156ttxctEKvmaKgyAGY1tK4pGuVqomHpr,FALSE,0,1226,1226,1
1156X7VK2FVJCTWQGji2SNnowQoUE7QnVz,FALSE,0,80772,80772,1
115Yn8Cn3zCaVZy13W6UJxvfGJYHznpj7p,FALSE,2818704,2818705,1,3
114ccaBynq45NxPuDFjGEsonCP7DmMQVmg,FALSE,0,1000158,1000158,1
114sBHACzFvs87FWtivdfEq2dn6s84zcKt,FALSE,0,284439,284439,1
114YeZEeqzWJk5MfHiwotTaXdKDsCRZVdb,FALSE,0,1000,1000,1
114FjujXHJaZwQZD8cJf4mR8b6YYLw8XQW,FALSE,0,84435,84435,1
115JGsV7U1VmtUAGN14rRkAaFphcR46yM7,FALSE,0,81089,81089,1
113gaX5dTaJZYHipoxCDSC31MQXubo7Mzb,FALSE,0,355491,355491,1
115QZHoJep9tsoBPxD3FrbtLofKyxdAc9T,FALSE,0,10000,10000,1
114GCjhEfmSkVHqWt86Z5qYZvoWtNVnzcE,FALSE,0,5775,5775,1
114Z1xKJdrBXo2GWSPWmUavB8MTzJs4MBz,FALSE,8459456,8459456,0,29
114F49C8epuMCo8pQWw6S1MCsiHm7r8zp2,FALSE,0,916083,916083,1
114nV7wJg5Db78na1xf9q6iW9fG4bWvthU,FALSE,0,4159,4159,1
1141U11QLsQBwJJjZUkymP2Kr52JcinSGc,FALSE,560000000,988000002,428000002,16
113yxZeRpJAQp29q8BhTDkr9RqXxtoxVxo,FALSE,14699730,14699730,0,2
115Lz1ceyRu3x4i7qyt1oxkRuLK7ziqNeN,FALSE,0,4909500,4909500,1
113oUu2JtXAdN5eu9ZLFqoR83UCRtPt1Yj,FALSE,1802388,2116207,313819,8
114gg183CZ1R1E1zKykUDbm9cXTkKnq7HE,FALSE,0,100000,100000,1
114pTqAhuFu9dFrKFuBbqmLztoLcuhNfDA,FALSE,1178736,1198060,19324,28
114fn322oWntCxJshzF4KxcWkL3YzUtR6Q,FALSE,19152462,19168575,16113,3
113zd4c3ZhHe4PKbbFzE8Jgdk2sKo7VDnC,FALSE,0,433309,433309,1
115RdEqMG3UN3K7KnPtY6kHtWtKCiEVVvQ,FALSE,0,87570,87570,1
113dNhK9tZXbLuauHa1Wb1PPNn8UH4npnk,FALSE,0,162674,162674,1
114D34PrVUgcUL2x94TwwTABV25Q9SgG7e,FALSE,0,58440,58440,2
113bXWaBYbLUDKMLt57SBvmVCHrx77m5Fq,FALSE,0,150000,150000,1
114dC9Vf5Ft1aPG85t7jjjTTqVCZhiTBcV,FALSE,394013,394013,0,2
113xXNohJkah32S5qDGXu6ov7QnHS3MAAC,FALSE,0,36318,36318,2
113fytwrSERg2ojuiQYTKH7qN3KySKjCtQ,FALSE,0,1000000000,1000000000,1
113bXe6NDtSZUoWvU88gsh2FTRA67CAFzh,FALSE,6424733,6424733,0,2
1152w16VumKrSuP3JtFJ7rMpp7vHdecqnz,FALSE,0,182980,182980,1
113xK4wWHMCvySVW5TQDAzNU84qmLy3PZH,FALSE,11696,12242,546,3
113xTA1pf4Xm5YHkusNPa6zztazGkmp3K1,FALSE,12000,19092,7092,7
1151mQptgRKNvYBCgNtzvV8dFJmSuRpPRF,FALSE,0,686,686,1
114B59umurzQDMq4wKLydyBxaxmPGzP8BV,FALSE,0,1000,1000,1
113zuwTP7Ej5tDDK5qYFjNzvUX96iTvQqF,FALSE,0,9034,9034,1
1147ucdy5xB2YXYUFHEyLftFczLK9EWfUU,FALSE,1342514,1342514,0,2
1147swVyQeFj3tKcKhJnn7LsbqNuUJXP14,FALSE,0,2000000,2000000,2
113fmwgQoYCtSD7gwi5BtweFccbWr5KXiK,FALSE,546,1092,546,2
114w11dGa2cEyPCUn9RUvZhnB2Q4TZFzk6,FALSE,0,11345,11345,1
114u15g2pnhcSvmt9KhWNS9iphWX18fm7n,FALSE,0,13960000,13960000,1
114yDqUWM4BZdDsFcQc87UU8kQEwRghUPn,FALSE,0,6842,6842,1
113x9PEdPzUpNT76E55sc3h2fC2Ly8MoPj,FALSE,0,11923,11923,1
113xBB9xpWMgrqcKpqYigCL3K66AsBfAWc,FALSE,0,8671,8671,1
113cNQkYWKSaXT1A3X6GbhE66MHh6bBuK6,FALSE,0,10000,10000,1
113pGPDYe18y66yrwD5KZ4mWv7m96VfVwh,FALSE,229235176,229328517,93341,68
114xzkZ882rZjJUcAdwzD1wSQtgfFrgziq,FALSE,0,5500,5500,1
114Ei2mMrQdU9iKzLHBamWEw7Es42edDhK,FALSE,0,3380000,3380000,1
113xhCR9TKxtoctT3wiwuATeFfeWTd6QQV,FALSE,0,214819,214819,1
114bkEizE2zuxEDzcSkhFRWZy4TPYMeLxD,FALSE,0,3000000,3000000,1
114eTjZYPAN2sQBmymWJxztyfjaEahHecN,FALSE,1000517,1000518,1,3
1141cUt1DfcJMx3vYv1Fmk1zzzw92gXdux,FALSE,0,1071,1071,1
114FkF9DAbTVaNBGeBBDSZWPLraJjLS9je,FALSE,0,453821,453821,1
1159iE1fb7cT4mR7xScWiHYGyPDEBLcG86,FALSE,0,680318,680318,1
114c9UycUvpK3Ye7LhekWnUz7jVxYALaZ,FALSE,0,5500,5500,1
113nnLvsb8wGggqpHggKf8xfnePUyWdwLo,FALSE,74350000,74350001,1,3
113kgV5ZiL5pE1mW95r7TAMjyusWFSXbZs,FALSE,0,1000173,1000173,1
113ggwM5kU5spSfoWw7P9UtNAdfrs2BGbS,FALSE,160000,160546,546,6
114hvRAt28bfJK2C3aSpFoNiVdrZAmCisZ,FALSE,6599,6599,0,2
114vhu5yWNx64B7dtN3smfVGzU7hGvoFPE,FALSE,0,5000000,5000000,1
113byb6zS6oFUTfLUNE79A53AbhfppyvBe,FALSE,0,108300,108300,1
114yA9P26WrdgqM7Rzh4JrZLy91Jiuc2ns,FALSE,50000,170000,120000,6
114LNWD3DV4Ngz7TnSTSzB3aR9W91zXTuZ,FALSE,0,580,580,1
115TEhsbh4iLLQRcrTgaijVnYuiMyTTacb,FALSE,1031185560,1031185560,0,2
113u6QPuiH2kY84UpZbgjbKok5gvfVCQmf,FALSE,0,84844,84844,1
113n4nnbZVeghzyKXGN9auiKHuxUfzksae,FALSE,0,29821,29821,1
113nwyopQCGq2zWnYXRPZ3GTbfDEWW4mqh,FALSE,0,9985310,9985310,1
115Yg3TZrXLgfqSCZUwvqd595NxEgtQqwL,FALSE,0,1478200,1478200,1
113yzhU3VugipDmcAbpTXN4aRZzu512h9Z,FALSE,0,546,546,1
114x4y37ZPbM1zHx5XngY18xcppS5yQTJ6,FALSE,0,200000,200000,1
113w45kdjRdKrkcUc2JqKNL5mWzSLgasRz,FALSE,8693,8693,0,2
113gXYok9iLA4edGngCc6sPoG2W4z21cbf,FALSE,0,88700,88700,1
11481T6w54DKRpopHgrEuyJdekWfUsPyrb,FALSE,20000,20546,546,4
1157dCfzsXEi7iE25rdbAs5Cx4BnZEMrE9,FALSE,4528967,4770397,241430,8
115Q1J1kFWWHsAVd2da44d2m12aXXtUmWY,FALSE,0,5000000,5000000,1
114rLaLqomt9zcDGSfRzC5XTxiqnQWEZxG,FALSE,0,50000000,50000000,1
115bMzv8rmsvaZVpb2TKYXBCWUFLVYBmC5,FALSE,0,6118,6118,1
114i71DXK6RmGhiCuhuY7veChW5UVvcNwz,FALSE,15950579,15950579,0,2
113pFRHSmoL8x8WDG338YSYFqkYzFskYWZ,FALSE,34000546,34002184,1638,7
115WxXTzxZgPnNqRYG3rsFpLVQVkUCzEPb,FALSE,0,414860,414860,1
114kE7pXTDNE5GWBs6CxTV1EzJdmhNj8UL,FALSE,94079,94079,0,2
114fwW2v4ocCZ6eQ1JSU7TfiCtyK4vbSnn,FALSE,456400,500000,43600,3
113bTkttyCo6iNwCxhJJ2DXsWDFs7QNTTA,FALSE,0,47149437,47149437,1
1152xprzCZhLaGCk95mSfcBpDxZhtCqGqH,FALSE,139531,162285,22754,2
114StQatG8qqUyuacvFxbUYXCNk2NYTQ1F,FALSE,0,162000,162000,1
114epbzZezW3jTKk2mRQ3mrAgz1mxqzrUU,FALSE,18000,20184,2184,10
114e6WccvrLCewEu3t2nyj5EiSGK2Ha8dZ,FALSE,0,303535,303535,1
115FWSGwvxwPKDm65FTajzWStnKtVrGZot,FALSE,0,1,1,1
114Am56tWid169pxQKXnWyZpdGbz1VNy6o,FALSE,17671,503276,485605,12
113UbNhaF9ygQLhmXzKBtFz4A1fmwnaMXa,FALSE,0,92425,92425,1
1151Ym5FeYbnJAvSiptcaCpaHowEPHFRVx,FALSE,500000,500546,546,3
115X3vsFdbewKgVmGE6o8Kat5CP4uxNrXf,FALSE,0,1,1,1
114nzpsRjLZY7Sxy4vmoPfDfVoxFeY5jR1,FALSE,3000000,3000000,0,2
113rv7g1E9V4xXetmiuGVfYsv9W8AApP8x,FALSE,100000,105430,5430,2
115GYrwoqDBizn9ARkevhXrN2xx8FnX7gJ,FALSE,0,1365613,1365613,1
113uDhMvecjwdT2pbvuZeN7f7jBpd21Uuv,FALSE,0,46730,46730,20
113ZCfyVxtmPWS7n6z8HpfKgTraH5mT9LC,FALSE,0,45000,45000,1
114p17TWVNvsqb1LgDBv38yXN4Vxkykss,FALSE,0,301690,301690,1
114B7gtpr2jprGASs6NQACRw2ToBFsfq3f,FALSE,546,1092,546,3
11594JW1TzWc6yCkUiG5YJRejwAz5KXNBi,FALSE,2811000,20599790,17788790,46
113Yxk8JPXzfmReFRuPbDcZTqWfM4VxigT,FALSE,0,90610,90610,1
115QJv2Emsu8i1gqiVxqd4hsYYu2fhFBjF,FALSE,919571,919571,0,2
114GBNju3LKXsr8jsutFif7Rv9CecB8CBW,FALSE,0,929,929,1
1146SRXiScfAcUrT5N2GtcsoZetiRh5BGz,FALSE,0,21511024,21511024,89
113yFSo9WnLtXHHRQGMd1F7xhvRAq1Xu8A,FALSE,0,475125,475125,2
115HTZiGi7UHy4pPh7GVXbeU4NEt7iDVU5,FALSE,0,200000,200000,2
1141vML5No3n4VAw1X89XzM8QRWa84k6Nj,FALSE,1630170,1667521,37351,10
115ChuGajQVGgYXYAdqTUrfsq1bVsBWDBA,FALSE,0,439577,439577,1
115Y67q3VLntC8JYvqtzDXygUsKSjtxLL7,FALSE,274507347,294507347,20000000,17
1151DGse295dzpeppGGiRSyhaFgt1cTerW,FALSE,0,4598,4598,1
114CfW382Ui6vSKtTPQF52FZNqzYkZ6ULg,FALSE,0,6083,6083,1
1141Ck3sJkWQHThz1eERxerYpfTr3RBm2V,FALSE,0,2733498,2733498,1
1146VrV7zzceAaTRKtGh1yUBauDJ6AsW9b,FALSE,0,1000097,1000097,1
114r2JKstNXtuFq5bM6N6kyQzdb1CnYDcV,FALSE,4574000,4574547,547,3
114NCvrikqxk2HpweD98ccYx5oixnk24oF,FALSE,2575025,2575025,0,2
113yYHsFz1hLxJnt5HRcVJbreRZts9ZZpf,FALSE,21794,54368,32574,10
115DzqX4pVL2TdqzJhEpvyhp3BCL6zwN67,FALSE,100000,100546,546,4
114YJnsFm36YB9SkyjopQc741kjomXrGR2,FALSE,64997,79003,14006,3
113Z4rDda9RVzDy3f5vUDfqjb75915RrRR,FALSE,0,2353,2353,1
113wEmJKoUEKfDnTaP96FuaUBEUwK4S83H,FALSE,1130268970,1130272803,3833,3
115bbzZtHxoGrQpAgabQiPsFeDSwwkbFQx,FALSE,0,5550,5550,1
115Hq7Pw7Hsjaoio9FSmRZZxpJcqnWfbxz,FALSE,273433,273433,0,2
1158bbDGEzQK3AoNH14mTjYeF9x6d4XUCg,FALSE,0,550,550,1
114tn1G9uX75uuubkdP3QkgfiBbGjkajo5,FALSE,0,20000,20000,1
114BTzeKLr9VS2NrWc2tQZdEJyVSsgZYKv,FALSE,234644,234644,0,2
115Rhhrx5JnErT11VbnLDw8oEDZjn1RCHy,FALSE,0,432632,432632,1
114FDze6V3etf8onsE9TBGczu2KDsni8WD,FALSE,0,290280,290280,1
1146fm2dYu7AaRVyabp44pD58nW78MKxgd,FALSE,0,20000000,20000000,1
114JaW6rZYfZZ3Js5Er3uCyYEr573QxCfW,FALSE,0,347889,347889,1
114izzUK1H6GPDmZYCbxDqUKw8ceXTApcA,FALSE,1180402,1180402,0,2
114vPajAN2p3kowYMvgFmk2R4Q2kjVHt8f,FALSE,0,6105,6105,1
113W1hoj3QB6gNqQXdEc9xUeXB6neuy7FE,FALSE,0,567,567,1
115AzegvQQBJGjZC2ctK3zbVoMTU8vHtHY,FALSE,0,43052,43052,2
1144DcgjU7Xnvp8PapXD7EWGC5LHBhiJ8f,FALSE,0,5120,5120,1
114cY2Pk2kHF3KXo21c8E9H4WG3S6RkYEC,FALSE,7059834,7059834,0,2
114B1Qi1JUnjQzFeULvKG4SC5W4Qrsg99W,FALSE,0,1056000,1056000,1
113ksTZFVVirzGsZW7wRFSKXMdu32jNbs4,FALSE,0,6740,6740,1
114SmxvozTP33trnWguScF7MxikJRA8Mbz,FALSE,0,355490,355490,1
115KK6yBv5S2hU5YBCPYJu6WzNTLXik9JH,FALSE,0,36272,36272,1
114DxV6hnvXnhpB7o13GjXXqtfT5rLvA37,FALSE,1842883,1842883,0,13
114y5W47eDeYfbYNCxBvtyddFuKBvrXhNs,FALSE,0,5000000,5000000,2
115JopYBcWMsqL5jma8q5tJnx4iuYsD3BU,FALSE,0,183645,183645,1
113nzWs7T9XWQjfvsqu9kpGygct52SXqg8,FALSE,0,864301,864301,1
115JxCTMrqLw6TzPYKa8vAmQUm2dR7BTU3,FALSE,0,86015,86015,1
114PVYvLoR9aNPQ8dFqf4HzEgbfXGHJQ1z,FALSE,0,7864,7864,1
113tDGMx83Nf3HYknvdnCBTkjaGUkUbRF1,FALSE,65643861,66170324,526463,139
114qs3h7eW5aAqJmwaYtzEhd7ScJdLUfQ5,FALSE,0,1445,1445,1
11458Ugt3xqNWUXgrBhoxoAe3rAadXPxFa,FALSE,0,86104,86104,1
114QpsxM6N7uv5MgQAjp36UXyFxicdW4vr,FALSE,0,7570,7570,1
113YqcoxCbDmGQYnU7vMy9Gjrur5ef389q,FALSE,0,295750,295750,1
115bBzpwdwZdasMG4m2W71T5ZCswGaWFau,FALSE,0,1000000,1000000,1
114d6TWWdZSrbaC99CMh8p91fjJqUYbR9M,FALSE,0,9500,9500,1
114spPnhpqpjXTZN4iv4L2s5S2EYbzGSCJ,FALSE,0,546,546,1
1146V3tVTzYsEK2DeHMBaQ6VWwEihmkZGA,FALSE,0,2000002,2000002,3
114zS5dPJupDEPikzV2ZrRXbYu7Qn1Z4B4,FALSE,0,12000,12000,4
113X2krHoRpPEDcWBFwqv9SMe4VJHiubbE,FALSE,0,10169200,10169200,1
113f8pc6MKEE1LTAYc66irB5LZUfwpB3A9,FALSE,0,10012,10012,1
114wg1s8hbSJWksZbaDoY3NZR2kwZ21cVe,FALSE,0,106700,106700,1
114QAT27pwGyu8Kb9nMoTCWxi2bXXGcyEU,FALSE,45572,159207,113635,8
114ftPp8g4xa5KNwG84DAp9ccHR1s6qT56,FALSE,0,58412,58412,1
114AZv6qLkqBECpteBtZYvjvd1mpq447X,FALSE,0,11980,11980,3
114wZQ7UFpACLYk5YvJwJQrUS5gxr1CB63,FALSE,15393877,15463489,69612,5
114CmBr17eUM3RuGeZQxy46anYBxqJFNTp,FALSE,436441,436441,0,2
114y4ZCnuU9J4HNmbMMkvsvpPcrR8V9fxi,FALSE,1630,500546,498916,3
114uj3mjQvnPPxotR8J7gR1HW781LUk2sq,FALSE,0,1000,1000,1
115A3EsqbqczfTKZEkK9L7yBVrXqUgvxHu,FALSE,0,230193,230193,12
113dJ46JW5ycqr4qNc5pU6ZsixhSR2J95U,FALSE,600000000,600000002,2,4
114boKGVaQcvw7n58wvhdUc2S94RawqXXJ,FALSE,199900000,203188556,3288556,5
115UQj3ukTAoZF8LGAmbp1pAWbA96xj2Bd,FALSE,0,720000,720000,1
114vVvXCa7uSXzeYN1WN6Gzhwwb5yWN54h,FALSE,0,1200,1200,1
114SUqPS13V51Ge1tCZD8p6R3KDhS6xXsL,FALSE,0,17487407,17487407,1
11476xw8v7Viu1JwgHtkF7pUr9YHJVBG5C,FALSE,0,70238,70238,1
114ni9amccV7U6NK6K9aQh6MkxPkWJ3Cbx,FALSE,154488258,154488258,0,468
1145yTGz6ugzKNUs1hdN8JTjZUoB3EVwak,FALSE,0,548,548,1
115Xc5zmhyRfsMLsJ13yimsE2ryxR7YZTa,FALSE,0,69928111,69928111,1
113shUvbiyiXMd7RKauTrLbeGFtbRJRWS8,FALSE,0,1000,1000,1
113mqaydtstfv4cYRkzQ4YY3qHCXbE256y,FALSE,0,1209498,1209498,1
114wCzftoUZY6JcLoodizRJTEYu2eLeSXv,FALSE,849950,849950,0,2
115bEujcT9xjzpiMYijNjJbEgeAGydka6r,FALSE,0,288850,288850,1
115PtMXebDPzyL7groJZ1vmF8nvL1ChwxH,FALSE,16153,16153,0,2
114GbaUd8AC3sfG3XyRN58FVwDieVQ395t,FALSE,0,21512,21512,1
115hHmmdVMhwXoYthJz3ihsfHaTzMv8SUZ,FALSE,1008564,1008564,0,2
115C3VXFb3prUNQfrPdvVyvYzrxfGRjfJo,FALSE,0,102344,102344,4
113ub9wMtgnBbff5jHHYwNEfUd6nFTBC5b,FALSE,0,64362,64362,1
115oDfr2c87GkuDLRM6jC5xM7hEgJ8Vima,FALSE,2037483,2037483,0,2
1147WWaoJuRa32jpnMVxkewjsm2ptJ51nR,FALSE,0,1017,1017,1
1158J8AuCYmtLbH9hZ5wV7423uq52AGcqP,FALSE,42104,42104,0,2
1158ShCLcLhqKorGiJXihQ4uugvYUhv2cw,FALSE,0,22501,22501,1
113qUkwQhWjMKwPZv4Mj58CEvxhcHrcTsy,FALSE,468310008,468342233,32225,288
114nAFt5Cmh1XnbV2yCfvjUHwtAw1261w,FALSE,0,29000,29000,1
114W7Uhw8vu6AVWVVUX95EFF2XY3bS4Wdz,FALSE,0,20095,20095,1
115ijqfv3aDBzzvnJ2vTGRSdpFjFaCeBHC,FALSE,0,7698,7698,1
114XShZtCCoMYA8dTc9d94V2w3zHGxR5vD,FALSE,0,324199,324199,1
115Yvt9rD8WD9LD46CgJDMsEb6DkPZFdWu,FALSE,0,6547675,6547675,1
115Xdq1MhVdk6fXt8udiSeifZoFtKDbeSq,FALSE,0,10765,10765,1
115nn2DhmrpAUtmdJyCUrqUNzi3JPgZp5N,FALSE,210737,210737,0,2
115FkYeX5eD75RF5VxBRhXEkELVsofytPB,FALSE,1384815,1384815,0,2
115jzVqPfTeW4uiiz5ocgpFc5MgA7pNq7h,FALSE,0,1638137,1638137,1
1155QQTCzrt4tmcg61sbgc39z2qnfBoDEd,FALSE,0,3696,3696,1
115HdFtDw3iUCuiuULeGchPTumNwiEeJqi,FALSE,5687,6788,1101,10
1143np6zAi6CBbacKjdKThs7RxYx1438JC,FALSE,0,125300,125300,1
115o31ycAkXih7ToUQPNFsF51p4UvEt3BF,FALSE,70048610,70760037,711427,15
114BC1Y4RT8aL6Q5ymZTC35g9CMXVqVrc4,FALSE,0,3174,3174,1
114FjHdoHtnxiiQ87LGMx3QN7iyMGufELz,FALSE,408100000,408100001,1,3
114TryY3h9hA9R5NaeRvaZjyzGGZSqohEp,FALSE,0,3545,3545,1
114PB4tZ6ZR767q5gfjsfQD8frNFnniaEW,FALSE,0,7925,7925,1
114Ffp8Knz95W1CCL5kQoHZNeeiwDkSxT2,FALSE,0,900,900,1
113yJoL5r18dgQ7CmyF6Z4h7AHg4F5HxWp,FALSE,14488433,14488433,0,2
114Ltoe5HN9qbhqUoE1srzXGoxgZEGFoUi,FALSE,0,7918,7918,1
113w3rnByxEWSjECyxGmdprK3odfChcN48,FALSE,14217,31092,16875,6
114yqZiVzRdvzsckEjyswTzTDvMaeCiLZr,FALSE,22127,22127,0,2
114Z7fkBPyLH8zwAY2yUxmJMxWNfKeHr6j,FALSE,0,10000000,10000000,1
1141B7ejbs5RckF9eSWWhtHZih2koC46xZ,FALSE,0,250000,250000,1
115AQMDSCo5LFBe8esQfw5yCBnULj42qsD,FALSE,0,1079,1079,1
114W7qRnoEsFVSsCjXGBY6JpKirC3Phqwz,FALSE,147527,147527,0,2
113vqyasLmoe9SyrAA5KWsfBfeaHCvmGLU,FALSE,0,2341,2341,1
1158TogFZGn7KYcfRp5cDU2B7aouw6TKwE,FALSE,0,23182,23182,1
1149B2KoT5v6Z4rBKvm6TPEQK5WGnd2mU8,FALSE,0,3403,3403,1
114ztagNmP4JZupUNHwv9ygmH7bd9rRmVa,FALSE,0,33000,33000,2
1147kH8vZ7UmYDXAeTAQVW3haLqxunogQt,FALSE,0,534380,534380,1
114zQTYdRT65BMeqs6bAfng1y6MDho8ig1,FALSE,0,896,896,1
115Je965PyBh2uJB2sscRpgpjbFYXJzwmB,FALSE,214704,279704,65000,8
114QeYKbQoVyg861o3ZMVXYkfcbRkugJ6w,FALSE,0,1200,1200,1
115Q1XGgnAtadQa8cW1iiB7P4Acm6mcHK7,FALSE,44184,51276,7092,22
11458rH3KiGFMeiZqtwQv6xD6geK4ieKcB,FALSE,0,127000,127000,1
115oFRjpgMFSiNyDpAGW1J3cbkinxUNZc5,FALSE,0,3000,3000,1
115hDyCyQJFu9uoaUeckk8XzTno81zX31h,FALSE,723802,723802,0,2
115nNAXterGPHkpQ1ktdcF3miyzMdWRBTm,FALSE,0,40176,40176,1
114BrX9kyCTDedXkWCg83k5GetnAKg59pt,FALSE,0,26756,26756,1
115ZH5CbsR2Dxs1oKTqrBLpQYJSo982FtT,FALSE,285348224,285348225,1,11
115Hb8TRGUvfxKJmLs3akPim8BreAPhXfd,FALSE,0,4102454,4102454,1
115HKzAkiW2yUdGW4kRQcfSxwydChVdxjs,FALSE,199996000,200000000,4000,6
114xhmQzRB5J8FnFNYZMXqHiFBvVBq9RYg,FALSE,0,99000,99000,1
114RLGbboed3HPrjGfRng6F1jpTgYLytyU,FALSE,0,133664200,133664200,1
115b5ZVZA8kQqB5arJ2xxzTK5AN1rXiFwz,FALSE,0,508165,508165,1
115XHoWBpk81m4Ahe8oagaCqstuLZaD8UZ,FALSE,52905,52905,0,2
1143QX8t2AR1igZ4wwraMtoDQcjSYsCusg,FALSE,0,29283,29283,3
114wsvtQctw8fhwjkuGzFckBFuSnEjDcHj,FALSE,137561,137561,0,2
114xD8DVHRNUEgzxHwPPJvzq8uDzYV1CHG,FALSE,0,60000,60000,1
114RyFPxow5FBidKZFiAqcinHJc7N5rbHQ,FALSE,0,5742,5742,1
115NWBq42VBAa9K9JGXtQke6ge3uhs8H7v,FALSE,0,2510676,2510676,1
115PNedRjAb7tiom2NH5icSYE4PWPSjaC2,FALSE,0,356900,356900,2
114zQCp4oGfw7bz5WFEZm7xvHJrAE1w1aT,FALSE,222363,222363,0,2
113ngeobSRfTPTJyFeV2ZbLTvn8DbN3ud4,FALSE,0,3120,3120,1
113mABPF9zqZjuJANPMmwCp2q9BxfCVhU2,FALSE,0,9994642,9994642,1
115HeCZ6K2tDR3JYLoKMmba4GPSoRK98pD,FALSE,21978036,21978036,0,2
115f7S7bnr5xwZFGAanmmNL3TTDua17P83,FALSE,0,140002,140002,4
113jVTHjnZPZQJo8jQJTib5QJE1yZtgmVb,FALSE,0,5042,5042,1
115Xf2GbhQ8BnCbMcHHF9L9mpcvpnehP1K,FALSE,101357200,101363600,6400,3
114zLNCP1LUBQ63WgghraRifAi8GhQNQYs,FALSE,0,544459,544459,1
11427BzVQD6rDAT1UnxkJ8KLW5CnLBZaLf,FALSE,0,34033,34033,1
113m2dTkLJh72t2UeFzZSUqBkZ76HkJNQy,FALSE,0,546,546,1
114SJvyS1wf5KtpvTgNpkCrJ8hDUVbh5Ed,FALSE,250000,250000,0,2
114qVYwFz9S5syvFipHNBMgMfoWXTXk7kb,FALSE,0,33832,33832,1
113qq5sP9xDBPDuorvJ2zjxnFgGG6d76VD,FALSE,0,10000,10000,1
113mWLiMQfvQ2HqmQZeA19jREu9m8uo1C,FALSE,0,5500,5500,1
115cyU93T7WapDjChMd6sFvwWhfinPimdQ,FALSE,0,202896,202896,1
115jPC4FHqvUBp7jU8eADdt7wzEzzdTitF,FALSE,1000,11000,10000,3
115CbsDoYRUhKKfqrTZHHfNzdiwicBfhfz,FALSE,930734884,930752902,18018,447
113s5sAe4BtkRFtL8o3JH5TreJQ3reTCmL,FALSE,0,548,548,1
114nLhWx7QxEew7DgEjtdzwU5xjadHks2,FALSE,0,242128,242128,1
115ArDSw4qpFaK5KRcR6nYKctjhX44cXCz,FALSE,0,22439,22439,1
115BbAysYNEAiby6yGTXjQFn6Y3Lk7aanA,FALSE,0,4195183,4195183,1
113y1M9K9sXgCDnJLD979t36KGSFRaA8xr,FALSE,819495,1202625,383130,43
115mE5x2LRxf9VjGiZvbPtyt8BW1XRJuH6,FALSE,0,8758,8758,1
114GNgNpzGyBqp8scFfBrevAwaWJBxzzts,FALSE,0,12703,12703,1
115jWgpFeWufdRsKFXy9Y6hJ6G4EyfQkak,FALSE,12837000,14124000,1287000,145
114wsJyfUmEE9Co1wVzTxuvC8aKXYXNqFv,FALSE,2929700,2929702,2,4
114v85sREpA84L87zzKb3JJhHUpmzFLDzs,FALSE,0,546,546,1
1155wxSUnWkK9byEcLtYSeNx2aNwgtaDv5,FALSE,0,10000,10000,1
1144fmyRtZbG7tPw6yV896RepFsQxBF9aB,FALSE,0,22340,22340,1
114gYmeCc1fBb1aSsNne8FqG55Qu9Nb7fN,FALSE,0,1000,1000,1
114VzTb2nAdxmSpzFanYWQY8VfpJswb8he,FALSE,0,287285,287285,1
113qs3YyPRytCp9RUcK2LxEEiY2poMn471,FALSE,0,3212,3212,1
114waE8pDdbq9AQLqCobbUHDCYkPDLA7Ct,FALSE,0,673367,673367,6
115Fnri5HF4fbxmPQuQz19uzi5cuJnmrDc,FALSE,0,6857,6857,1
115EQ6ANGMgEcoL72QspoeHeb6yN9SuABv,FALSE,0,33409,33409,1
114fJgMa85AQqShhWnZ29ZHYeLwfRmdiwZ,FALSE,0,458459,458459,1
114xvYNMEnGXMaJHC9nX7SbVaUFrkk4TV1,FALSE,622667,623345,678,7
113y32gZo2ZFJMdzh32a3ZkBSNvqiPKzcx,FALSE,0,1064,1064,1
114Ftze2zMJJtn4FJvA9gKoEqwZqa4DkeG,FALSE,0,1045106,1045106,1
114bUg5ff8gsknNKVQmbxoiwMcjBop9vzE,FALSE,0,57274,57274,1
1154G6KChvYppN1HCgrBQvVP1idcEoXVQB,FALSE,0,28066,28066,1
114F7vtRs8efKbLZCQoszFT3R4rCibDLBX,FALSE,0,1618,1618,1
1145h6RhR11yw5T8WQXHZLfcdo1pdxQYh,FALSE,0,33300000,33300000,1
114tKS5E81okwKnnpvNAWzfHLZ2KJRpptM,FALSE,0,999820,999820,1
115bYPpkkNduLzP5mVh6cyRd25PY42HpYb,FALSE,0,15931,15931,1
115eXXgP3EJPn9dDJf4D5yB45irwkrHCMF,FALSE,0,8695,8695,1
1158CEoJuPsy7LWPCghLHaeoMDx2q42hL4,FALSE,0,630921,630921,1
114mJAz77xkziUBBNrbLZEZuBV1aAnQmnk,FALSE,0,2005,2005,1
113mhv9YUaCMb5A39vUFiKp6ZDJs247bfn,FALSE,0,481933,481933,1
114tjHLmhcaX8SDNDWrcH7rmUVrBaUddtL,FALSE,0,667500,667500,1
115pQJaPm6EYC8skJXcvW7oupQ1A5FfyhQ,FALSE,0,2600000,2600000,1
113mqfHncSzSwcdpcJr7tq5sHoA1ScRNX,FALSE,0,26377895,26377895,1
113sn91CcxQBFLQy7xoyY8ia4r37z6qZnm,FALSE,0,30000,30000,1
115cY21nkjWHCS6iWeBVvLQnrm1tVEaMw9,FALSE,0,40000,40000,1
1154n6j1qvpTzhVT4XE43Lgt6XxTce33Pj,FALSE,546,1092,546,3
115aAnS91JxdFW7KbBRg5MPLkT2EwLG9Ps,FALSE,0,206792,206792,1
115L1XAp3xicFAjy695HzLLZ1odNn9HLgc,FALSE,0,10579,10579,1
115Vwq7SWGATuRaWNcy8weVa1hfXVQgBRB,FALSE,0,1275715,1275715,3
114sn44aZu5P4BnRNDjs27fjThMdGdUQap,FALSE,1000546,1874007,873461,40
1145SfF25zcKPXMaAmRpb3Bw56cv7grjwB,FALSE,13264,13264,0,3
114P8cqi3f5rDu6istMyMJnbKvB5igrjqN,FALSE,23230,57360,34130,5
115ppmvZiRdaeEThZGJZi4nf1MKBG8BPc1,FALSE,0,13057,13057,1
115oVtjy4toFGqCA9m7n8EBqbMjKLk7EWS,FALSE,0,364000,364000,1
115BYES9hozWB4vH1mWBBioTgs31D14Gio,FALSE,0,792822,792822,1
113q2ZXW3qHN46QmzFZiVSCqXcN3ppMTFJ,FALSE,0,966,966,1
115bgUC8kkUqcik13R6G4K26gbrNJNinMs,FALSE,0,315513,315513,1
114ZM5SGcSN1bSygDH6n1ei9JD4Z4pv5hb,FALSE,0,423,423,1
1141yN7CP6RnELD335rTvNSuwwuVXjx4es,FALSE,15460000,15534161,74161,4
114XfVhV3MKrec7yknjFrz8pKxDUDCWsLh,FALSE,140806,160806,20000,2
114zt79323mnSqzqj5Qwv8B2gzG3HdcRyQ,FALSE,5839,5839,0,2
114EbdosKbqd5iUtBJ2QiCSvfg8dAVus8t,FALSE,34288,75953,41665,2
113oZy2FPpnxPj9Veg4f6b6g1hb6PDa9mS,FALSE,845252,845252,0,2
114QfJdtoVMXUCy2NCRFayXfGifLd4rHKB,FALSE,2374894,2377038,2144,53
114oYGM376PweryqQxWbjHme2aejM3c4rE,FALSE,39249,39795,546,28
115fe9ybsZ8UZQmiUkqxJ1c5VvNg95GzkW,FALSE,0,2392,2392,1
1154efDa9bygSuLg8D7MZ1XnseCjXWxAZN,FALSE,0,1915,1915,1
1145qtvQyLLQQR86aEDhyo8jHAqTuvsnrd,FALSE,0,7393,7393,1
115aRXcuDaSi5LfDzvw7MzjHcGuk5yizid,FALSE,0,20,20,1
115NHLL7SgpgUiE1DPVsWYSpHgTQhav2NE,FALSE,122012,122012,0,2
1148TQHatogq73uVGBGPre9ehsai858Mfh,FALSE,326698,326698,0,2
115rHB6ytk8qaEGAuvqCS7YczJpFG4yr5y,FALSE,72525177,72525177,0,2
115NAoEEXQC7SLe7JiaPUnmTYyGw5a21qg,FALSE,0,130798,130798,1
113kDUP2xbLhiDk1D5jb264oaZNsKQmBYY,FALSE,5717,500546,494829,3
114YLUaxXgPXMG6QVYbsrJhcw9skgzWKNY,FALSE,6000,12546,6546,4
1151WNT6u2iADke5tawmVoWVRdfmEENde7,FALSE,0,8773529,8773529,1
11572djoBkNhD8GAqG1EkFkrafLG3wPXrv,FALSE,0,3190,3190,1
115iaouVkYkUxTHUwGjaNqVdapZCnHpfqS,FALSE,0,100000,100000,1
115T2s1jzxKQXTzrFU9z9LYGtTrM39r4AK,FALSE,270279,270279,0,3
115YRSwMHm1rgH1QqCxsZVtCP5fWcks9wb,FALSE,1162918,1162918,0,2
115A9xtJH3c4mRrCCGNR2u3FprAKC8xyYf,FALSE,0,530088,530088,1
115GjJBsWCfwqWLUx4tuukQZSrktjpx2F,FALSE,0,1,1,1
114AB3W66gCwPWDTBxXrZK2L4uCf7d9iKi,FALSE,0,1041629,1041629,1
115c4MVq2Qbfahouu8jVN2cxYr98qs3QSW,FALSE,0,278542,278542,1
1145ucZozFgXUhdrMN8kdPdQcfSnnHEnzN,FALSE,0,631,631,1
113jot1uyh6W5haF2UGMUE9h5wsaByAsur,FALSE,0,98897,98897,1
115iQkkcbiz47TW1148DUV9auvky9cc2wy,FALSE,2059000,2059000,0,2
115ko6dcPbAaazvB6hTnEc7nJmpVrR2KHT,FALSE,20789,36690,15901,28
113oxMfcyMBdEwk949pTDvjCwu2NBQZirr,FALSE,0,534659,534659,1
115gS13Zo1Yva5nquV1jvqZpkZgPrcD5No,FALSE,0,1,1,1
115UJnk2XJCfTPmUMYkaJBERFuSwfgwwG9,FALSE,0,2681,2681,1
114GTc7MppcmfoD2LBAeTMKrTyvSv4Psbp,FALSE,0,6000,6000,2
1155GGLwL1eJbYyTdR617yJgWAFDbaxDLo,FALSE,0,1058000,1058000,1
114Mstd4z2X9NALobCspp5g6FFTsLTcmTa,FALSE,0,546,546,1
114Lqnc2rp3Ykg8srzoedkFEDAQmuGDrLo,FALSE,29738066987,29742055905,3988918,919
114nzMfk3Kk2GAZ2pb6RiTEHj9CMXweof7,FALSE,0,42318,42318,1
115p6W7EGwaZh3epYZEeqstPqsKJaqnNqB,FALSE,0,562,562,1
114H6dZQEAN1qLrfC5kXRnqe1dWCEsZk4g,FALSE,0,347641,347641,1
113upvanPAGdhQVge6NThQq2uvj9a2PM4S,FALSE,0,4942,4942,1
115kSEp1mgFmarsUgP1GwWvmc48fCVQeZa,FALSE,8420,8420,0,2
1141FgUkAC3nK28uQSyHEAS39PUmLMBUes,FALSE,2797090000,2797780000,690000,11
115DkWPpJ7XNqLv1Zij6StsuREj6SXa554,FALSE,0,150000,150000,1
115RFy3UwboS6TUNUdDViDvpa2rFZw8siE,FALSE,0,5500,5500,1
113vijx1nvaBWT7KHD5gMjuVW3W3EKgeBn,FALSE,100000,100000,0,2
115rfVZKsCfTcourT3WYNvFrZZocJDKVcM,FALSE,0,10000,10000,1
114ETVUPvANGy27BXcUp9nXYup2BizHi73,FALSE,0,1551,1551,1
114AS3f73QvmwLWkNTUquxszax9AQCWQbi,FALSE,0,1994350,1994350,1
114qe3sXjGo7quXgdruVUFkCCdwh1NvNcC,FALSE,0,50292,50292,1
114qZY2oPDPXuTNK3TncKLSBT6Bq6BqtnX,FALSE,0,1222936,1222936,1
114pvdofduHus3RxpDUbhywe1WoTXiuSYU,FALSE,0,53996,53996,1
115Q7KoQSPLfJTRSmLU5oabJuenWJCcccL,FALSE,0,5608,5608,1
114pZgs4yMuts8jBLaNejgBgKFEBNqZ98m,FALSE,207457,207457,0,2
114r1nUSGQsGPEmBdgc72CaRbSNNKyujFX,FALSE,1884415,1948430,64015,18
114cnLAV4RqY9nLZ9oc8mGt3FSjQk2n8Ko,FALSE,367107,367107,0,2
115h9ALPf1ePc9TLdvqmPgWnjRGk3gLYJU,FALSE,0,2500,2500,1
114VgD2ZhEmJJ25mhUWgAaN72bvYfnbVwX,FALSE,2231,2231,0,2
1143iDqAtcrPu7CHX7t4Rmmc6oJ31K3Wcr,FALSE,9705863,9710382,4519,5
114jRFgJue55KDRa3LiD4oJJLRadEHT57R,FALSE,0,980000,980000,1
115nW5TNE9xEZ4LoXwyex1pS19kewehhXG,FALSE,0,110756,110756,1
114EUTWWAaPb3M9vqgQGh4QGiwHCUqq2up,FALSE,0,8000,8000,1
115V8krWREZfEujSbyfqs9gfxr3JAyW4xV,FALSE,0,3460,3460,1
115F3TRbqFgiUUtyJcqXUYLrpAajnQ8zK6,FALSE,0,12100,12100,1
114CxyEquPfGrEbs8b4BqD8uegXcMHYXGg,FALSE,0,61764,61764,1
115S8uPvRuzS1m4pBkNb32fWUyFmTF9Djk,FALSE,6784,6784,0,2
115VZ2R5gWuo9efwKEMujxP1j5hM1vr2sy,FALSE,0,1461,1461,1
114n7bfNuTyYtcPS1zpTdoKeuWE9kE2i2C,FALSE,0,60384,60384,1
114jCVWD6eRd3taNuCa7tX2QfPaao7iYzn,FALSE,0,24204,24204,2
114YKny9KzEMQGQXTnWGjPT62XZcYHeupR,FALSE,0,6454,6454,1
115DPBYcpkrYPaegcEBa2Hh99kYsGinmoN,FALSE,114856,200000,85144,5
114qBtpJ6C2nSPAw1uzr21qvmKCpmeCVzw,FALSE,401092,406006,4914,5
114gtBphET8g9d2wpvrpC4scGA675Hv2JU,FALSE,41973,41973,0,2
1144Po8DyNb4iwZeMZDRHkUDhbch3ooBKF,FALSE,137291,137291,0,2
1155zd6AoKYUVk1DT9FsFvhG7FYFi117kE,FALSE,0,121490515,121490515,1
115Cf73F8GQvYKGQ2uKb3FTVP73wVUF4W1,FALSE,0,158251,158251,1
114d7e3HxKyRTTVewMjyykByRa63FAEr7R,FALSE,0,19078,19078,1
114avnUpr4hHGnL6baihPMgzNp9Egk5Uyo,FALSE,2970262,2970262,0,2
114asVUTjUKD2LGXo21yrn3ymRe9qj9KGi,FALSE,0,8489906,8489906,1
11523tt8nj5CAD5SU1ZFEcYF1eh1deadc3,FALSE,160794138,160794138,0,4
114SZZDhhwiAWNfaBMTvrYjcrHbSWy2X2L,FALSE,0,306600,306600,1
115peWcJuDDATQ9UkxZJK2zq6thLDTbycV,FALSE,40084368,40164940,80572,171
113nwDXoeyoA1mbDdtNVhhPBtW43PLoauU,FALSE,0,19874,19874,1
115CZsk9hStyXFKpMLpXM2YtE5uCVNT1MR,FALSE,0,2648,2648,1
114t4LdPnGXsysEscTA5xPuWi2FJHP8JqB,FALSE,0,534000,534000,1
114A1pccvR8ALQv6DZvMY94MywjARSK44h,FALSE,54376073,54386073,10000,22
114GvEahxaEprbBukJ2yLBPdnCsssC1jam,FALSE,34777030,34809030,32000,25
115L9YzKWUTrFaXN9wtnESHEGUWKjmEFi6,FALSE,0,6240,6240,1
113wWLKSUwC3SQnAFGRAwt44o5h5jGvcdB,FALSE,2704475,50867758,48163283,51
115mcMRxqAYqJeJNBnhb9bMp9Yf9Y1Y9tu,FALSE,0,546,546,1
114fRcP2dMeTQjEs4yd266UVQnLnWurj8n,FALSE,0,5110,5110,1
113vNyS54AztphmTSPJkk54UjCw7FezG9X,FALSE,0,10000,10000,1
114HPmhDg1WVKtpGXMUW6FnbW3iP4hcSok,FALSE,620204,620204,0,2
115LPaah7EpfoEuxPyGXmirBYcHMbXPMyq,FALSE,0,1568,1568,1
113xwEUR8h84n7VRhXJ1yTJpftKWRD4RMW,FALSE,0,99998200,99998200,1
114nYeYKHQMkLtmMMj5kcCkkxNLRTh9D2p,FALSE,185921087,185933120,12033,431
114rWTbh2uqJd33xMkWhwhKXVqRbqrPXsS,FALSE,0,1000,1000,1
115aej4DRK4hXxC4uHxLW67syrFC2q2vJ1,FALSE,0,972,972,1
114BvzPzKNtLQ1QiEi6EAEqQEbHoL7ZKzi,FALSE,0,118814,118814,1
115h3PKH37unq23S4VtejpVQQcdbRhT4vj,FALSE,1037447,1037447,0,2
114nqBCGxas43WdSub4oUUqAfo8atTLbP9,FALSE,0,6099096,6099096,1
115BSuK4NMBWQU86iqC6QJzdk9tAMsF356,FALSE,0,2729047,2729047,1
115GCpzaMSnLRSLH4UsrXP62d4ut9HncQ9,FALSE,2804245,2804245,0,2
114kNwxp6fwxo3sULDmv4usWdJpdxLDG6m,FALSE,0,167154,167154,1
114bK69wm3AeYaDW279uy85DLKSz8JtQ4n,FALSE,546,1092,546,2
114M7XSSAcdBPoPKndDRJfV8QY5NB81fsQ,FALSE,0,6320,6320,1
113sD9QDGGvSwWU45b6u6y7yXncHuX7Rn,FALSE,0,2571198,2571198,1
114aujprw31XVubJPusvezjrRJNDr72oLg,FALSE,0,105684,105684,1
113p2yQE5QRpsCVXEmtE36tWpYXfjTJdLM,FALSE,0,5787918,5787918,1
1141xLcczECy9Mr6dZBBppyPh4U8Pm2KbE,FALSE,0,30086901,30086901,1
113ne9E2f1EbfmQWnYgcpa1e1SEc1BQfSM,FALSE,0,7871,7871,1
1157tSh3LtcL8vcyWWH58feMFCW3c35Drq,FALSE,0,2605,2605,1
114c6seoYxqTjJeJZCmoSqygxqBtE3sM56,FALSE,50000,50546,546,4
1154nTaL98GZ4DWW97c1GEEKW9cz7EqGfE,FALSE,0,5163,5163,1
115jCUoAP99r5sufMn7P3NATYtg4DdbRaC,FALSE,0,20961,20961,1
1147tXqFFskr3ZDgeWSEiaKmNXJyFrWASm,FALSE,0,309704,309704,1
115QiU1ohFNx8Tw83TrHKjytbCQ787ZoWa,FALSE,0,3421,3421,1
11553V4brKwdvupka2SWLAvneQ5ogiMCsj,FALSE,95613,95613,0,2
1144zzHvnJf2rzKgwJPgBcZHzWTXbnZfHp,FALSE,546,1146,600,2
115A2rxi992vhvNMpYqQuBb3gXx4Pfg5wq,FALSE,1745244,1748520,3276,50
114KjJNK36A9VSGES5u9VsHCtErdrfP52g,FALSE,0,2868,2868,1
115U64MibYpfgH2WKzEoLRwKpokrHCw155,FALSE,31530987,32409462,878475,23
114inAoxRk9xUXXUa8of6b3hDL4xeA2cEQ,FALSE,0,44062,44062,1
114ktmHoitSz5sQQafXegoH8x3iyJjXqZu,FALSE,0,11540,11540,1
114vogvk2RVTxNk7BzBKgrC1iVfVmALGvA,FALSE,30000,30546,546,4
1152C2Sc6KfAJdWqS5C8p4hrTcfMdcAgoW,FALSE,725394,725394,0,2
115qTuZAfEDTgA6FrfsHxh9z5b3ejWeJ1c,FALSE,75516,75516,0,2
115Ad7rZRyLQD9CJjCANZ859aofRRvU1AV,FALSE,40847,40847,0,2
115Eswvpc7njwAaBaHjhu9bqNNK7oACSSK,FALSE,0,904,904,1
114wa6nKbZvRxz7LWtUnQoJ8jQ8coMZ6tR,FALSE,0,96405,96405,1
115Au28e4UYM2Lb9NtdAg8tgtjrvW6FnAV,FALSE,0,7700,7700,1
1142SupUwQi7AzWzhj7Kgby7PiQHAUX23L,FALSE,0,6507,6507,1
11422q6WQ69pMpFHcyb37GCabrv5smTwpS,FALSE,0,36495,36495,1
115rrRBEfRTJ6CnmKYGGwv9GeH2shXF6wC,FALSE,0,5500,5500,1
115R75gj9mbvisbQWhAhNxsSUPL7Suy3VR,FALSE,0,475050,475050,1
114oCmY9DoS9EvaVNAPWUtmrDqpDXvtziv,FALSE,0,1732,1732,1
115ZfC5RnCwm5LCZWffp7W6PHRbyZsQyGT,FALSE,292223,292223,0,2
114URfJygyeToGsiaqtwzQw6eJSGUu2kD,FALSE,57000000,57000000,0,4
1142zKrUTWuzUExvMVzNstPwPe4bfGkZqJ,FALSE,0,75690,75690,1
115oFrFbFLfxLvn7smkF7BwWPxHm7iYiHN,FALSE,0,997952,997952,1
114F4qgiuCZD18aKipxYfwuJLYTZLBRxnM,FALSE,0,386085,386085,1
114Lmqs2U7CYDZyV1Q4yhpvADxneK9sxKx,FALSE,0,34395,34395,1
114bz1Ad6wLFKdD5KnoL6C8QqG2ugc4k9Z,FALSE,0,71160,71160,1
114HCCuemYCghSd9XDykaBAp8QQNgdGxMa,FALSE,5000,11000,6000,2
114BkAFwp1Yx5Yyj5DqC3Gq72yQMvGhHnW,FALSE,0,2535,2535,1
113qucSgBNK1yi3pPPUQarU9o3ekvidTgm,FALSE,0,1216,1216,1
115oQk8bfR51WKM9m365Dw29vM6utqgDJ5,FALSE,0,563,563,1
113s9wFHp7TNVAeiXWNaUxG14Q4SRPuRXq,FALSE,2161958,2161959,1,3
114qdnnyNFYvR5p5497QuQxa8sg2VJjN44,FALSE,0,152147,152147,1
115Bhs9Kx9BMgVgDJE3Kt3eioAXyzAhesm,FALSE,0,12727,12727,1
114SznLtLzona3zscGKnHGMKsycPkgvP46,FALSE,0,1324072,1324072,9
113rxCxhejPVkBRYTNVvzdFGhsVQHRUBS3,FALSE,805951,827159,21208,34
1157jyeTFBk9ehdgqNfw7n2q4EUxUVtDDh,FALSE,132568,136004,3436,13
114YKgy7o4WR9PBridoFHLWYPQxyJsVWZf,FALSE,4000000,4002732,2732,5
114G6LEbxTHbuqQqNhAvrhTotxJ91XHuuc,FALSE,0,600,600,1
114qMQTZLKcmpCLE1hJCAZsmoxhBo8kghW,FALSE,79630,79630,0,3
114NBXbZTbqwWHMk6KANYcbYXihQPosQ3G,FALSE,62231795,62233402,1607,259
115jPujRz9DzGT9q99t24vvQUX7TJuiR2t,FALSE,0,1000814,1000814,1
114ktg2sax5NF94mhePUCx8hFVLaAFJRLE,FALSE,0,8410,8410,1
114MYzY5A9XZAfDwPeVwvrZ4LSPHSYopNw,FALSE,0,322841,322841,2
114zdgM2TMFB48cFWpYdVBGtAEnfYsES5Q,FALSE,0,6380,6380,1
113q7WQdaRirkUrLpyWKxahjczPiqFqxRq,FALSE,0,68810,68810,1
113kkBe3vw2D41ZkThrQ4BCPvbb1Co3PuU,FALSE,63490000,63527353,37353,3
114svqvdwDG4pfRJmSxWm76uZwCoyDZb1v,FALSE,17350000,17354609,4609,10
114mceSq6aaHBX25s8cpwutzseiGosHCtJ,FALSE,0,37907,37907,1
115dydAn3ocVJmdwgMpVARXbbs5vR1PBpo,FALSE,2889906,2889906,0,2
113y9zaEuGTLATHG9sU9F3qQonRTxLVfnx,FALSE,0,995623,995623,1
11476oXepjbtnUUzB4ihfz9rZYDcvUXQqL,FALSE,0,5754,5754,1
114gyWTuWm2j8nKeDpMH4t243XoyPReCuD,FALSE,2500000,2500000,0,3
115ihK491NR84v5U8XToAhQyhuYjBtWkec,FALSE,0,1000,1000,1
114UYGHnqMG7Vy3kSo9ShMBTcgxDiGeCe1,FALSE,0,6000,6000,2
114SpWAB7H4BMrVs3VTrcsvEiAW8J7vQg,FALSE,0,338254,338254,1
115TR1NsPQnRZihVRD7BzFK6p2u9Qu8dt,FALSE,0,38210,38210,1
115asa7ZU89aXmMUiuFMyg5XM3aYhbzWYB,FALSE,0,304011,304011,1
115LKibZNbw7UrfT7e7PJRoBU61jxepM1v,FALSE,32289,501638,469349,5
115DWLhs5LgDCMGWpFY7CgdXN2MjPfbLfH,FALSE,0,5500,5500,1
114tdyefZ7Y34jFMerQxwnwmLNTow279Uw,FALSE,0,12269,12269,1
114swiPgh5nYek5rwCNc8DxzAPi7NuMJTd,FALSE,0,13121,13121,1
115PNyL16LeF2RvFrAp4oeJX4iUT6ZztGt,FALSE,0,3019,3019,1
114XtjtfJvA8PrRdgD94EL5qyhq6z5BAuD,FALSE,1741176,1741177,1,3
113tk31VTCcxwKZ65NpjUnUaaCYyQEwjAJ,FALSE,45520,45520,0,2
113rZT2MgKeHJX3GwJDPQeijVQ7iAnxk55,FALSE,0,403755,403755,1
1153cJstZqGsf72zdFgRzMKsFJbsmz5SUz,FALSE,419358948,419433696,74748,5
114JnkHDfLouJcrGXaFTy39NVMjgWqt9z7,FALSE,0,9692,9692,1
115a6cTcgq7iyZ6C5TSoXd9nJTfJoAToEZ,FALSE,0,4400,4400,1
115UqqAQuJZ62xm8RAxnajoUsaBkspN32v,FALSE,0,236500,236500,1
114Jq5CJ2YuGRExPaWBjPWNCzVMoJJ6T5,FALSE,0,15270,15270,1
113w9iDEaeS6mVcXcGuRzsKmdjXTBWGZzB,FALSE,619177,619177,0,2
115NHPaTrQGNf4QyhVmtC4DRMNAvMt1oxV,FALSE,0,10000,10000,1
114F26XuarXVv2iUK3PpQooua5KZVAwTRM,FALSE,0,72395,72395,4
115HnccDB5GrCnz7SDkhRcGuFMBTTUgAsE,FALSE,90000,106216,16216,3
115TSEntZ1mazZdhi6tcZnVCusbVMf5H35,FALSE,0,85739,85739,1
115C36tvnH5asvAPX2rkpmiCTTDT8pRZSs,FALSE,34824,59184,24360,8
1149uqWPdtAFo9d2MXKJ4YmqYiCVwJddv9,FALSE,0,14712,14712,1
114aRi1kT51Y88GTcyZNEemmfFTibppqsa,FALSE,0,89186,89186,6
113r55GRzb7yB5aPtXK7ScXGDq7ziognrW,FALSE,0,954,954,1
114rsjNL4F2hzXeedbMt2QRLp2YvLcbmQs,FALSE,0,85310,85310,1
115Rh79Ei1tsHYp6UCa27UnwYEL398ebzz,FALSE,0,4291,4291,1
113rhDS2DuRdDfVJphKBzvLmzcuRFYkL3r,FALSE,0,963,963,1
114N6aKVmNtJZPM93zXjx6p3RUVACSpNkh,FALSE,0,100,100,1
114ibZWVEnsMdxfxGEjZceg2VLZo6Eg1iU,FALSE,0,19643000,19643000,1
115MXyz2iWJkDfSwowcFSMsxAUcwKuanfm,FALSE,0,141358,141358,1
115HFpARwYVVe5n12xZVF4YFpVs2hksHpa,FALSE,0,5500,5500,1
115kMfkw81baf4MyNipeSYLSuZ7ijcD7b9,FALSE,0,353993,353993,2
113rpAZ2Ndc8n6zkz5ZrmLR9rZCTgB5bU3,FALSE,0,1382,1382,1
114SNgk7Q9fPS2ecXEt9RNsNGHSepFdESn,FALSE,0,59384,59384,1
115Fm6LGAzk2wFM1TQM2zpWnJA23XVgshE,FALSE,0,4178755,4178755,1
114KhrSUgY8n6mKmmXKjozaLZs4fAkCGNn,FALSE,0,424797,424797,12
115nG7vo3DjUhnqY6NtKnq1Yfix2mWRf7b,FALSE,4024,4024,0,2
114KY5owQzCK9xRT9fiwetAX33Wwa3g2BS,FALSE,0,112002,112002,2
113wcUQ25pRWSn5ftNeux6WixSVRGSjTZb,FALSE,0,15474,15474,1
114L7iGeDVP7ayoVbZvVp79spNYnDyQ8pj,FALSE,797619995,797638560,18565,438
115JpfPYggMZqQAMs4NnqN8KfF6ffpwJBP,FALSE,0,4049999,4049999,1
115ftMDN6Vs5mGDJadtcFMyrrUust3WBdh,FALSE,0,26726,26726,1
113tShmMEM75nkYBLdib21kg8iArFu7jGo,FALSE,0,10457944,10457944,1
1158tL2Tw8f5HhgX994Dc8JvpjUW5tfWcc,FALSE,11784412,11789599,5187,12
114cDL8fdHvi5rHceBPTab9ZUGLJMaUSGD,FALSE,0,92420,92420,1
1158nUy1GJ3mJd5GdBWuYzwuBfPHzkJbQ7,FALSE,0,3000000,3000000,1
115oydjHWYiW2UZBE9MJVEZA1trXwoX64i,FALSE,0,190015,190015,1
1151jLBJQ5ccybuUrnfiozKrHLEimTyuqb,FALSE,0,5500,5500,1
114zAQ1ffb57J6x6igY9mi6CkQL3bobn7d,FALSE,0,1000000,1000000,1
114DQWLf1ktDC6CcAYe97A73ptDFig7f19,FALSE,0,2943,2943,1
114qHmfrw5vNAqh3yagGaAbTAorJE6eUgt,FALSE,2094062,2094062,0,2
114faHk9RXpu5zk14FKQN1oPyUhjMdAmxT,FALSE,0,2573,2573,1
114BBgtR3jo1x9cXKZiH9iMgxG9TUjAboF,FALSE,2094064,3296230,1202166,4
115EqtQoE3T4GvCT3bZutaRhswEWHzASDW,FALSE,41356,41356,0,2
115CsjvZ8yYHYysC4kyaPzaZxnabfX8d5o,FALSE,0,43058964,43058964,1
114KLnsxAjLABEbSHij9qEmBQTqXsz45zY,FALSE,0,10000,10000,1
115QbYSHW6Hq4uhkF6YxP4QpqvhuKULiGP,FALSE,3486,3486,0,2
114JDCchdg538XBUnXWwYsa79jTRMpLwKS,FALSE,0,4624,4624,1
114LTucX9MKy114gTDmCJet1hSxkfYSaC6,FALSE,8077023,8077023,0,5
113oayH62UrHkffQPDRvheAhSjeiVFG5KU,FALSE,0,2730090,2730090,1
1142JttP4zv8Rgk8PxgZ1i2ohzGaTU2fBz,FALSE,10066421,10120161,53740,20
115Y1f9ioMaDeG35iBWwFJXavdcJx5fc3B,FALSE,4000000,6075000,2075000,8
114vhBkEbQsGaFvKrUkJfetNsxPhJ1LKfP,FALSE,0,78705,78705,1
1141NzpyJBNmxMhV66UB2x4uyPePheq2YM,FALSE,0,54944,54944,1
115apgzqc3bDfPTkTC4K4YN6RrXtNRngTY,FALSE,0,7630000,7630000,1
11598VMuPXHVjMh3xf8AybPKLr2Domicfq,FALSE,0,2198400,2198400,1
115gyG32AuNdZCkHqbptmDds7NcyNTFk7r,FALSE,0,1900000,1900000,1
114EEU2acNPkKpDqnAjxS5onxxzj9oKei,FALSE,0,500000,500000,1
115AfUNr7TeB7vqw56gBJVRmobSxAGdiSP,FALSE,0,30392,30392,1
115q44ysxg78p4rarV9xedtGEkLo23oQb5,FALSE,72280630,80390352,8109722,10
115mLqvcRCeZrZwUdPrRmJ5eA4TZa7jGd7,FALSE,0,2069,2069,2
114U1qctVgABVHgMBxUA923B3TqxtgjQFc,FALSE,0,3060837,3060837,1
114wpK2GN8h475scYJGHrV9yEunixm5cxZ,FALSE,0,43660,43660,1
115L7UuFuKm87TnG7QsFgyhb9wn8oaChw4,FALSE,0,5888,5888,1
114Hb3sUuV8sYp44FwujsBdA4G5FMK9Wz5,FALSE,0,7193,7193,1
115e71aU5P9qLWToW7rg5nBP3tPuJrRyJv,FALSE,504100,559146,55046,3
115ZstsenrU9qf3RFkbftB8PEgRuXYTJzt,FALSE,0,73225,73225,1
114kCSuBueb6qn25cqAgL99KMKgn9VZujK,FALSE,0,1270,1270,1
114N1m2X4DavyBiGWfxp91mFKU2puoa1Fn,FALSE,0,26544,26544,1
115ReCvUTLuCUyZd2B4agGoqq9sUnqWnZ7,FALSE,0,15000000,15000000,1
114HtGvwUuewLL7M8y47EUzKCiiKFaYpN7,FALSE,1231,500546,499315,3
115Y7cUcH8GuxfN5JfvVe3p36ZqBSCQc6c,FALSE,1125248,1125248,0,2
114fZGf7hgJVztf5WkeLxfu58tGdBFaU52,FALSE,0,256439,256439,1
114emwKmi3EGHhAuMFNvHvdi6RQDhu9yEU,FALSE,133121134,297887049,164765915,765
114q2JDKELnFCupK4WuDuawbhP3VGQANop,FALSE,0,17972,17972,1
114A8Xb92fgFmkELV7i8vYcgZ3Qj1XMJAb,FALSE,0,57875,57875,1
114nF6grgtwrkCwNbkpbECAGzRsfUoQHTb,FALSE,0,10000000,10000000,1
114hkoR3PBUkUg9ffrfz62qfzLWevqmSvq,FALSE,8908,10000,1092,2
115pQpvBCrhk8RtWdK2b7W3mBTQohY62P2,FALSE,0,70000,70000,1
115o2YUK34jW76MHmYEtBy9JUbiadSxhfR,FALSE,0,5207,5207,1
114CwrgjFDjjhYSU8D7WdLWfc3u2hvVP1S,FALSE,6888480,6888482,2,4
11522yaDESFaFyEqAvhoPuwtN9G9yRmH7n,FALSE,0,2638,2638,1
1143jr4hbEVFSJhoFBcx8JZdpTH4nxC6TJ,FALSE,6106013,6106013,0,2
115XLY4Me9hLvtiJn2xjSdf1mWwJzzueoE,FALSE,620220512,1341000000,720779488,11
113tp9eKP6nVR1FLSEbauKeEhV8U6xzGiq,FALSE,29699394,29699395,1,4
114PKNnr7pE5iQaPfAYXRSYsA95RJm7TaL,FALSE,0,7046,7046,1
1143bCc3vLk39WEwf3faouhQPHMXL45qHP,FALSE,39734000,1747081168,1707347168,3
113vCcq7QjZWtG1dGRu92VrqA7P5vEmpxH,FALSE,0,504065,504065,1
113p8aFcQ5GGcxgju28MnMrN9vdiJ5cM9Y,FALSE,0,17382,17382,1
115SoHcw1SsZpzHigL3XoHK1edHvDfe3AB,FALSE,0,1521084,1521084,1
114kbNijB8ZtP7UWmTo7LmFJxXcg1eazNb,FALSE,0,2066,2066,1
114HC4y6jzWketPZFz1oVJrmDhZUAefCpP,FALSE,0,1224,1224,1
115qcSGsoLTfe4eFhELE3BoZefYCEN5vcj,FALSE,12105137,12106137,1000,3
114HdUVBFstiXEaNcFmjdftRjxAw6wji2e,FALSE,0,260,260,2
115M28fnvYeFSJamhq9RijdevwPWmejpT8,FALSE,51217,51217,0,2
114scqTtgpcEkKqWVWoSTqbvpgWLMDGiHn,FALSE,0,49120,49120,1
115NfLjsdhiUf43tu9xMaS5vQZFHkFuCXd,FALSE,80720,80720,0,2
113qeiVhtrgDVVG3CL1Ytc8W5VWBmgprv4,FALSE,0,2329400,2329400,1
115U6TSBzmJXtGiri2r66grnJssc5E3Ht8,FALSE,0,100,100,1
114JWgPryD5m1ZctcA6oHmTVbrGRs2kvft,FALSE,30000,31092,1092,5
115B9cwcizDeX1tnoLVq6DdQSkijigrCYX,FALSE,0,9183,9183,1
113m6kgPFirypQGWhUBq5mqZFXoKfD9Eon,FALSE,0,1000299,1000299,1
113skNcR46yMXTny8TDgoF1VkMnwt5QLnz,FALSE,0,1000047,1000047,1
115ZG9F7xYLxD18SQHkqFp3zGc4sLsiKzY,FALSE,0,28263,28263,1
115SGu4KZ33KLuNsPidqfnxqWcFDBqMGiw,FALSE,0,100000,100000,1
115WJncuP9c8MMPGESUpBqWRRwjXmadwiV,FALSE,0,5587200,5587200,1
114VZCc1HdX3gGRnPpijKGMtmSsz7bDCyY,FALSE,0,5500,5500,1
1147ievQUuuwCbYi3xEWRWi8g8vn4v3WjT,FALSE,0,2500,2500,1
115FAvLrv2Wm6Zxqhp2eV5KgGcR4Z9sXDa,FALSE,546,2730,2184,6
114JyhwboMYtd6knxmwW6sYVwrE9xSbpxB,FALSE,0,945104,945104,1
114E7ue5qaPSfF6hH9LAvgE5oBQiMAQkWt,FALSE,0,209466,209466,1
114feaHZmoXur6jp4ujhw2AYbFUz2npi6V,FALSE,0,1233442,1233442,1
114oro1cMV6DuG6ESmRp5LeYD6JgY4WzoX,FALSE,0,45141,45141,1
115ph4WRG7FSLFWWYpQ8SHQc5nnJVZWP9X,FALSE,0,963,963,1
114tA3Pd4fHz1xY9qdMMgjYjgT6oVw4RPg,FALSE,0,528555,528555,1
114svuk7bZ97VvuZzD9nnTJPLNoG8BC2Vt,FALSE,9954904,9955904,1000,6
115Wp5zWrWyNfcQ9QJpiELtuNM6xob3Sys,FALSE,0,1000,1000,1
115nwViKrShgEUQmNwakDPpF74VQ1woKMd,FALSE,0,12690226,12690226,2
1159RpxVvg7ASYZpSzjXYksr49e28Z72Pz,FALSE,0,543143,543143,1
114FyAV1mYtGaMYyq39jTTaQy2MVm6ZDdo,FALSE,0,631645,631645,1
113xoo9oZLBZsUnwVQKhhniXWACKnMy7cP,FALSE,0,3215,3215,1
1151X4B2nXP7A5nxjSBqNUix3U2HgxvXcQ,FALSE,0,1691,1691,1
114L7n7eHrRQBFEqcsL1kcKh1ZKpizhtVa,FALSE,0,32353,32353,1
115BhDqwbFDQ2Vms4EHJ233pmbGf1iDGCF,FALSE,0,31069,31069,1
114eGcVWJCipSWg9xuKiwv6DjKqG8DdHwH,FALSE,12078159,12198159,120000,38
115Ad4ESHNTf6EXhgb7Y6VppUwy9Udig7n,FALSE,0,92400,92400,1
114DCjt8wTa1geUK3hTMa7u2Rime3MWdTm,FALSE,0,5681,5681,1
114YoS6X98WTmkerqqUBDrzxPCtoQo1Pw3,FALSE,0,533654,533654,1
114M6tawiNVct5Hy12PpgN3nZ7ikC8XfqT,FALSE,0,1190000,1190000,1
115ktKpVQ7yupdtipGpkoT6r6d7MWTwFVw,FALSE,0,925128,925128,1
1156TcNt33im3tACY8u2pF5BQv6HL3JXEG,FALSE,0,10000,10000,1
114uh7KAr3yTj1bcQazMG2E3BkjwR8B1m2,FALSE,590000,590000,0,2
113n2bLFS84YLCy9NiCCMbo5TkV6uC3KGX,FALSE,297491,297491,0,2
115ibDneJsdjBV5Cb5yVV7fycgXjiSdLmS,FALSE,0,5215,5215,1
1151YKHt6peQxGaZD8HQdzDzeGEjJAL86r,FALSE,0,19000,19000,1
113trco51NNfrKrbkShcxvvLAkcCXVYVAf,FALSE,0,416907,416907,1
115b9zMwhs2iyD2iCoUoWMeiUcV3UNeK4w,FALSE,0,59831,59831,1
114iy47hiB1iXCQ8YWqrhhVbceg1wf1HUp,FALSE,0,10854,10854,1
115j3gspS2bNahZ3NymR38Yqd7r4oJLtEo,FALSE,0,22661922,22661922,1
115B62sica6LXBaTXoh7V7HYYzxA2k3MkX,FALSE,0,6550,6550,1
115ZbAkRjCeitvTTqebYCFWApXpySFdiNW,FALSE,392810,392810,0,2
114LeEyD7rNKdGbGVFvFAPn2T3Tp63gYZ5,FALSE,0,198613,198613,1
114wvDZHTJAoeLUHLkPWSbxEJyFg7oDvoQ,FALSE,0,11195,11195,1
115RyNSbLQHpMrtZDSt3Xq2yYj9N6tSFK8,FALSE,0,49207,49207,1
115Q3rDbx3BrFuo6PEyTc5brdicsBUDKTM,FALSE,0,94870,94870,1
11586gdGhF3j4p9kFaWCkjyR3Vw8eaRW8a,FALSE,0,262101,262101,1
114SmfET7wXSj8JTqPVmJMFpj5fyfQeM28,FALSE,0,12689250,12689250,1
115MtXXyhnj9k2nWf8ZDr9tV4thCBB1kVD,FALSE,0,33320,33320,1
114Gb89pPFmC9JWikD3CtsGFML3ooXXgtf,FALSE,0,548,548,1
1146g4VcCXywGJnH5Fygi2vpnypS6FeAUv,FALSE,0,16463,16463,1
115e2Qgw4PNffFTFMQZvNMbcZCXtob1G3i,FALSE,0,40000,40000,1
114RENrEb7zqnVZGz6o7jfrEQNj3vtfAMe,FALSE,0,10000,10000,1
113jPssDjYmhDtLBr6fGcp1DsH9g3t8KEL,FALSE,0,79681,79681,1
1141EizmJwbnaionHh9fLF9u7kbZDaz3xy,FALSE,0,31442,31442,1
114MMMa4WiqHMqyptxrHLxfLwutDemevfZ,FALSE,0,18102,18102,1
115VZzFCzPCXFVbhoE7vuspbq6YCeNCiqM,FALSE,0,100000,100000,1
114cQoaqVZ9gciGgiZqekzvjUCGeYdhXdP,FALSE,0,9782,9782,1
113rMiAqLAJddZMvkkzUdacmidTnBNfWEE,FALSE,0,18702,18702,1
113CxUfhq3miVhJbV3fVNiUwjjtfNJNxQp,FALSE,8808,21092,12284,4
113xrPTTojmGBL2BHV7hfPyxHve4t9dXHZ,FALSE,0,1526337,1526337,1
112zfzs87vSSnAqgWpJBZdRZEwfUUMo1fh,FALSE,0,3000,3000,1
113yEpZ4G4KPy5yTMXGHyXqpxTH5Gu3ucJ,FALSE,6000,6546,546,3
1123Lv5EogMRJDAtZmXD22kLP6xzCsE8uj,FALSE,0,3232710,3232710,3
112wrW3CXJrVntezYa7HNcB1EQK51MarSM,FALSE,0,2730,2730,1
1113FrXxxC7N2iWBUynGJmyGgiX6gEYn1,FALSE,0,2730,2730,1
113SL39zLivArda1E42LSPos2K8CgsAob6,FALSE,0,18927,18927,1
112smoXcwsfiUtZKCNTUyPHDxoRfb78eWz,FALSE,2214146683,2214254621,107938,461
113rv1zyimfbfFmV4bWfurkKpQKHpf4wag,FALSE,250856472,251773068,916596,310
112Mun1Ze71rR8rxQQPXu8iBaygmUN7jvc,FALSE,546,1092,546,3
113EqxnZsL8zDXxtc3bQecMrYuWSeAECP5,FALSE,0,1465383,1465383,1
113iq51MQhGs1E3gKSDj75kjk9K4haQR9r,FALSE,53626,66953,13327,3
113xF4LsUqZ4ffqLHzCHCwyawkkX8ZXMb9,FALSE,0,1324,1324,1
1124gpv3zC77HTJd8VZ9H4e8rwVxvjEKYL,FALSE,0,14571,14571,1
113hv95urhyGP3ftEcCCLTRbnq8keu3FsZ,FALSE,0,14137033444,14137033444,3
112HmChTJ1nnPJHUYWv4AKZzKuSjHTy85M,FALSE,1079149,1079149,0,2
113GH5qpi6TcUXWRZRGyytPp4Qp5VjgWJg,FALSE,2120392,2330474,210082,6
112udTKoweicB62q9dTRQK7zqc37fzps2S,FALSE,1000,1000,0,2
112cGc4i74jKHUnYKzqnwmEdFuAfompDk6,FALSE,0,31232,31232,1
113Wo5q9EBVD3BmDccYzqVfimvxLEgKX2z,FALSE,0,62630620,62630620,1
113GigUpQjgSzShom7kz2q63jvgj4dJMo3,FALSE,0,1030,1030,1
112QY6LJ4ANnE2ufNE2XMyPTd2ifzmJJF8,FALSE,50000,51092,1092,5
113NNdhVTDW9JcQgJswCh726QJd9AhnhX,FALSE,0,26546,26546,1
1138ccFB2sbLwTEpBVck3WQr9zZitGNNpF,FALSE,1515460,1515460,0,2
1121tF5ApJTYtvWV5seaZwFiaU8x2BdB59,FALSE,0,179978,179978,1
112QhJ8BmNJkC1UV1ZScesgxVuuHPhjtgs,FALSE,0,102991070,102991070,1
1128nTw7zwkfExsshwrSKv4SuVMk93jdp9,FALSE,16056779,16056779,0,2
1126CoRvitVicjSu876Fj8AhdKk9L8JaLE,FALSE,0,10000,10000,1
113gKCQxahRSJaHibokYrhvPh95bhniJjR,FALSE,0,13600,13600,1
11114Zs7KPQG7CckTKwApqpKDE3cMd8R,FALSE,0,5500,5500,1
112khFWQMhyTGNKdae3XhwZFGrt4dcPHxY,FALSE,0,1123588,1123588,1
1131XafDMXrH3JufKEtA784T2uMjyXYApM,FALSE,0,20000,20000,1
112ZS8N2y2ih8TCUjhY4Qr76g1r5Vqnz2,FALSE,0,2895,2895,1
112tCP69ZuAZhhdmqv3uGq1HspPZpbYYGT,FALSE,0,67000,67000,1
112Kh8RHajxsj2yqdvrdcq5L4bLm8xymY,FALSE,450100,540100,90000,3
112Ke7naoxwcAzh3XYaLZHHpNMXTy53wA5,FALSE,0,266387,266387,1
112bphPQq5jiZJQ3kPioBWJSxbFwW8Nn88,FALSE,0,3550,3550,1
112ZR1FWQjMG6pokEgcS5P1EGywSZTqV1c,FALSE,0,6834,6834,1
112SNxKnco7EeE853wtoMC7Xpi43C1qjTb,FALSE,0,19573,19573,1
113JWSvLZybpHD3bFTWL9Kxi3hrK6mf9Pq,FALSE,0,25182,25182,1
113VnRdujQLbJrPdSS1Jk1TffDPruZjqRa,FALSE,4500000,4500000,0,2
11219WB1PofTZZNW7juRvcGY9hWNRBFCjC,FALSE,0,1050038,1050038,1
113CdWgseogKv7XRBGknUtm2hpsvNVCLiP,FALSE,2628396,2662996,34600,9
112XULKeiGHWsW3y1SnZw2B8fKoC2pMd4u,FALSE,29522192,29522192,0,2
112X5Xurh5jcj7ZJwWFjDdAdnnHQWiHtqy,FALSE,901,901,0,2
113yUmxuk6bLF1Bmha93T2x2irUgZUUK8D,FALSE,196313679,197023487,709808,64
112Ufh2JHNYamCcr828LxpQyxwZRCH793z,FALSE,0,50765,50765,1
113vkEvYaQTLZRpUBwbAbyQJKen7aZHSyY,FALSE,0,1000000,1000000,1
113cdGN9agAfQZcEV7Tx2QcAhQSTTobZw6,FALSE,100546,103276,2730,3
112HhTASbLBeu7bV9Y3u2HxpXaBbf72kiF,FALSE,294020000,294965194,945194,3
112PGGNTR9QMg7WnoBB88zLfr8umUwyAuP,FALSE,0,5480,5480,1
113iE4tzdmc9pFZQCv1E3ZJzBw68BjZv58,FALSE,0,27965,27965,1
112mE4yjpHprYdVKt1TiFPyokVBDoDk6aK,FALSE,0,227100000,227100000,2
112yeJphcQHizy1idVPJxiXscvj3ZmiGJa,FALSE,392639980,392652441,12461,6
113fiXgkieTn3B39LAW5uZfkmTmhm1gJdX,FALSE,4334638,4454638,120000,31
113nTmRAZVPsLH7y75fojrN3kdGH17aEs7,FALSE,0,739000,739000,1
112TsWEov5VtPbcmpq4nHks2fiJH7JQ2qn,FALSE,0,508055,508055,1
113ZeWKvZfVyo6wB3bo6xahzeVJtjsdMfk,FALSE,0,48239,48239,1
112yRC8vm1D1wbbijdWEqMxA1mA8NsV3by,FALSE,0,51099,51099,6
113U9y9vZTPYRnmV5azo5EJJcN2kDDZM9M,FALSE,107833989,116613989,8780000,6
11329FKSCXH78owTqCFYyGU4ukYkLBB5i3,FALSE,4281457,4295057,13600,49
112LGf3Krf6z7ZX3uHDTX38kb3qKgvvqHn,FALSE,0,10000000,10000000,1
112s3rruY5m8pv2DnoEZCXagksx7nscfRp,FALSE,6000,12546,6546,4
113MHbhUEuSNr4qqyniyF5gXgZ7Fk9kjwu,FALSE,0,9610,9610,1
113jHK9E5nhc7X9LDEfLeKJqtAPCBCdYsY,FALSE,0,700,700,1
1136F9NyZFeBQEvtCcGY75Wzgouau6Hr5v,FALSE,0,14014,14014,1
113Fn6U7oqRDMCKfPewT1kCjB5rrLb2DsK,FALSE,0,86221,86221,1
113fnkBohAukAeEqBe9hZKKsjzyNZyPGXd,FALSE,0,321634,321634,1
113sZwafQt8yqgYsYAUmG4icFxDThuYXq5,FALSE,0,3433,3433,1
1138qC1Z5g9TKvzjFbZjwgkWU4eYX26yT,FALSE,0,29314,29314,1
113kfShWLdHP7QJMwzf2Pz6YeUfuRG2btb,FALSE,0,3230,3230,1
11251zRiZ5yfv1YUMfvY1w2dmfFxARDPgH,FALSE,0,4786973,4786973,2
113KhMjNjRAXT6cPeVvfTGdrA5kjty2RUg,FALSE,0,2000,2000,2
112QYN6pTK6UjCrACAyMk8kcznxy5gwzFA,FALSE,0,8200,8200,1
112d3Gq2JyGo79nP3fo9PNXYzjPJ9ybUjn,FALSE,0,4365,4365,1
112c82vf1ED721GW8xqM3eCEvKJV9GwVsK,FALSE,0,1838480,1838480,1
113bqy9mxbHgNBJiK62RA2zXaHFurdXT56,FALSE,3339900,3339900,0,2
113xeGJZUkjbMNCNByuBDzvjghyXeJvjEN,FALSE,0,8610,8610,1
112rdkWdfNuyuwdpazFCnRudxuNDJz3txh,FALSE,0,6465,6465,1
112VNiHWFb8DfrKbiuZzcMZzD15kcQfJF5,FALSE,0,5086,5086,1
113o6N8sYGrDotnmGhbA3egorSZpXEKTwC,FALSE,870300,1052140,181840,28
112ksXjZiyjrWoCYzf3SG9wZGi6vTPZe4D,FALSE,0,30000,30000,1
112EczTTFKCxZSqj2EWLeWv4GgZA6EyGG9,FALSE,0,115037,115037,1
112AL5GbtEZruHNqunsAoJJfasbRgGYrDM,FALSE,0,2861,2861,1
113Lx4uNXxMSPA2nxzQ2WqwvmBeTca3q6X,FALSE,0,185200,185200,1
112tUCXHREXDEh73pwxLD2oAAxi8FRK8DA,FALSE,0,1005529,1005529,1
113onGGkQxb3bSt2KPAgH5dxB7WwwyFvi1,FALSE,0,9314,9314,1
112TVXknRDPCYox1n3paoqJN4nUAkaTTpz,FALSE,0,724778,724778,1
111BLh2VfXoRD5EyYkqTZxocFsGzKy3cg,FALSE,1638,2184,546,7
1129etT97TW4oVH7aQwmbtzLLxeko35Z4L,FALSE,325047,325047,0,2
111g3qjk7YzhdkKuMmTBzUB8gQ55YZ6MG,FALSE,0,5000000547,5000000547,2
113wyxjpwLFL9JhNRdGhsewicnHxW1hyLx,FALSE,0,7173,7173,1
1123XxEmXeXt5oJuMK9ppbpS36o2SpGRfE,FALSE,0,784314,784314,1
112YM3BS6k4GcHJRTTKLSij3H3kLXqPvGn,FALSE,25546,26092,546,3
112s8pkhrKENrYZeD5XDFzdAYKdSoo38Un,FALSE,0,79275,79275,1
112mndwpS1oayYFPxfxWhiVZCavWmZbgsj,FALSE,0,12782,12782,2
1135nixTyKRrLjiRHCbK52bcRdZron5Wp4,FALSE,0,420000,420000,1
113xZYubFtFfAbk3kFZGw1ybLoPJbcGSoW,FALSE,1852594,1852594,0,2
113ti2y3GFapdSyY2XQG5y9YYJpvQyj3DE,FALSE,0,1461279,1461279,1
112zWoB46VHkUDVeuAiCdwKCfuEXM5WXhP,FALSE,0,8937,8937,1
113d2ZPnLjY4YKCTftWfUtFC3ZvgVaoatw,FALSE,0,226850048,226850048,1
112WZCpLDtYkTPNJE4sV9Yyt3up9wjDC7q,FALSE,0,260190,260190,1
112gGr4CQTnkXdDEubrPkSkDxzeJGkkXBY,FALSE,266882,266882,0,2
113oG779PwazSaUDmAewjDsEVD2MZU7U8L,FALSE,0,1077908,1077908,1
1137iRBAwrJ5Dr9DYFHehLBAuJNKJsZj97,FALSE,0,500000,500000,1
113J7iVXsRvGgKnorBob5jH1o7qhAbQVEv,FALSE,0,5500,5500,1
1137M3dJMo83ddhBoKwtczGQWGZcP6sUyd,FALSE,0,28017292,28017292,1
113UtcSnf5pd779nYWmymFYkCzBWz9TbLE,FALSE,0,1000,1000,1
112PQKsWPmaCUNL2Z8jgRG15KvAWFFmoKS,FALSE,0,39500,39500,1
113e4PrDBy7EQergzjbXVQEzmY3nE78Jec,FALSE,0,219828,219828,1
112y8Cxy9uBVNWK794UjSxcx6CwTYrRT9n,FALSE,140990,152990,12000,6
111UJWmdm4zZb7NiJcAfUifoexXrumK1v,FALSE,0,406182,406182,1
112AnfDGkWYgkyhLeFpjY85kMZnzcEhFWN,FALSE,0,56237,56237,1
113PfyueSMqiZ7u9ctUPYjtCxGEBXFMky9,FALSE,0,2100000,2100000,1
113FcMx6McmTgQm7frJnp3sQR4REggT7eV,FALSE,0,664,664,1
112JSZcWmP4kz9SaC71oMFKpyBZTTTHdnU,FALSE,0,25739,25739,1
113mBLPZLgQ3AQcdFsjf4NffiEMgZ9pA8H,FALSE,0,595,595,1
112JEvGQkTAHw77AyXSDVKNUenAF2i35WL,FALSE,0,3686,3686,1
113XGXXGqLR6nJwgdZR7RLHwrbYuLAobAX,FALSE,0,44986319,44986319,1
113maYjRxF3AuteUsdPd2zSCs8eBRWbXa9,FALSE,0,1486,1486,1
112mGAACfFK1zWxGqgDspe43XZ2myMFSQQ,FALSE,0,396572,396572,1
113Y2rb8q58dJz3e2iTS2M4W9BKcxg187D,FALSE,348257,420373,72116,3
1132aMCMDM1hPBcwYVpzJMBrf5ownzE4nF,FALSE,0,66350,66350,1
112z9b4CbAi3csWo2hP3VH6RrN9FncQScs,FALSE,0,87392,87392,5
113TN8Ytu3rgX2vVwgjYpmFypbTxEN64yW,FALSE,10652399602,10672433314,20033712,137
112bXDvjXVXDp5nNJPZQWupjvkus6C6nJ1,FALSE,0,25000,25000,1
1121KmqB8p5WKR2o35avUEC8fpJWMZRSHX,FALSE,0,34743,34743,1
113Bi4tLnJHt4vdiaCUCkGimZzuaNYsYn4,FALSE,0,275622,275622,1
112AUpWaaBHqKs8RYjSArKseRXsgGEFUVR,FALSE,0,943948,943948,1
113Z7tDtY3MVUsjV56LgsJcpY1at2j7nKr,FALSE,0,108000,108000,1
113ud4E5abGQH2PhCM3vxezuKf3s8ANrcg,FALSE,1376610,1733483,356873,33
112zv38eJnCB6tzHmt1VnvTMfw3sZhhsAq,FALSE,0,39644,39644,1
112FW2A23rmVKZN3uwY7baiHeaoGEfEwXS,FALSE,79920000,79990000,70000,2
112yLAu8GRYU1fpQm8wUjMzZb4Dkys7cUE,FALSE,0,852,852,1
113u8pvHDayaGqY73Roaeu4k4Z3a693CVh,FALSE,0,30000,30000,1
112A4Lpwc5SVFAXtZgZgRchPhqMrfZy1FH,FALSE,126000,128730,2730,13
1134bMaFmcvCxsu5ApVPCCFNbuuGWqnBrT,FALSE,0,103800,103800,1
11355qvQZNutzEcguvkboGt9hHn1W7QDzL,FALSE,283271,283271,0,2
112Qixid4whVFeF8xvpRLLBMgP4dCzdvgL,FALSE,0,5630,5630,1
113PrgcCyrkUgYCk7xb2pU8Z6izcpybYt4,FALSE,0,39872,39872,2
113JTrkpk9qUV9Tu6LoJrSNv3zBFfvUWu,FALSE,0,10000,10000,1
113B2Qib49KbmYbq7dguGPgZc5BRjGwviM,FALSE,0,4085,4085,1
113vhHjr6x6jRxqk2JryCR2ujKxAdZ8xGJ,FALSE,0,11000,11000,1
112kbhWzMTvSGkmpYUfzToZ8oN8DTL5yRU,FALSE,0,1201237,1201237,1
1139QwEBxeyCJdgWyS56UdfLAom92CXhj7,FALSE,0,902840,902840,1
113WePjUgR4F8xuYCjPdCJWV6EDYdxTDkW,FALSE,0,169162,169162,1
113NN5EGgH2jV1pGUAwozgp9dTNVRhNJum,FALSE,0,27639,27639,1
1132cHsQDNdvsyT8h3jd6cy7g2ewAHU9Fy,FALSE,0,1356000,1356000,1
112R4bdzZBhx8z8x8WYbpYywPwVQy6eoxe,FALSE,0,19427391,19427391,3
112yAEUEmRnbZkfA82V2cjmZ4FVZzR9jyB,FALSE,1425051,1425051,0,2
113Rdfm9u3UxFbfBFfoMiqm1ZED4hkcCZ6,FALSE,0,577576,577576,1
113pvgG2yThnSx1mQRfH87U3SFo4bMX6gb,FALSE,7237893,7237893,0,12
113Z5uRMXtejLZYSKYaiDvz5Ld6CTyFFEo,FALSE,4485662,4485662,0,2
112Tyg42F7qGVrpvYZw19yDEbJEfdZPxHh,FALSE,0,980000,980000,1
112gyWvsMS7B7izjvyAGqhymCraEAY6VvW,FALSE,52422166,52480266,58100,54
113t2XTQ66AoBYKZM5nEY51rpDbqMNhGk6,FALSE,0,10000,10000,1
1126uQ3rZgpApFimErTEuy9r2LUHDiHfQz,FALSE,1457,500546,499089,3
112mmD2YLQnwBowccCznm9H9dJtuZetwNb,FALSE,0,1027172,1027172,1
11111HZkt6qqipyoW8rkcagh4LpsN5FW,FALSE,0,2730,2730,1
11221khXDVQ5U58LxRuqoNFy8qK5Bdsmxh,FALSE,5546,10546,5000,4
113JtcRYh5V1g1u91ux37ZFdstkiUUQ4TS,FALSE,0,81000,81000,1
112MZjeNdwJ97tLL3VxcxDHytaH6fQzng,FALSE,0,16700,16700,1
113JAjzwT5YK7NG2aZ4Ftf8BhwyTK8MuFJ,FALSE,0,693161,693161,1
113RDASzZAAmufGaocgGrayshiE8V9gnx4,FALSE,0,2980,2980,1
1126H7HVHfRWNpbyKovEzqMzFmxeknQZHG,FALSE,0,5500,5500,1
113M6yEoqAHrEnfyjfVNworMP6byTFKZF8,FALSE,32532,32532,0,2
112JLEdTrJ3iXoeK69fGYfdqADD5vdRtNd,FALSE,0,10000,10000,1
113foH1PgV8X9Vhg9GmD38wCvNr1HG9VjR,FALSE,0,86382,86382,1
112meBekYroWfsBiDCJBVUtNipbfJ55N5z,FALSE,0,5500,5500,1
1111GBLtYa8VrUrkw8YHW8TDMvMyHpj3n,FALSE,0,6048,6048,2
1129WDXyS6SwqgLHwiGxTYQu1Ai9QfWL6S,FALSE,0,751700,751700,1
1125ACoQ4NRzfoakoDeg5qX4hwKnZZnxPD,FALSE,0,1045,1045,1
112ifB9PyU6mW3eMaeaSC49QwYSowoNcBr,FALSE,44645,504914,460269,11
112ojwpiJZiSY3tdKDbhLPN6W91odV2kn4,FALSE,1788740621,1788741715,1094,857
112UhmM8upKSNjv2JEZ3xFFSg7WbAaHXZF,FALSE,0,1727,1727,1
113gd3UZMZVU1xr5oGZ1vGqZrsFMpvKxLM,FALSE,0,700000,700000,1
111112w1wXm8nyCSCJxrcZPcRXoSJSoUu,FALSE,100000000,100010000,10000,3
113wq2fxFbXDPRygXXCBp7ggb83oWjEhew,FALSE,179947,179947,0,2
113cmGVpWPFtri1mPmnRdvg7XMJBqiy6nz,FALSE,858623,858623,0,4
1138RXQo7RkbQkJKNgXCu3vx8EBuM9s3pK,FALSE,1008312,1008312,0,2
112A7m4xPFkgFnuVbFNDDzsPrBL1Lbf5rW,FALSE,13747,500546,486799,3
113mufjA4gkYFTCuKbwhcpu8ToBZPS4ixX,FALSE,0,32297,32297,1
113pRQvXUhJ95a8mqirh4jR3U2bgw2ztEy,FALSE,45271171,45271171,0,44
112sYzTaYnsKCvDAq525NPTskA6pfD7LfM,FALSE,1844931,1844931,0,2
112gMHmdw7uXjBbixvA4f1NZLrVx1D9pGj,FALSE,0,6035073,6035073,1
11321QENtTW98vNRbzq6p3FPgjayjnphG2,FALSE,0,1890,1890,1
112zPA2aoJZs67CCuidarZgY3XJCrnh7Fs,FALSE,11424990000,11424990001,1,5
112YCQUvCBo16LNkSxVeQiwa64UMhhGuit,FALSE,0,1922000,1922000,1
112Nq7g8uqM8caUrV5zULZuMBKzUsX1UYK,FALSE,0,5500,5500,1
112d6heVNzAKujwDaWqYXDLs8izLrWCQcU,FALSE,0,43042,43042,1
113haHYEBobfF7CxENxKGuJpHMPdWD1gqd,FALSE,0,4776,4776,1
113Bhm3WKZJ6aCdZ1Cy1ucMmTFS6qFassA,FALSE,0,94634,94634,1
113b8QWXCXjgBSNZtDTdib3demVU86duyf,FALSE,0,5480,5480,1
112whEZ27k6gFL81kr3KxufPBG225cuE3v,FALSE,0,5430,5430,1
112T8ArVq39j6pXeYbLSX7AbwqtTdmnWcN,FALSE,0,20000000,20000000,1
113Kv7yjJVeR56pvd2weG9eiomfGNRiW5F,FALSE,0,845806,845806,1
1129XtugaST1iKYrSgL4ncYnZp24otfHLU,FALSE,0,10462,10462,1
113DUBxQgNiKmJGVpPvmRHQCcTb2Qi8jCq,FALSE,0,710,710,1
1139NvU2gnFSHtkUNCf7vdsWfzpdj7fvCk,FALSE,0,996327,996327,1
113RKapUzWAhcA4QWtFkZSW5HUGq1qv6zs,FALSE,0,9969,9969,1
11227bxT65tjLTL14245JXyf9rKMB1bTPE,FALSE,737845,737845,0,4
112oqphbeetC1UsH8Ks8KRwrdpX2yUYUoi,FALSE,0,2730,2730,1
112Twmnew2sehPpJWznp6SsweMtftGKnpH,FALSE,228205627,228240149,34522,16
112uUCn8W9jfezmdmA5ZzeZQ5bV7cvRgyc,FALSE,0,55454,55454,1
113HabMMvEwzPiw844f3n3aMFYhLRYgNZA,FALSE,0,49918734,49918734,1
112Nn1CQjbvUR6CEYJZLyBTY4TkSiqcfuS,FALSE,0,5792,5792,1
1137gVkB3hQxRjsxZUXKAhJ8xdkkS9REFf,FALSE,0,3972861,3972861,1
112PfPmAnoPwEfL5UPkYAxJ8kLwsgKZebn,FALSE,0,4000,4000,2
112UhgV5qPk8YkmmXT2JJuy3w2Xc9tE2xX,FALSE,546,1638,1092,4
112R4ctz1HuakZGw8T4YhJ2ynGaz5nGFDJ,FALSE,0,546,546,1
113sb1R5DUKsbu84vLmjN35cAPvNkdF8qG,FALSE,348684,709858,361174,3
112Thk14svFbiUcGFsaMDtoYDU72k3f6NY,FALSE,0,50002455,50002455,2
112jbqdWV9AGy3vF4zZ9o2BDRcATfqXcWp,FALSE,0,546,546,1
113nt8tYu9zKCW3jYEXr2XLAvGGdCEH485,FALSE,0,152643,152643,1
113Gxy2n9gHEoKNW895pRc4PEpVcqm4ebj,FALSE,0,1484,1484,1
113Dq9uPBoNniy2Dii2AS16itvVqxLstCm,FALSE,0,11314,11314,1
112vCAdnUT5qbVGyWbMe9uNuN6cp1nqiEn,FALSE,3276,3822,546,8
112f19fnBKVLFLDHuDshGWhi9zDZrCSzHw,FALSE,0,13222,13222,1
113ZgonEx3qv7aaN6KPiupJsdBqJxgtPSi,FALSE,1163200,1163200,0,2
112GrfBrqPLsUiUMGecNCZirxvkFRffrDh,FALSE,0,957,957,1
1137jRSbiUtogF6NwhXmbs8DPso6qgo479,FALSE,0,6000,6000,2
11123sRogtTv9gowurwfNqGQ8iFfyhkZbR,FALSE,0,828730,828730,1
111bzgtx7ryQ4G3PWpx77SFizUtSbEcM6,FALSE,0,480000,480000,1
113PHMZKCFKiNaavKPo32XYMkXNbLPQiBu,FALSE,0,654,654,1
1111111111111116e9ThMiVeQfumS,FALSE,0,6480,6480,2
113y38hUKkeRkWFa59e8FD5tMwgHoyHjm7,FALSE,0,488077,488077,30
112H6ypxUxpZo3wusdnj17bmjdXfy4bk24,FALSE,0,126638,126638,1
112LLm7YtDTxUoPNgcyBXYoivNEnL5CLBu,FALSE,70524,70524,0,6
113Z8RZKSbgGcc4pNMUJrmqYrLRKYLEC3F,FALSE,21167745,21190748,23003,40
113HyiPxgqUboPd2VaYQ9agS2bYcW5FZKv,FALSE,317882800,317882800,0,2
111pH97ZM88dY3hLZpvRLq8zzVrqMB1bn,FALSE,0,43742,43742,1
113Ph8mGZoD83hSCP8WaCfTiX6JrrM4SEN,FALSE,0,12904,12904,1
113TrndGVMguyzhzLeTevSPHoQUejjReiD,FALSE,4726279,4726279,0,2
11111111113UMudt6u3qhLS4CaocnFv,FALSE,0,548,548,1
11111112qdAx2GurLogQnQVLmnPthYih,FALSE,0,2000,2000,2
112pRmhjPbGYYF3xQACkxejU8LhH3ZHtuW,FALSE,1346214863,1346254750,39887,19
1136vE5F923NujzjUfJpN9KpCY6gfhfFaS,FALSE,0,10000,10000,1
112pnDWdQRCaMqPf6r7yuJm7o7uzuyxNt8,FALSE,0,815,815,1
1124fASZQfvGAUMEqLK8NkiYxRdVdT4pBQ,FALSE,0,21863000,21863000,1
11119PhMRJiPM1d1wDu4pZEqSk5nU2yjG,FALSE,0,6048,6048,2
1124PWmUMYYVxZk93bW84qyaD6yhLwJr3c,FALSE,0,85665,85665,1
112EiY2ULGbB3kSw8sRe8iqtgu3aawHuND,FALSE,128039829,128210894,171065,8
113xTjDq5uoXVKr9okKwuF5He7hLzaL6SC,FALSE,0,27570,27570,1
112kiNLNodV1onuqjkS2GGJ8P5g8y8FoBY,FALSE,804549,804549,0,2
113FDGF32NqFF6V42iyNsxrt2A9nRUG5R3,FALSE,0,451160,451160,1
113QURRyytxPMr7Qi7TrnKKwhkdhjGCGZj,FALSE,0,156679,156679,1
113Dd5CRFNbVpbAFudSSBCnMU5xP26zPs9,FALSE,0,100000,100000,1
111111112dyNc8CgfGwc4iASFMW1f9k,FALSE,0,5500,5500,1
112tnNunWzgjWW3fzggodLZWqZehU3nhet,FALSE,0,1093,1093,2
112BArwiuhVHFZCXsRpwHgNEonyJAhbLb5,FALSE,0,130823,130823,1
113emHehSnmDukgX5GmqADn2HTmG6vd5wW,FALSE,114529,114529,0,2
112aKRzw7wruYJ9LKYXverwatSewN3KFbx,FALSE,0,1950000,1950000,1
113DX6ASUqvbve4JNz3CXS71EQ2mPNGs93,FALSE,0,5980,5980,1
113T759XviygbGEaJaCMemhUZ5xuGX7vE,FALSE,0,2688,2688,1
112nRr58HKif37crJ5hyhFceeoAyXhdL9r,FALSE,0,13026,13026,1
1128PqcET48r8Nff7F3bAqUYX7GA8hZmAj,FALSE,0,132021,132021,1
112NaF5soZxkBMRdz7kV5PJfagRfBzjSa6,FALSE,0,40540,40540,1
1137RvjpZCTRgEs2CEBeepXC8CBtLEXktp,FALSE,0,30000,30000,1
111mZCttvWV85TCZggRj3HHYm63CrtndE,FALSE,0,1300000,1300000,3
113uzc9X3FY4wpRkmXB9APK3JMiVN7Xv3B,FALSE,105031902,105031902,0,4
112pVDfv4T9DWrZkCwn3TVx9mG89dseYdX,FALSE,0,247081,247081,1
1132Fgx8UxbjsGrWkZiBgbZWHEP7Vt5sG4,FALSE,4338,4338,0,2
112prS81xUrKiKv7VGSE2Fs8vjVgi2sGZr,FALSE,0,98475,98475,1
112bisGuRFqq9iBi7m71h7NgjdDZXCSjEK,FALSE,0,8000,8000,1
11111111111TcgsE5ehVn4AQAF1Y1m,FALSE,0,209200,209200,1
112ZgoG6dWdtET93PGj3ZBvUGkEVKsuMpv,FALSE,71364,73266,1902,9
114xpScPzh6FotuhdtuP1NtVjH8rW4usbt,FALSE,0,5500,5500,1
113HqgNgzhkizT58Mh1GLQdVM94ZvkMTok,FALSE,0,12856,12856,1
1153WhRDQVTmsDj92xrRFxy5N1K8hw8ewB,FALSE,0,696836,696836,1
114DcU2LfZsGynFH6CSwgrbKtcR5E8a8zK,FALSE,18306,18306,0,2
114aeheDNuGWQqdSbn7MYhGVzUUACTXHJ3,FALSE,0,1000000,1000000,1
1134yFYCdR2cpd29gQo8Y8aRYfMSE7pq1Q,FALSE,0,7360,7360,1
1136stpVSvHNrEHGkF7SjqF2f2jkMkpuhg,FALSE,0,121924,121924,1
1151Dd3ZsQEngCP1oYUFsCoJwqzXHenV9,FALSE,0,11500000,11500000,1
112yygfMCDtJqVuSe5Ec4xYrUkExJn4Kp9,FALSE,532898,532898,0,2
114L9EzUDbEqEkQshPrqymq3F7DDac8BkQ,FALSE,0,393695,393695,1
11468NXEgjCyrFPciqxxauysc3qTKyVdDQ,FALSE,1092,1638,546,5
113NKZuVd3cdymqBMWkD93efrz8vmEvUQV,FALSE,0,12683,12683,1
114jarn92zhj9GnJecD7UUnXG8YSqrk3ec,FALSE,13508378,16625696,3117318,2
1141avVwV4AU1MEekH1pBGxHbUsoVmMXbX,FALSE,2157782,2268134,110352,10
1134CNS9hV9VHDnW3MLCx8LuHYYVfWpixL,FALSE,0,1004500,1004500,1
113Yj9w45Br96zrE9UFVzBgA51c2YdCCge,FALSE,0,392473,392473,1
1155JFsEJZvZZq28KjAXEaqwhtp91qS23h,FALSE,0,8117012,8117012,1
112w1Wytf98QTNv52Q22jATWyHjJFjbkep,FALSE,0,4151,4151,1
113UmTk7zwtgyeutizvAistQX2f8xXw5s2,FALSE,0,1000529,1000529,1
113pj5zEE5wYYpHRn13F1MvZSSP78ujSgi,FALSE,0,40000000,40000000,1
114bKKQCHneVWJ8DxWggKQuNKtUSDHQqyN,FALSE,7000000,7000000,0,2
114RP9yZftcEtjsURM4jAGKfBXWkmdPLUL,FALSE,43630000,43876363,246363,7
1135DEYUJGYXc9fpYpqbDFzwyDqkqeGpTR,FALSE,53480362,54079942,599580,198
114FDKjXp7SmiT5C3XEmKBhwMDZkbG8NpC,FALSE,0,2373357,2373357,2
114Tvo6858trpYfdQRdMzWTyPSpBeW57ic,FALSE,0,87570,87570,1
113TdunzEUNno9cQVtzShB25bhtGrAdyDx,FALSE,6759826,6759826,0,2
114eyV4YoeBWbDn4mncWeKDJEUV1Jf5w7j,FALSE,2056565,3101301,1044736,10
112yYWHQ95rxe8Fy9895tJ5pnph1qsCGRV,FALSE,0,473147,473147,1
113SzPhemhw2axtTKk7ZD7RSAscKGgXMy,FALSE,0,1875,1875,1
114QMAtxEc6DQx4gzrZvd2E6vt9Ryyzm6S,FALSE,0,41334514,41334514,1
113AfrzyKdYnrA9p1LHSJxVwvJrnzMaSVm,FALSE,0,500000,500000,1
1133tSUY3FQFm7Ajm9pDKVuCzxfaaVhbCj,FALSE,0,671347,671347,1
113B1ixzpft6kTAzDh44eBHuYfPzqhJH4k,FALSE,0,10000000,10000000,1
113Q92Tk4m4VW3vvtXkcc6PzZnZz6bGbiQ,FALSE,0,625807,625807,1
113bZbPAp1xY5qMHAVrHWzqPa7of7QbjDz,FALSE,0,26030,26030,1
113BVUBgAKYyiebP7SAdtUoqgpoxNzFzJX,FALSE,0,1000000,1000000,1
112zcdfp9N5MuN7YbKryPSEJnSnUVhfJuy,FALSE,0,5000000547,5000000547,2
114X6KEn7JVhp5zzmWaTDuUFBzQVxeF6JB,FALSE,0,10000,10000,1
113qBSAWTsnoobF5qDPUc1Lj5HFac1wuHz,FALSE,0,101841,101841,1
113C4WATpwRB6iEysMnpV4RA6KmR5H6xZF,FALSE,1092,1638,546,5
114d5asCDLCqNwa4s1mgbD6KZU1sTparn2,FALSE,888005,888005,0,2
113sBvF1H8iSTKSTDAzDvHC2BfpxgHjygJ,FALSE,8256,9546,1290,3
113wsQxMpuJoJztb52fAtcRrkQU2StDgy7,FALSE,439537,439537,0,2
113xn8nps1NfGrpNchsiBLYHD6K1xL5jD3,FALSE,0,5480,5480,1
113Eprizsngk3hu7WRRu5E1sdELAq8uwUN,FALSE,0,1660000,1660000,1
114UN64EKECVD3ZJimMz3QgwEVnDGz1FA9,FALSE,0,10000000,10000000,1
114mXEMRMsW5dXsm2wywDJUbwLj4FDUeVM,FALSE,0,5480,5480,1
114pn4JAbHdViX5XtW791mtPtTNvLNeMhi,FALSE,0,59000,59000,1
113FKcmfssQLRPn4YwmNEwJjgpv9EQC8Mh,FALSE,0,268940,268940,1
114MCtW8MU7ZpHzceajZeTjoKyRwhW8Jya,FALSE,0,5195600,5195600,1
113y1KpSBpUbC8GUG17xqMMbzZqqZ4hut,FALSE,421499763,421500000,237,6
113xdBENEkaM2bM4sCWtHhmLgvJFH7DHjX,FALSE,0,51410,51410,1
114idgScu8J1Hgg8s2eLEXc9eRZXQ3j7r9,FALSE,0,29606242,29606242,1
113aN7e1h4DHAHEbbXnuaA7FqbCQMrhPmY,FALSE,0,1162581,1162581,1
114fpVdFKbJYHogkJysyyZ7WRZdv7RY2zT,FALSE,0,7570,7570,1
112zFFY3GoeqoycBUXv9ESiLkZPWZ3iaqi,FALSE,0,381930,381930,1
1146sHdf614LHY8w8L2CPVTouyii4pE3Km,FALSE,0,100000,100000,1
113UHBHyNezZ9DQiVbtpyTSkEXRLDBvTCF,FALSE,0,72906,72906,1
114wmBHZTReznvDUB4ddtKJMKZgQDZNUZA,FALSE,225175,225175,0,2
113cVsngLzypYR4hUBoCARVQgRekVPBLMC,FALSE,108180,109260,1080,3
113ELmeZFcF2GBepspHXWWQVK9QUh4W71q,FALSE,0,100000,100000,1
1137CcE4QpBTVc9pen2wS2b3CGCeTkUnEi,FALSE,0,1564,1564,1
113dpgEnQCQVBASmLicpgcJL51GtCL8KbZ,FALSE,23158002,23158002,0,2
114hsXJfqdiWd6h9hqemRtPvw78bLmxs7X,FALSE,0,400,400,1
113YLsab6T3VWeM21RXmVSHHC6YF2rJ75z,FALSE,27157,41237,14080,4
1135B6Tbs3zXCK6TcGVPWrmg8RdQjXDEnn,FALSE,0,358352,358352,1
11349jat6mJu25teBhX591rT7w5k6nvV4o,FALSE,0,837000,837000,1
113PWaSRC77xoULeX2D1U4pARsSgmiLYHG,FALSE,2399305,2399305,0,16
113BXDSMh652WLZW2E4oimXeBrgqQx1sXG,FALSE,0,81324,81324,4
114sRLWs6hS3pDVcx5QrfbLdJWabhUyfq1,FALSE,6807199,6807199,0,12
1142nFeNTE226edega2DBJ5nroa31gWjB6,FALSE,0,46000,46000,2
114fHvrxdRNFCJaPTcz7KAUpD8H82yCSht,FALSE,258059,269638,11579,3
114feMqfWAtsNozsraujAAaxcWy2hbg1gP,FALSE,65000,79283,14283,9
114u1PMrgxaPbpxmNvRjky5e5ZMG8qhiKc,FALSE,0,146515543,146515543,1
114BBgpzBb85BhqhrAGcNCaxy4Ts3rF2HP,FALSE,0,27986000,27986000,1
114MquFiqa57NhFM8LxkKRfXepmiokyzqA,FALSE,0,478232,478232,1
113yeH6MXCAQWiJjcZ3YQMx1h5U6oFupCK,FALSE,0,45720000,45720000,1
113i7fmuScbTWHDpVuFBKqvDWofvZJHsbz,FALSE,0,10142,10142,1
114F5vXBn8zf5NWoUXvci8qNsTZbiaNtpQ,FALSE,0,3873,3873,1
113e8XkLf2xZ2k6UDaA5W6Crie1N3uEtzG,FALSE,0,5653,5653,1
113gU2gg65iefWDDLGJUBiHecAsFiSABiA,FALSE,103789,103789,0,2
113kDse2iQrxDq2K2cx3uh7XbLGWUjKcKL,FALSE,0,3000000,3000000,1
113q7AhJzbs1KdQv5YxHqVSNpVb7eMAWug,FALSE,190017393,191450763,1433370,199
114wQq8PoDYhwWBv2DuxerouFrMLn1bLYd,FALSE,0,6738440,6738440,1
114qVYD5xHAdFPCwQcTQ77Bvo2BdjhEGiN,FALSE,0,207576,207576,25
113jvEz1kdL3PXmLFBSBxwHFdRk2Nve1cr,FALSE,0,5463,5463,1
1139arJKq3xFQ6QgRnh4GRGzi2UHhSCqqz,FALSE,5476482,5476482,0,6
113ZqpHpSBk2BcMbVPtuySbi5CKAJB6Qed,FALSE,386389,386389,0,2
113WsxNdWVHnhseUvF8iCMb3DiTmygEDVe,FALSE,0,1000,1000,1
114Sc5qXKcQD8eE3Ut2Cs1nvJ6iGeFb9zg,FALSE,4307714,4307714,0,45
113jTGYABzwboNALePqKfW6KcmX8TqTAok,FALSE,0,282000,282000,1
113ZLHxcHeDXUXr4jyQyx4fkffTbgBA6Xk,FALSE,0,548,548,1
114rvb8ZQN5nTGGP5Y8X9a7728rn6Br1Za,FALSE,378112,378112,0,2
113dtai7MTtusKYzdzYBTrveBc6EKq1KVk,FALSE,0,80,80,1
113Hyyc2gjXg71MmXebRVJRtLYiMt4MvE7,FALSE,0,7182,7182,1
113C8Bt6WH1BuavkPapGsKjgcnbSXSPtJ3,FALSE,0,132358,132358,1
114RRD3GXCEeV7QqdKX1o3fJbPzfCs1LB1,FALSE,0,16923,16923,1
113EZthvpPX4duqfrUy6RHmbyz3heFC5AP,FALSE,0,10000,10000,1
113bgPWhGPFB53P1Ea44TmBWxhFQvJvwGc,FALSE,0,72560,72560,1
113auYJa5V7ZTKJAC22ek1zpRWarxZ9J4B,FALSE,0,2183155,2183155,23
114XSvqmj2wqb8bDBKT9Cvuh67PMc9252F,FALSE,156700,156700,0,2
114fSY8tpkCRX6jpCGKUqYfV21x3dnGE4T,FALSE,0,2730,2730,1
114vfSqydAnXNP3c7i5zLv1jZzpkMUBt82,FALSE,0,221479500,221479500,1
113kSRuWbiCsdZFsRziPfbjrZCxeo6U3sh,FALSE,0,18640,18640,1
114iC6mqfSRzffpCkU2kLa85RUBUPCR42k,FALSE,0,10000,10000,1
113PcuDzUyUB42Rib9Fce1yhkPqcVT7rEd,FALSE,3811,500546,496735,3
113QmjmZo16PGFBGuL7W5ZW1SCkYSj34mV,FALSE,0,1000073,1000073,1
113VvD1uR6pqiDrn5hj2mMqhRmS8ezmQaS,FALSE,0,6480,6480,1
114DrCzxpfohzH8AFg7wh3Pst1CdeFwJJf,FALSE,0,14564,14564,1
1132LMRnwUCWY311CrMjGAGnNyisFc5gXR,FALSE,4675568091,4676725606,1157515,36
113UzEzeajqnFRf4ApC4YKUEdqnD7AL5fd,FALSE,0,577015,577015,1
114XNzYWXgV3q62chzH1ydtETc4hYbaj1c,FALSE,0,849911,849911,1
114TeYcw5x5czB4A44r4qNMvqwRBmu2dv1,FALSE,29053920,29053921,1,3
113bnk5aEja6uzgDbmbJ9onSGShrh7t3mL,FALSE,0,111569,111569,1
114AXNMAbAS8KGkzYbDiZkYHfhxsyE1EnJ,FALSE,0,77316,77316,1
114Wmd6wWBF74aHUkM7LigZbtxNXSrUNQZ,FALSE,932944,932944,0,2
113VMzA6tDeKyjseBHqRqsJMsnAR5u4a1K,FALSE,0,3133583,3133583,1
113tCbfLQVA3a7RJSwpytMsyUPJCddyJNe,FALSE,2979512,3003341,23829,5
113nP4gQQ54eqdVszakfbZeuj4S8qMHExw,FALSE,0,546,546,1
114qqLCCuzYeCE1GJxeYQJLuKyuueLpNzW,FALSE,2924899,2980299,55400,27
113b7yzCyCb1ukhqZ5348MzqV9RbikVns7,FALSE,2790967,7606740,4815773,274
113TeP8bpNeibNA71trCWuhpcF211Y4H3U,FALSE,0,3534,3534,1
114fzcb6Th7piQLXQ4grz5JFWq9ZbJaes,FALSE,0,546,546,1
114FjUrSRgrKR61q3xAnBXLJpUr3MLos6k,FALSE,898910,1151848,252938,79
113cjvnMid9S2M5iyGQQLNioBsXjjX5WX2,FALSE,0,10000,10000,1
113Cwj1kXvZiTzAGqQ58TATGBkCBXWVMSs,FALSE,107018302,108049160,1030858,422
113veVjNhUVzvTu7uJ7auio7XQuncrDwhv,FALSE,9808,9808,0,2
113aQZQwnwQN1xacrRG8r7KpEoFzfoSCbP,FALSE,0,16409,16409,1
1138AaUgBkj2qJ2f2rFnh5P5s5bP2AcoEU,FALSE,0,200000,200000,1
113HUCjtBju77g5GaHZqxkLDGS3NS7DGG4,FALSE,3578548,3578548,0,8
114ndcqd5QyQSWWxQ2ZKFmv8CuDz2wSE1V,FALSE,0,5671,5671,1
113UpEUMxYZ66w5xGCk1wrJS4NTg5tmdYu,FALSE,0,51235,51235,6
1146QavAAa2ag1Zgq8hX53C8WsbXwnmMQp,FALSE,0,17510,17510,1
114RWgsYFNTCqX5ETTDtdZvycfosyuWjD6,FALSE,0,339544,339544,1
114hgCx6eyR1uGM8x9KnJxFWXHj6nazdzE,FALSE,0,34268,34268,1
113VKRZ6nz4quwyTJcd1kTcya9JortXjfq,FALSE,0,15289,15289,1
1143J8SaukKQp9eJe2Erv5Vr4env2F67gi,FALSE,4892000,4892000,0,2
113tE6AiuV5jKqh4yUMyhDdyvp3rs9dubf,FALSE,0,1000000,1000000,1
113FUXxAsLg7Ai5Yg5hMJaWSBwaLm3jD5t,FALSE,0,1011116,1011116,1
113pMzNebyoppNvZwPkNir6qoRZPnJrs91,FALSE,0,7088907,7088907,1
114SRX8QsBnUUrHxLy4RjZeuR4L6REGdiP,FALSE,0,180109,180109,1
114dvDTaY2mh5wFjvAac9sXqQ1ZyqJQEWK,FALSE,2758223608,2758321829,98221,90
113kRzbPNXYMHNayuApp27YTxQ2zC5Bxub,FALSE,0,59430,59430,1
113fpjjbwyLZtobJYjtVb5Sfzgr5NvfeKD,FALSE,0,85583,85583,1
113PRhFE44hBYpBWCUuCaGi63NpZK3SXTL,FALSE,130613,130613,0,2
1151AgQ5EFCLU49QyzYfmE7syVZiw4s3d9,FALSE,54669028,63131028,8462000,8
114S1etPJ977G8EvnwLdfo7ZsusHx3myjf,FALSE,21000,27000,6000,6
113hJjsHzq2XmcR8YDBZ8W9XEH7tcAkh9S,FALSE,0,5559,5559,1
114upXyH7MaDRffbpdzbPqHX29QkEzdesP,FALSE,0,21291,21291,1
113G5xr6QADt3GpLje2DuuciCESd2UQ3kN,FALSE,0,4670,4670,1
114u527RExrEFaUMzBMzhE283WTAXgYLGB,FALSE,0,61496,61496,1
113WSTS5RWz2VUDkT7X3SsEPZEEgL4Svec,FALSE,0,12705,12705,1
114uUNLL39dcKzGAFNkJiAjmxNZhjjUHk3,FALSE,0,1141,1141,1
113sTxCy5AJ4nJc9qMhei4P8yVnwFEj8Lp,FALSE,1092,2184,1092,6
1132RdBVux6494rt5zMqUY2WsN4LjU1sm9,FALSE,190076,190076,0,2
114CUunaMCVjuLqovSVh6U7kBgt67BS1cZ,FALSE,6160000,6192984,32984,8
1144pmCshn3ZphzsMHd2Nt31c9rkVSzcGP,FALSE,0,4568240,4568240,1
113F77X7rS9bn2A6SwZrvjdkUY6wHd9MYG,FALSE,116632,116632,0,2
113Kx9vH2MRihrqrxHGkm2229tjUUbpwFh,FALSE,0,5153,5153,1
113Twnyrs62Qptwoq9sMNPBGKCe4X6pVmo,FALSE,0,4530,4530,1
114UaSjSDMYJumk9EFWiNxiRUCJJxniC5r,FALSE,1000,642137,641137,2
112zHkaRpfUwXMADhdzWKgLgfLjvitUq4J,FALSE,0,3078039,3078039,2
114gps7Uqva2JKDUfuBhcx7CzDjqgjSiUK,FALSE,49981000,50010000,29000,3
114ASm8BJoUZXzC4pE8aAw9p18isCzb8vG,FALSE,0,330810,330810,1
114FjvKbaN14FWd82hzzM1S15sXHHuq5HK,FALSE,0,32569,32569,1
113nz8b7aESVvNEiJbzDTsk9v9VEG5wXuy,FALSE,0,936855,936855,1
113B3v2cnsXUQXnMX7FKjJSBpHg18PW35D,FALSE,4462203,4462203,0,2
113rkZJgREYswkpgaQjqWesBMQrDRqG12U,FALSE,0,2604099,2604099,1
113mq5X2KaHhiXkscgjNeHcU39wAqQLMX3,FALSE,1970,1970,0,2
114YBVFdk94DbB1LbFP264uKKNUgq6JDji,FALSE,6966163154,6966171019,7865,73
114rs1aFRiRN7ihk4p3CworCrt69XsPFK5,FALSE,0,2071,2071,1
113f8ejN1mwQmyweiMbMJrniTxNbUFaUHh,FALSE,0,7393,7393,1
114d488AG8rCF6F755njfvSo4qftWX9bi8,FALSE,0,5677,5677,1
114tMwSvBvYhKP8kTYTHeR5fLAFSsb7ZNW,FALSE,0,7249,7249,1
113CqgYb4bcxJvbBg5p21Qui7QzAzKdqfJ,FALSE,0,9466510,9466510,2
1142UvK3rnatxLzs5PX7yg8Rb6Vtf6DqYP,FALSE,198161,207620,9459,3
114TskM1kZKJwEzBkVoFJDt21bpjupS3V5,FALSE,738518,760661,22143,19
113hEWvFhRtVtqXarG1HgfyyUjCM5jHKwy,FALSE,0,975556,975556,1
114aYLcexFfUPDuma6bMJ5Ae2GwswNLVSG,FALSE,0,40095,40095,1
114BQJbzznhKgq2XsMYBdJPk9YZWP3tJXq,FALSE,0,1205,1205,1
114GyNsaJ9cFB5zWtMQADDwEu3ZkCzXnrL,FALSE,0,5480,5480,1
113DD7WpNumXcY9P88Sb3xz37Q2VVH8cMz,FALSE,313380,313380,0,2
114A4dVXJgdjejASbmgYceLWYJqk8x9bFc,FALSE,0,13300000,13300000,1
114aHdCPtC7QzaoscqY3gPAHNrzSqdW8pZ,FALSE,0,672208,672208,1
113eS8g3cteishpV3wqXJJcdYhWNmWews7,FALSE,0,5548,5548,1
113Xw8MmcRJp8vRJaoxupuyQ4QdmgTQ1U5,FALSE,0,4557,4557,1
114C2NCfnzcFxMhtACcUgV42AGL8wJ8wY2,FALSE,288353,288353,0,2
114D6mGx7twLsHVUy59bmKHtCAgqQwocbg,FALSE,0,13074,13074,1
113Jhbo2etRKMs5YGsDHrT6LSc4dqpZCuy,FALSE,0,1600000,1600000,1
114bjGSCnfrRRWZmRAjh7HdCVGHtjH8FwT,FALSE,0,1321109,1321109,1
113tVJpNESLdHq6MQfVTnq4rHi4X7T9GKp,FALSE,0,1495,1495,1
114qntvVTiDUZ9gijjVkbNsVz3Bc1MJjZJ,FALSE,25430,58970,33540,7
1143PDgB8NbTDrFoStrKXv8nAfXDyhPAJk,FALSE,0,1136363,1136363,1
114MDzmo1G8WS18TKHaBRNcntKSsEJHqqB,FALSE,0,80925,80925,1
1146vfshNtE2eKUzQ5STPrrH6WsSoNU2wM,FALSE,0,49629,49629,1
113WK27Q3wyTbeFnn6e6QPX5zUFZBpYnZC,FALSE,0,15119290,15119290,1
113V9jVVdvZsUzdADouRoaCrtHucgt1mDo,FALSE,91008,116008,25000,3
114jLvzqDt7QzH5xDARx3Nkc37xKGDEuJr,FALSE,0,1000107,1000107,1
114RyrvLTDog8JNAFWjYJzC5P7FQsyTcVN,FALSE,0,53108,53108,5
114zrwC6mDZX9sST6YuwUg2RT4hPnvPcWm,FALSE,0,660000,660000,1
1143d1v72Fq8uwep5frg6gbmvqMPpZdmfc,FALSE,0,8773870,8773870,1
113EMEeeCHkMdhMAdN2U5MiboPV5XATqEe,FALSE,5259,502730,497471,3
114fSfAmVa4jL46od6jtLkEfnJaCLxeZBa,FALSE,0,19235,19235,1
1145ePxf7oZfcGNHJvqAEfKMzE1Xz1h9gV,FALSE,7448691131,7448924343,233212,5
113pJR2QoLRFyMAA2VrNtVxgkND4bGqvh6,FALSE,3953890,3954437,547,3
113nx4mXV3nvoeoHRiwVrM9cgA52HU2WLF,FALSE,0,1859,1859,1
1138yzHJSk5MYFiEpZBD7rVMpDzym43wSy,FALSE,0,100000,100000,1
114HGtdN3zx6Jk3eGCpETGtAw7gBwFXfbH,FALSE,0,5480,5480,1
113emEbuKQjpxAekPL3ev6ShHxv5ehGEnx,FALSE,0,12299,12299,1
114RENCYDjqmP45n5vZEA7qHiXD3B9v64P,FALSE,0,71647,71647,1
113yoFwUDp99pWcaQywb5wDVUF6vLJTApt,FALSE,497884,544528,46644,4
114A3mguUxDXnY4boHjaRp8qt8HTH9pnoq,FALSE,0,12128901,12128901,3
1155B5y5eGCDmsVsnCu5DD6BY52DXWC7qf,FALSE,0,138040,138040,1
11488QS6Mxb7RqEZhEyPva7E8ZiJMeYbLk,FALSE,0,34510000,34510000,1
1133hHEbkCFEruy9rAb3dMrcapN4adfchC,FALSE,0,120000001,120000001,2
1155GgEiUGm45Y3iGGzdpVqzRPTqx8JMM6,FALSE,0,997679,997679,1
114d5Jp9RPY7eTyYRdgRADPmiCUCY6TPy7,FALSE,1119000,1119000,0,4
113G47i7hmJH3V1kUwREiNypE7PNtrgDnn,FALSE,0,377582,377582,60
114cs5Pp1ybx5RPywb8PNpGp6bnYCKg2Yg,FALSE,0,997785,997785,1
114TwwkezLFnbxMwWQH9zGiHrowZM8PzRF,FALSE,5053922,5054800,878,3
113CkMqouf4RsNZ5JYjuYScgMvEn3BCZwr,FALSE,61092,121092,60000,5
114kfZF2A91i11rKeVfQR6QoU1CuSjcvMP,FALSE,0,33713,33713,1
113MmowcdbrD3pd57q8metKV9ibaHt8fe2,FALSE,41150,41150,0,2
114pdVmJ9Fk1LRbRaYsPE1qgQ6voabVb4v,FALSE,0,175596,175596,1
112zjAtTuZrdnBEm1aMbJcSSJs62ynaD3f,FALSE,0,729,729,1
114a7EEX8xq4vZU1LGfqHwg8Ak9KwQUGxz,FALSE,433177535,433180243,2708,63
113UvRa8Hr73BkFvemJBPmhQeRf2PKAKUw,FALSE,0,14190,14190,1
114RxGAYtUKmco7nq1ZBshFALbRs3PTCex,FALSE,0,16411,16411,1
113yNU2mkXyfcHAPidNtcYEj7bnPMrahnu,FALSE,4041574,4069734,28160,12
114enQniiLFWXEwfdWKUNshDwSwKQi1fkt,FALSE,0,50000000,50000000,1
113PCWctUHD7456M5tPL4ZFXhHv5MhECot,FALSE,0,500000,500000,1
113dijkdJtQYduLPpy61iZiYWvRFq3ohcD,FALSE,533074,534030,956,13
112zrnngnTZEKzE3MmvzRZofGgYHz37Wui,FALSE,0,1174,1174,1
113mgsBeYW62u7iFBZeJSDN7fjhMYzqWpt,FALSE,0,998555,998555,1
114vQnXzDtZ9P2mA69Cq71PmHxgRY6JgzS,FALSE,0,60440000,60440000,1
113zMe8ni1vQ8fTN2hcnjp4cxXxP6DEHnr,FALSE,0,601278,601278,1
113gHkBo56VqXi1GPsYWkCfrcZXsiYxcvQ,FALSE,0,7008,7008,1
113Acvzxbk8VEKFKhngX9FsMwx4gaZDsgs,FALSE,385893,385893,0,2
113o1idaxsBr9XGq8UiAGJqwjhzJuvcpLi,FALSE,4186861,4186861,0,9
113hkvtLFvYmwdLZhvezst1bT71vrYuk3d,FALSE,0,20000000,20000000,2
112Nqp3UrJj9fub4uJdLKqZ94MH6jQuk2P,FALSE,0,623,623,1
1127tt6HYrTGgVLqneR1sYKPGBiiqqmgJJ,FALSE,0,333859,333859,1
112HcB1qx522KMYuNxEXci33KcqvkMjtbA,FALSE,160000,160546,546,6
112nk6avNkXSdQgRoLHVDw6sUNskU22k5H,FALSE,1575,500546,498971,3
112paD2HRuFD18YJoNKkWP9joxhEMeJjUs,FALSE,0,3832,3832,1
112WZgnvrtbuRqpFetCaJ5kssM76E2quWY,FALSE,0,37732,37732,1
1135SwnRwXxGcDfAX7p5nXR27puzKDvjHy,FALSE,0,1000000,1000000,1
112nz7dysHVueGV4PsiN3qfbcRo3DJQA6i,FALSE,0,278183,278183,15
112sUST7WWRb3wWd8aJoK2vde9Kx99SbbN,FALSE,0,55049,55049,1
112LjdBjUkDEsHZVbRUeESu5t7SD4GX8Xz,FALSE,0,40016000,40016000,1
112U2uQNjMLEMRDNc4DmFbKDRECAbUAotK,FALSE,7450000,7600000,150000,9
113QMkpipViRsgNmCKzKQUPSF6fTBQQKWU,FALSE,3038173,3038173,0,2
1123whi9hhzPfGMUQLghGB3t4AMPSV9itu,FALSE,0,59440000,59440000,1
112fo7HVem2GCTPdsoQhof1KaVVAeGRZNx,FALSE,0,8972,8972,1
111111111111111112hScZuq9Ahc,FALSE,0,2730,2730,1
113Yxjq3nh45SfC85C77m2a5TF6QGScStZ,FALSE,16803272,16900518,97246,24
1132ttwdbtGHJtPwwsvaWEvbbBEziHgyQ6,FALSE,859522,883088,23566,17
113dssCnHAT6a7Jo1AgzWxmYkuF8B6CQgk,FALSE,1137576402,1137576403,1,448
113kR4sqTTUyiawCuBy8xiNi4eEXS1upoi,FALSE,0,426017,426017,1
113PVBiD2dt6bdG3LeJjkPLnbC378UwVuT,FALSE,9801538,9801538,0,2
113Uw345wC1cq2f8QpoQ2FFK1yccru7Kc6,FALSE,0,114600,114600,1
113PAjQPG27Lbhyf7zt3KdZZJp433EzLmc,FALSE,0,1896852,1896852,1
112Yb7sNucDCVcpBnx428F4URJ6E8dRV2f,FALSE,0,12961,12961,1
1121tWqC24j7oErAF3Npzqo1cPUfjW41CZ,FALSE,0,2012444,2012444,1
113co1ycz2ZWaz49cJrf6Ri71uzwFqMe7Q,FALSE,0,1000,1000,1
112WZmHS86ier8fx9GFYtMxPoKyTbQbMmP,FALSE,0,1997,1997,1
112gfcPSex2tPYFD5wYUWZHZzoSyrPUqxP,FALSE,0,689791,689791,1
112Q49aZcb5Vucwhe4MbKvC2sKndwZWrNA,FALSE,0,3347,3347,1
112ZwZyy5ia4Fy46cHSVjoaNmbcCG5SQTW,FALSE,558004,558004,0,2
113DdZDfU7nPMY2FJS4uTZpcuVfKfroNcJ,FALSE,0,614674,614674,1
112NrJMQdNcLaAR8dqGCDMotgGhi6d3S4e,FALSE,0,727840,727840,1
112ajbaWMPJPQ65CjaxDTber8g1CqqWndB,FALSE,0,225388,225388,1
113XsQQsjCTQvM7FAUJyv8eCcgGUzQLC6G,FALSE,0,212085,212085,1
113p8X5b2SGHXQvMtXuaZNL4JEMwT86NhZ,FALSE,0,5120,5120,1
112SoypzXhhc6KPghgNw3ivFF4yGykA16z,FALSE,0,30000,30000,1
113k7ydZhcwiHqFiZzJR8mbGELgNqBEwRR,FALSE,0,46772,46772,1
113ouoNQsdBCAGri6wC1ZAyUkBZ53MiLrH,FALSE,150000,150000,0,2
113zJqD6Li4XZuxSDmmTRQedeFCU8JcVTq,FALSE,0,18639,18639,1
11114Zs7C1UuwhVrKMsoHjdXE5hw9j4Y,FALSE,0,1000,1000,1
112BPCMhwfdQsrru8asLHejHMke1eUgSit,FALSE,0,100000,100000,1
112YLcMBZ6tasB5KQYSG2zGY73DD5jngow,FALSE,0,1000328,1000328,1
112TjHkqs1PECkW7fAq4EurScG79W2UfAA,FALSE,5468200,5755602,287402,2
112ePEEZRLq2LXS5JSwf2u1Qoe95oS2pze,FALSE,0,79586,79586,1
112U4sc51PaZSXEgadnJjJYHiu9h1Z1fCi,FALSE,17714,54368,36654,14
111111111112ZkE8UvCp8JCNRhfuBoo,FALSE,0,5480,5480,1
112o1E3RX1yuMvKhRct8BX3kc3Gr3C39XT,FALSE,0,3946,3946,1
11111111111111111Lok2dGhWpaF,FALSE,0,1000,1000,1
112enwtTr9hqPk16thuRAm49pPF8QDv1cK,FALSE,0,31105,31105,1
112EeyBeeJ3wqPT7ef9xaLWfBuz1CVcXsk,FALSE,1022534,1022534,0,2
113J1Ecx41JGW1upKhFzxcAE1wqWYKkaih,FALSE,0,85310,85310,1
113xMnxYKaaTxGVXp389QdBdrqpsetDste,FALSE,0,3877,3877,1
112hjUM2ajLyxBF55s4DPbG4nk45SToFy2,FALSE,0,52548,52548,1
113ym2FRGHnaUEHWnp1RREoyv7x8DjSbDk,FALSE,0,58065,58065,1
112cN76GwugFTQTwGEuQMacBJLS7yuTPA8,FALSE,0,6989,6989,1
111NUuJF6yYijegB6ZpK99rFFekAVTwRa,FALSE,0,3622773,3622773,2
112rjtpq8XzSUw219qmvhbWfkL9UPrMUXB,FALSE,0,30940,30940,1
113pcaQ9RJh5p4yyeP2LisD25DmVTnZZz3,FALSE,3203314,3216517,13203,15
113AmKqxe3YHaRkgFUmHmXAi3y8QXZumAD,FALSE,0,2371900,2371900,1
113mvaYJcovMr3uWocu2EUXF65HVKVphLi,FALSE,0,1,1,1
112VNPQpQ5ZWEt8cvgG5tgcdympnKqoYBJ,FALSE,10620,21638,11018,5
1119gk5MmjE8E5vZCxHL1MnbLnJVUJcDj,FALSE,0,546,546,1
113inv5GiJfVwJ78itDX9LAZ1W45id5dyR,FALSE,0,6024,6024,1
1133pPWq56Jgx4skXJTkEwhFwq55npHimj,FALSE,0,2655591,2655591,1
113qD85mXMjhp7TWY9asxGbgaYRchb82dY,FALSE,0,3259,3259,1
1124Rnr8J7Hhm5Y4ECEQDd71WVeCs5DZNY,FALSE,0,32000,32000,2
112BrqgVgL25xUQpzoj33pEpk4bspKJuhM,FALSE,0,7276310,7276310,1
113YTx1aomNyDox3vBZx2aV1FBrEbrdFDc,FALSE,116366898,145513121,29146223,3
112HvWdYBLuN8H7sgPoVipyEGWCv6CmAP6,FALSE,0,194350,194350,1
113ACGybUjo65hYqZqZd4kuwC1qas3S4V7,FALSE,0,667,667,1
112z49inma1aPiwTVkXdQznKBPRUeb6YGC,FALSE,74043148,75990000,1946852,2
112yU6M2rEaTWdimjJf5m1oV3B5D5Mwd6f,FALSE,0,1684,1684,1
113WVWbbRoYes1HxaHUM5bdPXNtejB3kE9,FALSE,0,270351,270351,2
113bYu3zwwdRsGGX2cMgJT9FrGgP9zJCCs,FALSE,0,1220,1220,1
112BqMoYdERwdRJ2yPRYrBkP9iwDuDd76a,FALSE,897900000,899330000,1430000,3
112Qbr1Cs8a7STARpXj5AvS5yynVM5EJ77,FALSE,0,498445,498445,1
113WgWHpUdzMf7hjWQKMHEWzR6dNrgW31B,FALSE,400000,643765,243765,5
112iVhz1ez5Lf1gdwz5cpwKsa9CTCXHys,FALSE,5450000,6200000,750000,3
113VvWFJa2jyuVeGN4tzvQWGAb81ciMSjx,FALSE,0,738000,738000,1
112HZ45nsT2sSBpPyADoRgcnSSNUzaaYZq,FALSE,0,5425,5425,1
112c7wijUKfMnW4UkpFVHepJsnjGJFbaab,FALSE,6006,10920,4914,31
113ik6fk5AcMZttRFuqa3Aev9V3QUsNyHH,FALSE,0,34232,34232,1
1114Qku2hf5zRKCmoVZS2UudSBkGEA3WL,FALSE,0,2730,2730,1
1125UUEKeHWJmVexWzbiSypUqc74fANaQe,FALSE,0,148368,148368,1
112aSGumjR9eqRy4Ys66iAbMVLV3ozqmLq,FALSE,0,1050,1050,3
113s5FNcFGJZG5cjuctssxw4Q7cnDfSM47,FALSE,0,399774,399774,1
1132zKAEzHYVSPxx4fKNq7AWW98MDZjMB9,FALSE,18898,18898,0,2
113eLNADrTB6Vqr9QQ9DabdhndE7YdRqF6,FALSE,6101598,6101598,0,2
11387FrREeAnzbQvyAXAYcE4y1Gq6FxMSH,FALSE,603914739,604386432,471693,39
113zmrUbTJqHoKM4ACay49FvxiGxgyJjGg,FALSE,99990000,100000000,10000,2
113XP5a162CvM7C1dssvWmYNZrqxqEDAvW,FALSE,0,160000000,160000000,1
112RscxMLuff1hvVBNZbPxsnkC2Nnw2w67,FALSE,0,1104180,1104180,1
112uMUBqrT1rgiDkC8WPFPrmcXMmErCqkj,FALSE,0,23000,23000,1
1135psR9C8TW3ZycVU1foi7Nq2YGV3Fzma,FALSE,0,1544,1544,1
112Y9uvgTuQwzskCk7tXKV6D6m2G2P1Xn3,FALSE,0,28314,28314,1
112GpLgpfNhQf4qZzYwpoeyZDhYx5XgMNN,FALSE,0,512889,512889,1
1128xYu1WhEqcsutNbduru1SexD2XzPPA5,FALSE,0,5213396,5213396,1
112Acqi3bK938BRZpVfoK2qpBPTFiYWJVD,FALSE,4698731,4698731,0,130
113HudhKDSSzVueUDFSvAh1cDJf7bhAsbd,FALSE,0,11564,11564,1
113DPEqaxrr3ReZ6vTAzBCq4ce8vvSvzY1,FALSE,0,520049,520049,1
113T511evn4Qqzs7K9yhGjQp5j8V16kRNj,FALSE,0,1724,1724,1
112RHXAr6rYnsuTduY7srCmRLDsr88Pv38,FALSE,43000,43000,0,2
113T9myqefFp9kiFWx5FHZ56BmUcuFwNbX,FALSE,5546,6546,1000,3
113CqHrpZKs4Dazoy5ZVog4iykCwXyvhdp,FALSE,0,954100,954100,1
112ArUA7oySw4f7hhjLfoRZbNvwxnd2eZn,FALSE,4327294,4340315,13021,143
113vNouu58zuktrwbz3GDDPkZU7TcxUqVE,FALSE,0,10337,10337,1
113KCKvzyujRhmBa5X6SjhouVFC5jTssKC,FALSE,0,69470,69470,1
1132MnvzvBKpxkWSwPjLunQdyH5ucPRcer,FALSE,0,53465,53465,1
1138LGYAm37aqmB6YC4r9V9T8BmKqFnd9m,FALSE,1163285,1163285,0,2
113sJ9XU9QndQ1LWAWVRksCcEpue2ExyCM,FALSE,22500000,22520000,20000,10
112PTzfQG24x7zGs7rt6Tq4YAwGcgdge6V,FALSE,0,10196,10196,2
112UAXzNFMYfyeEyGvcn8RCjCxaobskHgb,FALSE,7265724,7575813,310089,12
112h4Wo5rTgGRoR46yEsHZXVimr8B2g8gD,FALSE,546,1638,1092,4
1134WLqYurimA5173jb5PykqoMdmA3QzPr,FALSE,0,91092,91092,1
112e4LGvWx5YnJxN6BafjKEfg4KM6svHtW,FALSE,122803000,122805730,2730,3
112NVSxyDvptsWJ2dnmGbqVN98TCTj36Rd,FALSE,546,1092,546,3
11287L6g9zEqnuHSfxPzBZYuqBQcVfHK7m,FALSE,0,14538,14538,1
1122YQt3yUdQUgHwqQKizdg2Prp8uwEJwP,FALSE,0,202457,202457,3
1137nHmcuCfLZhaKan4udAhsbsxfCd6WmF,FALSE,4382772,4382773,1,3
112ATxFiFbPbTMNGe7bR1LNfeQRhsKFBMJ,FALSE,0,811,811,1
113npwVdNMS39K2P9iemMbthNQMnudF4QY,FALSE,611686,1541883,930197,68
113ABK5ToCnbBa5WDr4EpsJEgTu3CWeubc,FALSE,0,603357,603357,1
1124ymXHY3BQoYCQSn1E7M3qcWALwZpK3e,FALSE,2287320000,2287320001,1,41
112w25DpnGM7oG1KPxzJE3LnAZwmShjn1C,FALSE,0,80016,80016,1
113fPq5iimMZWCU1xftCNnWNjzF7eieqs4,FALSE,0,153975,153975,1
113VXYHKdYA6h3mGCV54rM41ht1cY9cB57,FALSE,34928,501638,466710,7
113bTgj8TGmUXK57vy4VZ8azJmCWdFcFPV,FALSE,0,157656724,157656724,1
112DoeUEkHmVT6jgtTnnjzHBQYkeVB2NzH,FALSE,24665960,25235217,569257,7
112KCSSi4qbHwDqsG9sSseSrp3krENXzYw,FALSE,0,5334202,5334202,1
113KaGm9Vsf39txJhtiFkngzvqmEiejkSa,FALSE,0,100000,100000,1
113MsDy1H4jwYbMRtFM4norPDeHptfaehn,FALSE,461576,461576,0,2
112FU9TJCnMZq8zGUQrzj3G2z5jiXgDE9,FALSE,294128,307517,13389,3
112YGHSwVS29hcSgDnE5BSRsQyuSzkfoNx,FALSE,0,2354,2354,1
111QJqQYPVJUuaYwcyo48V6Dpq79ZaGpj,FALSE,1240030000,1240050000,20000,10
113PC8t9C5dZx9ahm53RyQ2CQ9dvfrChdE,FALSE,0,48332,48332,1
1121zjEK9ZHSbiZ6L6SND5ezWfJtmD4qwM,FALSE,0,99810,99810,1
113gXFn7xtpeqG1cuaBecfQfHsMnPPac9H,FALSE,0,85310,85310,1
112NieEmYDHSGLcbiRemNVVWqUP67C2NqK,FALSE,2400,3000,600,5
112dSpGeUQUgVi9BjzRnx1zhquZjS8LE8u,FALSE,0,180000,180000,1
113KmaYDnDphvV5qrieiCHCHZah2TxR7cT,FALSE,199840000,200000000,160000,5
113jqiP2Pnnr1w5AHfuWyNY1hfKQSrdp5S,FALSE,0,24247,24247,1
113VWYRSccaQ675qqMd5MLEk9Eg6Ah2Yc5,FALSE,0,242133,242133,1
1126GLyiAT7PrJhSTP6qpiAMc9duyeGQYm,FALSE,1042730,1046006,3276,6
113ynfPh1bawBxAPLT2eB9pokiKbPa89yG,FALSE,2494064,2494064,0,2
112wQowvN98jqP6TrZtnv9e92KnXcMTkS4,FALSE,1141800,1141800,0,2
113SpbdMaXjPXEDDEucD8SxtEdCJVLiuj9,FALSE,0,345765,345765,1
112dJUuY2woEJsxa88dKUBZ7VAQNobDY39,FALSE,60000,61092,1092,7
113kF5oLzf16Fpuj26vBNwAuXH141btjqw,FALSE,0,1091301,1091301,1
113JV6T4TvLdBJCysDZFjQucABBN1MZUyB,FALSE,0,5542,5542,1
1111111111111DEdNGwrwfykgSBpj,FALSE,0,2730,2730,1
1127BfoKrSTTRRKzmRwiJML2ch7irzuX6X,FALSE,0,1000,1000,1
1125VxRxgEF72b8zGobGRAR6KbiG9rGgXm,FALSE,0,12280,12280,1
1134Bivzrnb4mJDPxRGRni5LAKRusqsUEn,FALSE,0,43000,43000,1
112zUVViiJi4fMEVn3y317uerqxY4Je3yq,FALSE,28932,29589,657,2
113GsSQJ7NXLzz5RKyGm23JJu6u394gK6A,FALSE,0,586960,586960,1
112W16udAPCPCwgBzbSinXbH528qRJDSwL,FALSE,0,3000,3000,1
113XpCKyXpMB5rkYmh6koo1gykvBr7yuwX,FALSE,366137,366137,0,2
113tFmYLELwaxTmQvXdsAQ5oTEx4XGDRsP,FALSE,0,30000,30000,1
113axBKziUzBugLhvC1Y94TDQeX8YQrANf,FALSE,0,6990,6990,1
113XwtGQZUHbm2pGMNkk7kyNhzaqB84YRE,FALSE,79370000,79370000,0,2
112fGboBsz5YkLbS2LZEVyULbQsjh4S8E,FALSE,0,96506,96506,1
112bMMMeLdiZZk1anN5JbHRrvuA3RSLQrx,FALSE,10100000,10189999,89999,2
113MX4MmVKLqSyW8nafq7NWoU3XZ7HCcnW,FALSE,0,548,548,1
112pAVeAWBU7Ayj1QNJkmV5cRA9AR2aKbW,FALSE,0,41589,41589,1
11111111117uXnx2Dq91CuBZvnh4dnL,FALSE,0,27400,27400,5
112PxT8ccptCcWc7Ab1etrqGVMyPHLqo7j,FALSE,0,994243,994243,1
112xnf5uq72aCBUdNay3G464wXDMM29ufj,FALSE,591707,591707,0,2
112pyajEznagnwePebsZfeBykmu48Wkn25,FALSE,0,70210,70210,3
11111rzR5PcKtzeiVEkvepCNa9wraLG,FALSE,0,550,550,1
112nUNNtZXafUtjrLboNvPP2hZw3Bn2SRo,FALSE,0,1000000,1000000,1
113d1yFHD7aDJwQEkyPGG7ExcLpjwKFgHf,FALSE,0,3000,3000,1
1125fmdogcFDYCV2PpDecG1uR9imMxLdR2,FALSE,0,213250,213250,1
112V3DfW4uhjnumFkYp773ijagSsZzCz8R,FALSE,2000000,3000000,1000000,3
1123f2K3mRVHPdRYp5eBx9WiTMQpVbz7dX,FALSE,0,18499,18499,1
113wnJFwB5BsugZEGKFr5P6xxEUcaqoGTL,FALSE,0,1117000,1117000,1
113eLGmZ2ma4nR6rqZ5G8YquiURuDhPAyR,FALSE,16552,16552,0,3
112ozG9m9gvnLw9mnyVYMGrwKoLGhTc3Gi,FALSE,836521,2221405,1384884,4
1137WLzzWyiaNg6LAiigq12qcmeQeJKKSn,FALSE,0,13385,13385,1
112WQ85QRGkG3qvfpzjtmnvRGN4h85VQCK,FALSE,77113,77113,0,2
112uXb2V6MjY7huv2BnpyPny8fRH28Yidv,FALSE,1414695,1414695,0,2
112HJWJoisL3Ft3hvj7dC6EHsjBZgTSocW,FALSE,0,1010858,1010858,1
112X4LFk6Zb6HxtRkgophBEe4pVMrRvH5A,FALSE,0,1966,1966,1
113rWPJB4wNPTEcyS52MwSoUTdyKDiMYTv,FALSE,0,979430,979430,1
112ojEE5bGhAfEnQiWY2xEPZFQnmchdxdF,FALSE,0,4215723,4215723,1
113dZcLQWsUxCpgrhTCLoDraTpbdf6643q,FALSE,10627,17987,7360,7
113peQNNWK1ijkBAhyeUH2C9WGHdCyW4nK,FALSE,0,13328,13328,1
113SsDJBwWMVJ9mvNYtdbX7HzF6gvdJph,FALSE,1219228,1293652,74424,4
1139qohpxDydHLtNL2oPyJE97mSVMXNSGr,FALSE,0,2500,2500,1
112kixMks3wpzNdWiZprWUngcvox7c67qQ,FALSE,0,5000000,5000000,1
113HPigWZFXq3ik2wb8pty97iWSD8DQGUf,FALSE,0,3049,3049,1
113wxCc3wTaMt5xRqAKNBaSqaKm7RyY1bT,FALSE,0,5500,5500,1
1134UQ1Ha8nzStvts4bjAoxC8yYfyhjXv5,FALSE,0,989973,989973,1
112qeK9zXfRdL5dGKTfUCnTbmgLoUbsZYi,FALSE,0,3803000,3803000,1
113sga7EY2teSEePktDyKFvut765cz8DXB,FALSE,3087159,3120291,33132,41
112m4VxnsoPAPJDNwAcLhJYbajeifgCAic,FALSE,0,7914,7914,1
113ziGzCzLWuLrU54TShyTZ4jPW5mNT1SN,FALSE,0,310828,310828,1
113GycvRAFkgCFwoeoSoKERgRLmwkmxw8,FALSE,0,117554,117554,1
1133r7g4gKdBy7RmhVxPB6ksaWjCZBfx2i,FALSE,0,1000000,1000000,1
112JsCtftkkbVaWZtVKSTdfWAr6eWEKg6q,FALSE,620774,961368,340594,3
112CkiR45FJjb3dkFxx7WacS7Dgdf4MdV,FALSE,0,548,548,1
113LDeAYWGRZyqMFv4bdnC4HVcPnU1cnKb,FALSE,508426133,508426134,1,3
113T5ufbZHQFW5qYGx4Fkeh4ZEyMMLSRaD,FALSE,0,11664,11664,1
112qmjXRnPLrJrdyvEwrPdyCwxNhnmFCGM,FALSE,2702732,2714885,12153,10
112nejJkHaPrMhL2tidcmqcuc3KeqWkShX,FALSE,0,5000000,5000000,1
113BtRiNCh9qYzWmdAWKgoddAC2k6Hp1eL,FALSE,0,181815,181815,1
113HbxJjHWj6X9uCoAkx14rdEZ1nHugs2M,FALSE,0,1507057,1507057,1
1128U3SQHB51Avw4Joj8MBPMRJmM4zHjoj,FALSE,0,52788,52788,1
113RuRQdfpu6KqeSAavkQNNBoBuGdceYCm,FALSE,0,1000000,1000000,1
111Vn8MbbrrxoEBikRDaoPrh5SUu4kiQ,FALSE,0,5480,5480,1
111NAs5UsjZiQiw1xssqgiMGEA1CHAaMp,FALSE,0,11000,11000,2
1128hMciixbmUD7RxG93q33r5iGcZLQfp7,FALSE,0,480000,480000,1
112kf6WLh953oJDYiS2PzXBe1byGkczS1Y,FALSE,141683149,141683151,2,4
113vZahAWo5udZdSQfSoGyv3Ls7pJq7DVj,FALSE,0,700000,700000,1
112eDjDCdE2dcrpYZEtdHUEcf3bXTRAa1B,FALSE,0,571,571,1
112dENuJdNHeE2u2hFfJLD5qXao4ENGJWr,FALSE,44961,67309,22348,3
113LQxuDGjqjZokJLa2PSNyQAnqvo1L4eT,FALSE,0,3000000,3000000,1
113WoGuqqEzd9gJspK7RDhZCHk4dCmmsBH,FALSE,15916800,15943300,26500,3
112MxxJAFQjkFuezn5YubfTLpAwWEHqfzX,FALSE,40538281,40598740,60459,65
112dqBbSUbU53g5uw9mbdmm4H4RHg43b7V,FALSE,346348567,431894533,85545966,443
112JNb1qQwjDXhC5siSg8NfeXBZRj7S1ob,FALSE,546,2184,1638,5
113Wh7RdUUG5FoYXGTeHAVuLj7FMY22ur9,FALSE,12012,20202,8190,37
11111osEoy933LkHyyBcgjE7v9rux6N,FALSE,0,2730,2730,1
1135trXbNjUNycxQ9Zj3tuYxKvcfkXWpx7,FALSE,0,4174930,4174930,1
112G2uSCAUPayNxNQ1Tu5wxQHm4gLRDwJa,FALSE,0,2500,2500,1
113WWgvUEFFg8ukQfabtFZo4GPYbDVeWUh,FALSE,0,6771,6771,1
112rb4EDNifYxfy2pc5D2niSVEMhqcgfvC,FALSE,0,30,30,1
113rvZrrnmmMYbijAfUd8DYdgEm4vCeBxo,FALSE,8030,9184,1154,9
112erioBGV6xGEP1DBdFer8senWVyaCoXn,FALSE,0,548,548,1
112EdhtHjTYThpcpcLkimpF4n3cHfNsoex,FALSE,0,1000,1000,1
112ahbBjMis8h5xcnahs2Gfe2DyX92pdoy,FALSE,0,2784,2784,5
112GTzd3TAVKqcQnXdfm4meYFZUbtP14xW,FALSE,390000,390002,2,6
112yev6cumXfgM7gSCR8g9PGzNMcwfWNQB,FALSE,0,1292,1292,1
112J7EFFedjXW2kSqLKUNqGwfdWFVXT3QU,FALSE,0,864,864,1
11111osKmnNjQ85fgWaxkCAh2TURsue,FALSE,0,548,548,1
112djcA3SN2AfaZ7paSw52aSGA9szryJXn,FALSE,0,10000,10000,1
1122ekiUwZDz6vpLhzwWNuV3FJC8ntbUT6,FALSE,44839,44839,0,2
113va5PLn3bMmm5PRyMhvFsxSn46eVyB7J,FALSE,0,5427,5427,1
1137FPMHSFWG7frgFA2uQvnBAuAFZAgc25,FALSE,2675333,2779674,104341,2
112jWkACFwqxMCUBDj5MFxhrVueGEnwvFd,FALSE,0,11000,11000,1
112Bk9rThowjhYgvkupMmGm64k8uVa1G3b,FALSE,0,1007500,1007500,1
112QoSUKswF3R2EZUAtMsAaQ1dse2MLqpm,FALSE,1116992,1309490,192498,37
113F3azPDdaRZrZ7DNTq4nA3KMsTVxvZdT,FALSE,0,91642,91642,1
112pykpcm2aCCqXAn92WdRXcpZYPkDjzeF,FALSE,12000,13092,1092,6
113tUN3gwgaCt4VUQQunvrpUMopG2Z5KMH,FALSE,0,610587,610587,42
113ysB2wuvPJmj6RuGrX9Xzh74WftmqCjL,FALSE,771479,771479,0,2
113buHnoqWMwg4pyBVTRrvFxPFbkJhQuZ6,FALSE,0,871,871,1
112nhu75BL6HpxqzG5Gb8hwiAHqXhPFC5c,FALSE,0,8779,8779,1
112cGvGZ5VZC9XVrgr9vGD7ZGrqvsjPLBz,FALSE,0,71277180,71277180,1
113hMKtRnpsXeXUYiVjrnN1QkpzmtJr9kP,FALSE,0,1000444,1000444,1
113nX7uAdxTZkqNYFxsotyPhwyVzCPm244,FALSE,3278,3278,0,2
1131qNXG5QrUvJy2Ezscgw4ycJgA9Wi4vX,FALSE,0,500729,500729,1
112sdbFUxrJWeBvoNCodgf3Qyjv6QMVErk,FALSE,0,11798,11798,1
112Vd3MYx8BgByVZSLLzewzfNbQ6nfCgMR,FALSE,0,4369,4369,1
1134dYb5wMbLkLDDSkmG5JxdwszEVWEMYF,FALSE,25546,26092,546,3
113iJbyn3cb1BRc1ZFGitZZdVWQrVZ72YH,FALSE,227290,227290,0,2
113Fsmsk1Uo5XayevMKadCk8gu6z9oYuiD,FALSE,0,19208,19208,3
113tFYPK2yoAUPP5mKhXw2xyCkk83SXKqq,FALSE,0,11123,11123,1
113YWFNmVH1C9bR1iPC8M7j4mo7E6w5FEN,FALSE,0,8300,8300,1
113BvUdGigcjTTNQCoMcM8SaEkjJVEAhC6,FALSE,250000,250000,0,2
112CnMgpXDdzEa5sobNjbrFQKz3xEGJx4z,FALSE,0,39200,39200,11
112oZPTCoWy7rnyFNc1AtQbHTeqT4K9Hzo,FALSE,105803,107269,1466,3
113bQkU2u1FBjvweuDrQEtKNbksnwgTFmV,FALSE,123630027,123634175,4148,42
11Gs6nH55phmecYCKZrtJC3s1VWDx2EHH,FALSE,0,410298,410298,1
115nh63Nt5uEu6n5zy4Lc1qdBQQeyRKLwX,FALSE,86369442,86372924,3482,14
115nDMsLx3Rp2oETX8QL1zsMgi74ozqGv4,FALSE,0,21331,21331,1
1165eTv5qCvGaejk8hw4rHTgSSKK1rJ6VP,FALSE,0,7566051,7566051,5
1164HNJZRpFgvpk63tE2w5sZ4sK1htCeK4,FALSE,0,27312,27312,1
11GCT4ohrTQYmcmJ4GtYWSHvhUNitrUaw,FALSE,0,1103991,1103991,1
116CY1bNjVcCCPs8Wk58FTSoGj1B1fC3uM,FALSE,0,6918,6918,1
116F6ihoz36fzUMNtZDapYUjpzwncYJvSs,FALSE,185222836,250000000,64777164,6
115RVJpcbTzjjjk6v4sv77hRQ2W6mG6k71,FALSE,454240,551892,97652,5
1157AK1RTxRr3SjMHxRnSnHnG7rwqhifBp,FALSE,0,1299601,1299601,1
115sWUC1WFFYd4rMfGDz9avCKkC6zecBsk,FALSE,0,17274887,17274887,1
115vRjsryhmqn2pd3iVoH52fujUYRQdDS,FALSE,0,14165008,14165008,1
114gxot1BB3rBGSAQ9ewfAwg1ZY1PTsbNf,FALSE,0,2160900,2160900,1
114cfa1fe8EdZvRJ4zGdrHt4DUBQcGt4Y5,FALSE,0,5480,5480,1
115TtepM7me6uT1UxrDH7HTBN2uB2XhWuZ,FALSE,0,1130,1130,1
115c1uS5gQXcTqoDGvSyuz1o2Bv3vJjxvM,FALSE,1646252,1646252,0,2
115uEE2mEcVp4KTGSeBtJTMh1zWKGrY24N,FALSE,166991,228750,61759,8
115oZ4PAnU6j6g8tcgsPxR5n7Eo4aq8QVN,FALSE,840000,840000,0,2
115vo8KNFis68w9yTtpWeFTtSFmwwucBYD,FALSE,888971,888971,0,2
115jtpJriovYN1DXxC2UUuHsTM1ASxDCwK,FALSE,0,4884,4884,1
115nSP1xUz4FyHmHYvBrm6Bz19evfe7T9C,FALSE,0,658538,658538,1
115D7qUmXVxsRZvkBRdVY3wwmfiHFjm47P,FALSE,959337,969337,10000,3
114hSFr96RVoNSVNRYwVrMyqYKYnUSh6Fb,FALSE,0,3538,3538,1
116Eixs9toBiPHE9kopTg33BhSpwbFZwda,FALSE,228169,228169,0,2
1167PZV7QpQSX5KkVmkCrCb2LC6sdmWNpk,FALSE,0,4203,4203,1
115LhgMX5UH7Apt4roun6crS64Uy1ZToGj,FALSE,0,1006308,1006308,1
115FznSQf1h5DYcSuvBNnEntLdHpEYHjCz,FALSE,0,2730,2730,1
118HmCws2juv2qXFGvfwQz6Qjdh1BgFEt,FALSE,0,19880,19880,1
1173rrffAN7nwAJBfjCWyH5NBkWvTG5MY,FALSE,1040024,1040054,30,3
114sgUFt8eBLFT7t9U7qmgTEeTNTuTpdWj,FALSE,0,20817,20817,1
1162JMtsp4nupKDHGffbLEZkTrniYVumZt,FALSE,470060000,509900000,39840000,3
11JCH2nQTqUhoX3FKmtcvcBHJE5Kr2U9Y,FALSE,0,10000,10000,1
114t5ec6LcxezAn7RZX8UvkbT4Y1QiBuMe,FALSE,0,1284808,1284808,1
1154SBqeCMX4JHdrWfZUPhnyZnMkHp5YL5,FALSE,0,550,550,1
1164TVtr4na2xfm86JCaogzTtyqf4MVV3W,FALSE,0,814,814,1
114dJ1eJ4WaBNRkqJFqBGfzW2BsPddUx91,FALSE,0,6150,6150,1
115qSNe5u1R9vcjwhjGK5epD4uAE5JLgEX,FALSE,0,1161282,1161282,2
115uXJbhdPhTje3zEoWptkEdwjftThss6R,FALSE,0,2538,2538,1
115xKHLNcvsWPkqCLr2ySfkD2TVXX1ufeP,FALSE,0,490000,490000,1
114fPhmTC9Qh1NLhXaRBivw7Apz9TuTFNm,FALSE,0,537406,537406,1
114yeBAPTknH5cnrBDGbN99HiVSK32jkJk,FALSE,2881360,2881364,4,6
1153FWZNEfuPqyicxKhf3yuCQMpv1NSn4j,FALSE,0,1001494,1001494,1
115RMLADP7NsEEra7BbkpjB1iCLi1TcpyB,FALSE,13154,502730,489576,11
115KFTGx8pkweXEQsZ4nRqBjNziPb6sTjM,FALSE,0,10265,10265,1
114k9C28xhMF98NaGw1ZRtwiY3FKyXwA3h,FALSE,1976130,2145032,168902,4
115X7cgnHF3ved8Uzm4faY9ohgVjWJHXSH,FALSE,78817,78817,0,2
11DAHVYufGhyfiWVbcWJQ4nEr8udRERuz,FALSE,1190000000,1399950000,209950000,4
11EiCbJEYePLRkuwnUrdcP9ogSAXSwH5E,FALSE,0,5480,5480,1
115pAHnnmanXGhbkZjHPA5UftNWoYsxz52,FALSE,0,84375,84375,1
115mW62V22EqMF3REJEwbNAuNFdshaHu4K,FALSE,0,1000000,1000000,1
1154hoxBFyoWdbCfHP9y36jKGhLsS4HoYo,FALSE,0,5690,5690,1
115yBgniCwcbK7CTD8McbMAu8a1ZDSQuuT,FALSE,0,5480,5480,1
114ch6zFKyPX3PwAxDzjFudcrZmYo9eX9D,FALSE,463771,463771,0,2
114kJSiWSQsQAVpxo7UM6YdsdVLFC5858r,FALSE,0,53299742,53299742,109
114ZjEwCWVcw6nrvUkhJnrMoeB1cehUfNi,FALSE,20000,20546,546,4
11LwCEYzAnRk8DKZui3bx337TrQTCdB2g,FALSE,0,500000,500000,1
115TQGdoyHe7CuBD5PCKnm2YNUAzxFe3De,FALSE,0,5523700,5523700,1
11Katp59NrtbP3DLSRpQHk5BzEJL1yFBX,FALSE,0,1,1,1
115KBy4u88jwrXErijsg98apMK2W6q6EKo,FALSE,0,141991,141991,1
115xqyo37ALvBJuKSDrVyZm3d5EFeeM8tR,FALSE,93040,127738,34698,6
115W34cjASfsU9EKyxNqScKpbi5kwbXNm3,FALSE,0,3535,3535,1
115uVsMhCQtmykwcSf8Wn5cZi1RAf3tpiT,FALSE,427397,427397,0,2
119CmghEcViwqa7Lsmjfqt8praiNQj6a9,FALSE,0,263102,263102,1
115kHYaTVuCrtyuKqzHDXWafyJT8iQYh1L,FALSE,0,9182,9182,1
115spmzX4eTwAnQSV8oagJHoRm3Yd91QRh,FALSE,0,41473,41473,1
1153bjCoacBQubbmxqKKY3EvDcFusfH1WH,FALSE,219,219,0,2
115SdFGWjTaHM3FV2qeqQidNHhppbd1UPh,FALSE,0,85310,85310,1
115QyvyPNFQVRBMQys5o8feTxZPcohvxVm,FALSE,0,26444,26444,1
1168Sw9jAPZBN8nfP8WMC1NGrG6bjk23YR,FALSE,0,877188,877188,1
1156uERiY4SGzPQALoafXCnygmCS6NuFwF,FALSE,64568,64568,0,2
115AoRnMF1gsiZ9abdwckpHpNtpnY437o,FALSE,1026,500546,499520,3
1156TNwvCQuastVDVCws6Q1SywbpMNdohX,FALSE,0,20542,20542,1
1161jykU3itbUgxaMmGY957HgbsRKSWBfG,FALSE,188997658,189000178,2520,24
115a2ExTvMmZro1nf8GY8EVoWUyCZ9HvVU,FALSE,0,319380,319380,1
11EvunR7WcvAs2vmUSN9fiapnhyq3L9x4,FALSE,0,3406,3406,1
115nefS5GDRjj5hGBQsGCJeHgHGDUtyUP2,FALSE,0,356432,356432,1
115qqhmvqx15dxaXh8GgnPqapZAH2ao6eB,FALSE,439828,619828,180000,7
115ChcuYCArG3WBQkAhpdXAf4mobBHMEP2,FALSE,0,3421,3421,1
116Acz2AQfqpQZmK7C9oxupJgJX1YVvazG,FALSE,0,3587227,3587227,1
115FQBDfraeycZJFAsntaJSmHmBhLnjnQH,FALSE,0,436038,436038,1
11SUe9oiWnCDux7aBZBtF8FAYZsQVFMfJ,FALSE,0,500000,500000,1
115SeEzgUkD2gQLCPymAFzjWQsjor4dxMD,FALSE,190583,190583,0,2
114zRyFZS2fpRZMbyADVDtkjfY2x2uJpeQ,FALSE,21350,21350,0,3
115bqXBRmAPMxqDBbnWLyXxcck8rbrjsaJ,FALSE,0,238511,238511,2
114nFRf3eh5wEgXPhVfGAbJRqmpKX3MpYJ,FALSE,0,3000,3000,2
115EwbrrSC8LJNpdoS7GtNDRMbAVDbxsNT,FALSE,229857,229857,0,2
114qA8A14WFun56FtnYhT7BHxY4nJMvc7U,FALSE,0,10263000,10263000,1
114vEE1UJdQ2rCCs5LFMyMQ5p9mzi2CBki,FALSE,21113040,23006609,1893569,106
115asym8iEWTctmBvaDudH9eZ3TkyLHvT1,FALSE,0,610,610,1
115N1K8RjpHgYD6PP38aAqkMozDvGJN2bG,FALSE,0,1271800,1271800,1
1158TYZRzvBUiJTBgWa3sZcdeoCz2kS2rP,FALSE,0,5296,5296,1
115tppWuMN1WbMp2HPgiM7HNct2uxzHpPm,FALSE,0,100000000,100000000,1
1159qN6KtsPiYADG8ym9t5SnY5wyRqhV51,FALSE,0,1236656,1236656,1
11J6YYaFYSqGLBuem46k7tCsfhmsb1omA,FALSE,0,10127,10127,1
115GEUSxCxt5AXU8hehMVFoxx4AoS9jADs,FALSE,9900000,9900000,0,8
118tCHKSk4XZKLqzF4ZkejGmBWRRj2LHb,FALSE,0,5897,5897,1
115aCHhYxYCmgCURKEhj1JeEDt6LEn3uZj,FALSE,63821015,63821015,0,71
115ZTLnrdFxkr9uJoSDn7bVyMLwWE9FFmv,FALSE,0,14005,14005,1
114hFc8zwJMoNd5GvtSGPXWjp4v6mgPzFd,FALSE,0,1000030,1000030,1
116AcTi4iAvhJ63HVve6mmX8cQKVQcpeF7,FALSE,0,17615,17615,1
115jJQbyZhnFBhNZricM8MfYi1HyHGdAeE,FALSE,927796,927796,0,3
11Nu11amSedNunc1nTe11usXXXXWuCCuc,FALSE,0,2,2,1
114bezfMs4pQqsVHJ5yNyUAfX4twWYRGdG,FALSE,0,697033,697033,1
115f7JV1fMmEtkeTFdv2jouH2dUKqEsQZ9,FALSE,815769,815769,0,2
114rtsAJrn9rSHYguyCQ4Y1LQzNULq6Dxb,FALSE,0,6828,6828,1
115yGWSm6vp7YoWQw2fH7srvPyETFd88E7,FALSE,0,1425,1425,1
115Vr7EWGhdfb5HFyUYR2ESS6nUn1BCb9h,FALSE,0,20000,20000,1
114oCG8AkhFWDuzGUR9efyVe9M4AE5MnTB,FALSE,0,10000,10000,1
115c5wyoNjwTUKpzxL2VDqukLYBizf1XPW,FALSE,0,1042691,1042691,1
115NdVQDoSnyvxtj9fCe9SSBcsszYTEZZ5,FALSE,0,102132,102132,1
115jkmMjH1wtHa5YwmXCBb2igZp35M38yi,FALSE,0,730,730,1
115b3E4Ae3GsrQdoESASw2vTbb5GujuweE,FALSE,0,302670,302670,1
116D9ieEHXF2ppGbpSW6cDrcoug7yNn1ru,FALSE,0,1614,1614,1
115CLWeU511YgpR3cwc52yW1tTuwB71Dqj,FALSE,0,406288,406288,1
114peEVz25714Kt1Rg1Jofg8NNGMCxB16M,FALSE,294242121,311210842,16968721,7
115sK1qa3r98KM2yEy4Sqr5VtFTLUw5bLQ,FALSE,0,8153199,8153199,1
114uCm3Y4n566SXuhWM7eY9sXbdexjtt3Q,FALSE,0,198396,198396,1
114rSQP2vvC3hGSZE5XDQhuYicpjntm51X,FALSE,233486,233486,0,2
117CsihiNrHhRLm8YWwuYyK2WA2XghPGF,FALSE,0,1000,1000,1
115AguBoYJUJQ7NTEhhftvQy66AFy7GTNv,FALSE,0,300000,300000,1
115FdPvEwbowSngTNp6RWxC3K2CqwK8WqV,FALSE,0,21354,21354,3
114m27BhfTUvDfP8HCWmJz7WS8prBT1hJB,FALSE,0,9633,9633,1
115xorHQoWNgEZzegMUSJkrEr8fM3co37b,FALSE,243664410,243664410,0,2
11LJxp9xVJBqKvhMBXRdATDDDMLjPvyMo,FALSE,0,33307,33307,1
115ZP8wzbY1RGYC8uTa3SQihvmtMBoHvkV,FALSE,0,3841,3841,1
11C5QPZdtYRUhHSeP8P6pEBqLppVqRuuU,FALSE,0,321750,321750,5
1168pzE3Apn9K9M4SwhYBQnFET8NymPzLb,FALSE,0,1000,1000,1
1163YofZmFAwXou2BkSAfC4YW3LdFcvcFk,FALSE,135994468,135994468,0,2
114j5GkZrhZKvorqkU9a69AwsoUrkGWUgj,FALSE,0,570,570,1
115yauAHggg19mSSm3EE7TGMvWy3Jzgrka,FALSE,0,9520,9520,2
115W4nNWM8heMyMABDJLSG4dEota4njGxJ,FALSE,36000,39000,3000,3
115jmwgdy1TYtjEot7E8BhzkXUhJJ5wCMx,FALSE,0,5977,5977,1
115WK5yGACXb27LTDB6VGNHM7vsQqj4dzR,FALSE,0,20790000,20790000,1
114mQA7RGJLR18B3MGsyfPuJeQXKzNmSPi,FALSE,0,548900,548900,1
11G9Q5LLdnw1B7TunLj7kcDAwe2ZFLVc8,FALSE,0,1635,1635,1
1169L6ZxCGWndoa6wm4LY5v5dwDf36bV9m,FALSE,0,107656,107656,1
115dMXU1uLZvfyc6VTitX5eE2hyQmSoZ1R,FALSE,0,88277,88277,2
115yCNRwLgUKZBAMeangRcWtFe8ARzCziV,FALSE,2730,7730,5000,2
114bSjTGscaU6grzGr4FS1kJba7Zi1ods,FALSE,0,5480,5480,1
11QPsTNrsSqBhmD3wwJFPJz1KoBpX3fNn,FALSE,0,42546,42546,1
11QFemPBpiCYU5fEkCTSoJ6PciDamVGHq,FALSE,0,3000000,3000000,1
114wkiP6SyYZ3Jcqz7b2Z67BV1EZ3LJbnF,FALSE,193955,193955,0,2
115HMSnDZhFigvJw93TFsSMAATboHRJcWq,FALSE,0,3948723,3948723,1
115ejUJa7upizFy5hi2Pm2xDrsFe1tbWc1,FALSE,0,996336,996336,1
11NutzZ1cbbmprHXry3MPTTt9UmUD1tX5,FALSE,5356182859,5356428671,245812,728
115KuhbdVhajK1ttQ6o7QT8ZS9qmjRMbUB,FALSE,0,3331,3331,1
114xQ6hg8Ru3xxGEpbHMeH2KpCGBijzFDV,FALSE,84419346,84420497,1151,87
114p85uub5hcSGBzf1i481NgQEFqh3ECjE,FALSE,0,10504,10504,1
11CH5tTpV7u6wfucafXGeqYYGjjUfD5EE,FALSE,1100448,1190548,90100,2
115aKLuWCduVA6UeX9aYcCKpmXNxBf4ZUZ,FALSE,1302490,1302490,0,14
115UyJU3qwVuspw3RgUzWm844mNghYypMB,FALSE,5000,11000,6000,2
11EykhmX3J9WhgR7uGXRF3dhFuH1vdr6T,FALSE,700000000,700013182,13182,5
115WDhagEybjdCLC88pz4ws6qa2d3YMyn8,FALSE,1400809,1400810,1,3
116r6jcDvX9mL15VCZpSXQKXEyBiYSe7L,FALSE,0,1629939,1629939,1
11HbsaDBS9BDxKGJsS8yY8ffNpY88x9Nk,FALSE,0,200000,200000,2
115HQ1dTtsKrMTn92dqQMfuwufKdfgF2Dv,FALSE,0,1000,1000,1
115EnAjYHNrocaoEaRtyHxS5JFhzz76eTe,FALSE,0,1220720,1220720,1
115qj3jpd2Vvy41GDLui2p9JvCrwF3KwM1,FALSE,0,3936,3936,1
1163a3LasXgNFqJaotiNwq2ujnGFkz4chF,FALSE,0,24224,24224,3
115wQdqExH6a6guaSY1hM3hi8zLY13bTDV,FALSE,0,7006000,7006000,1
115Fd9oPATTN7GxwF5FYiwgJV23W2KSnT4,FALSE,0,220406,220406,1
11Q51kbiPWNWLfTFkabmDaTCM8x6dQ952,FALSE,2076472,2076480,8,10
11AW7wHzsZGgcqoP2Cz175xdihRb6Yauc,FALSE,4175063855,4175063855,0,117
1165TV2auGp2zxnJ3LMkuMn4rj1eMFwEhq,FALSE,6852,9000,2148,6
115zRhx2b7hBoKeXefTJGEDb7xCFNTQxZn,FALSE,0,268717,268717,1
114Zt7Qj9eYCQEYB3mhQCSJ6GpZ2zidsCM,FALSE,0,712333,712333,1
11F1CvuFoQqHvS24ivKs9sjQGssaqfoNE,FALSE,0,77341,77341,4
115qJqWAso2zQUDur8twMws2wW8i5ajido,FALSE,0,240000,240000,1
11619ehTRQtzn9A2a6fqLUgp5PYiB6V5F5,FALSE,0,15619,15619,1
114azxHnDoc59Q9hZF9WbV6hVejWYma77s,FALSE,35453,35453,0,2
11C36tZRzjpFdbk3kRwRFUSzk5fVz7BtX,FALSE,0,3487344,3487344,2
115DDdLEB9q3jkrcsgNF9ZqcV1Lu8p8s4g,FALSE,0,12858,12858,2
116F2BdEzJyDVFjvyh8fVTGvMemtCXpdQA,FALSE,0,29300,29300,1
115Y2bR41tt6eozJcME7AFH2bWpQKxTAmY,FALSE,0,2815225,2815225,2
11PUTV4xr3kcjb8dpBVdB3C6Nv4CXEFQH,FALSE,0,450000,450000,1
115CT59BbApoWFSmkZWmZg6nfZmSzSXv89,FALSE,19992700,19992700,0,2
114bTU9HehktLasxhxpfbfuaVTm97S4rAB,FALSE,0,649551,649551,1
114uGePu2PaY3DdxDFPVY4Qh8dAm75hgKH,FALSE,309006141,309011055,4914,56
1161cxvx1taRMjaTkUEohEzUwWG3ViJVBz,FALSE,8000,11000,3000,2
114yuRyMShGDKeVpsZQLCzLBVRSoyu6Uj1,FALSE,56956,56956,0,2
114hTrsFKMS7tphxzjvN9Y3uEZhA1E3FzK,FALSE,0,110000,110000,1
115PdNKUjzdpgsTzzxMQTdgV33WNxyrbdL,FALSE,18837469,18837469,0,2
114gnV2Lsd7C6zcLmswqKjwEZQkTVGQb4r,FALSE,68484105,68666655,182550,48
115oANLHPQeuKXaLRu7AStVDpBjHiWMyXX,FALSE,34326917,34679700,352783,4
115EBgJC8XgBrq8BqTZwWHtP53QyVQh66o,FALSE,300000000,300000000,0,4
114vUzMHYiR7YC6SjB82Uv73KrBT38deva,FALSE,0,9962,9962,1
115oZfb3WRBPR2Td2kQbMBtnJVs7DBPNSs,FALSE,0,47112,47112,1
11AGMBrj7YGQvNGhPZFYnBzFdhetaEwSK,FALSE,0,5870,5870,1
114nALzK41d9PS4m2xZgPeDZy8Aw8tuojz,FALSE,0,6000,6000,1
11KnRJRDX1GF5CfiXCUWANXwpgPTW47EQ,FALSE,0,73600,73600,1
115ypamz6cwXpkNXjax5jAQ9PJQZc7Vfah,FALSE,0,546,546,1
114s5pDVzEVRzWULFHu65GZBViFbCAXYbH,FALSE,0,753719,753719,1
11594vsDTQFUhbVhoSZboDxCKVZ2pYaADD,FALSE,20776873,20819202,42329,34
116zQZ67zwhQM2qgXvhpH3xrdgo1srujc,FALSE,0,548,548,1
115MuiyTmPma1YuX1cM6k9gqAwGcp912np,FALSE,0,460000,460000,2
115s2gFvyFz2HXtrZWWEmMnBgWz2jjEjWe,FALSE,1305719,1305719,0,2
115z4Lo9pJRG1trDTauYjvyc6WDc9jdVQg,FALSE,0,48472,48472,1
114sRrQde6p1dBiYjYXQ3rC4sNWFwPSZbR,FALSE,279949,279949,0,2
114pTBdHYZs8A1iAYj7uEmr5V13XDZkcLV,FALSE,0,400,400,1
11N8JsVda4Sj6KrRkcTxksVeMnwvDXcMr,FALSE,701126,713500,12374,2
118DADaKpzC9PNVnTANqLfnrRY4REDQqH,FALSE,0,1,1,1
115caSqMrovzJfdUkiqw9hPv7srqywcXFL,FALSE,0,6358000,6358000,1
11BibnWekkYzy9fUJF3AryyG7QpQHCFJ5,FALSE,0,1,1,1
11HCTxBeoaRjQ6v6GEWFXJVjaXGm51oZT,FALSE,0,185212,185212,1
1152JgbTLFCCNR6AmUv2jpYJfdtLWCX27F,FALSE,0,864720,864720,1
1157CQQv9ywAxojL4j5vyV28ppss6jMYQR,FALSE,0,17403,17403,1
115uAkHz9ZkyrVtWLrdmhH99mYfh6ZgrVW,FALSE,0,187570,187570,1
11HspqoqCGzB2zV7J1v18QrPSWHmXbJ16,FALSE,839266,839813,547,3
115DWWGF1y6qpuq4swVjTNmfDrQ78Qx5gh,FALSE,0,852,852,1
115rSJYiYrfBFSW7EVgThNtjp5VWYUc7pX,FALSE,0,870,870,1
114aexo6VHCd1yRySaDqyXwTRQcMJssCrN,FALSE,7400,7400,0,2
1163m8JpvPF1rziWfGnUJ3HG4rLz2t7mrp,FALSE,2000000,2455000,455000,3
115rg5fiHv45r19iPiUAuFEGCfjkc7H9Yc,FALSE,0,82000,82000,1
115pXXtBWxJq4v8r5azntXJ5zimiCuHd58,FALSE,348190293,354212687,6022394,109
1168j3CYpF9so4WLA9by6K8h9L9dTNU814,FALSE,0,36700,36700,1
1164UpmZ9tTBVaX36kRyCjWUA4mYV9fCiE,FALSE,0,23526332,23526332,1
115xF7zk3yM4WoANEhQovp7zc2PsNSY1x,FALSE,1710238,1729215,18977,104
114kckiMcXPHGPU4yfu99rmBZmztqzBFHw,FALSE,0,81416,81416,1
1165VM6kuP9NeW54N4rbnZ9b7AFQqM3Pip,FALSE,0,2077,2077,1
1153ruUtikB96pfgPRLwoQLEZu8Y1YzQaM,FALSE,1848899,2108770,259871,3
115wfcYjj9ZHxot32rAyjFcdK5ddSibmWh,FALSE,0,7250786,7250786,1
115uxAWkY7iPeeRGrmobjFsieJbmedQRmn,FALSE,0,16586000,16586000,7
115h9y3q479KosigMCjCqneKYJS3zSHYRG,FALSE,0,245519,245519,1
115v637MHzyn1yAPREhRfqusZQsL7SYVnb,FALSE,120781,120781,0,2
116D9b8yy82GQ2UenWMidtfAiWvNEwCyrr,FALSE,0,27840,27840,1
115xTxM4keuGJwCL5f44SR93pBmDFhdhmD,FALSE,22666,22666,0,2
115ssnBFdCNtERGym3uhy24FPqwNxWvqP3,FALSE,0,2306831,2306831,1
114nvxNekvQxGZaMj6bNzBRw8bcdFAg57S,FALSE,599400,601584,2184,13
115kH4baNPoH2fDX9RamZA484ZkxYk1pRX,FALSE,294189727,294364809,175082,134
114kQx4b4Ag4F3XoSZjZHGSVxQLx2nbG82,FALSE,2145390,2145390,0,2
115FpAqEWvBCnvLd3v6RbGBF1jfHZC7kmb,FALSE,0,8307994,8307994,1
114YdJXKumKsA5j45qBTiKbr8UJet1sws,FALSE,0,2992,2992,1
11Ck4G9Dg22XauQtvNjMFayUGqkowgeLZ,FALSE,0,181410,181410,1
116R34DpcJNmjZF9nKgLmss2nEju8zujb,FALSE,0,926250,926250,1
115Eatd2LXh5G7M4fEmmnT722NPRPzGbUN,FALSE,0,738019,738019,1
115CzS5BQxpQ58xHttQYKNhXH5PFJWUjBa,FALSE,0,979282,979282,1
115n4sLb8kqDrxaeUc4E4DzDH93xdoA1rS,FALSE,0,1001848,1001848,1
115qj8LWPRSKbDDvx6wabW6Ad2PnX6k9hB,FALSE,0,87570,87570,1
114oxY2EKUdNZATv5Nny4XDoau9tPqk9CR,FALSE,0,36223284,36223284,2
11GcqWxKmZjHiMYhmUAEqzUfnEk4rUVig,FALSE,24660,41555,16895,4
115wmnrFXWdLuRLp358Wid8ThDCoF5sKsB,FALSE,0,35000,35000,1
11G7yNQXHzwfCrcokufrVnEkmC4EV5Lmu,FALSE,0,75690,75690,1
115LUFLWmUd3AWUC7jQ5j2LHCsq3vw7nfN,FALSE,0,5364,5364,1
114ZrkWzrZoA3hYfRD1CxpEQtevUGVEf6h,FALSE,0,76366,76366,2
116HYM8sag8MsLyGUhsmHyx8YGQ5wVWNh7,FALSE,0,5500,5500,1
11HCjxwMW5ZmFMpQpdYzWDKyKobu5excU,FALSE,0,11226,11226,1
115QA8AwkDHuFi41JVA4LRzHatBTNSiGj9,FALSE,0,28560,28560,1
115R4KVYuPV59tPpfE6SgEfNug6QQrKb2z,FALSE,0,300000000,300000000,1
115ZG4hsszHRh2QeTaM3oT1qDRrcJ4cHjh,FALSE,10000,105427,95427,9
114kPadVrtpdTpavLY24ofmNQLc3WETgrk,FALSE,1358512,1457324,98812,6
114eFBBwtffZdwk4WJfTGLWW1SPvrHpDg2,FALSE,0,6430,6430,1
11Bveotdqro7sJnaSHQCeuEy4nX5HbsbV,FALSE,0,206571,206571,1
1159kFoqaLHxSVg8sDBZsULnFpDKqok9QK,FALSE,0,1000000,1000000,1
115amVKVYiQCtrdGVtTZaNmNZoGgmZER2X,FALSE,60000000,60000000,0,4
114bsGLcdJuXgkR3eqZ1McVitw7XuhDGTB,FALSE,31943796,32760312,816516,12
11juXMeL9CpUAn8YupZ5NCD8QYdYA6Wtn,FALSE,1545,1545,0,2
11S6f92dF4favSSgLRZd6BvtkMLF3XKZj,FALSE,0,599,599,1
1157hpcBAzN65n5Hsg7PZg3LPuh3vXykXu,FALSE,0,4811452,4811452,1
11VGE3FYsZRwsN765cgaaXhYquWTopiia,FALSE,0,1982,1982,1
115XarZiBAeBjuy5p1AS82qLe33zAVj3oL,FALSE,1518487,1632340,113853,10
11oMjTVMc1x2sBinAxwefweSnZ2aPvDyL,FALSE,215510779,215520779,10000,11
115QbRhBSGbirBNrmLcwE2EnWvYZ37BadZ,FALSE,0,1000000000,1000000000,1
11JcqvkaX6cjYyHWdJ3nMR9XX5ers6ML4,FALSE,1190017,1190018,1,3
115wVNgv5Jnw1eUMrgJfb1D1dj73KzJ9N8,FALSE,0,18403,18403,1
1167jAtHUFaQhYskJqXLbSdfuVfek6ooas,FALSE,0,25090000,25090000,1
11p2usqFyEmui3rcCEC2R9PkSASrhMxXD,FALSE,1289605775,1337072393,47466618,124
11RLgYbpnGhVnDsxKkZb3vpRSvNX9bwoS,FALSE,0,5480,5480,1
115HQ4RZWTpqPvt9swHZUYaoyjgDeyeXEY,FALSE,5388635,5388635,0,2
11V4bv3n1sa9FtcxS9EbeRATEsbymUP6E,FALSE,0,1,1,1
11PtuLtRWwc517GBUzhCPCtNqKsBwoWCm,FALSE,9068,9068,0,2
11msNNDaNB5Tku9caD6zY9phcUYQGH6Dn,FALSE,0,179448,179448,1
115iSVxR3gE2SijYGrpJwRZSoxVDPFQUqh,FALSE,0,855000,855000,1
11C7vaC7D3EuXueKcR755c8yBKx282HXn,FALSE,0,12788,12788,1
11snbgTfBAZwGMFpm1pj56P5NR2oxAq5p,FALSE,0,49770,49770,1
115eedseyJPNzz9AcDgTAHEGCuWEm7WS4J,FALSE,482654,482654,0,2
116GwuLn3L9qdugUjYk8cWqLzYsE3apTzb,FALSE,0,109187,109187,1
11LQmYFSXGrhLk8oeok3ZfapirtKU3R2Y,FALSE,0,5500,5500,1
115smJMK56XWompAfokCpshwAS3RH5M7Qg,FALSE,0,1092,1092,2
115hBeyWLq75YjXbHovdXUBMjSrLfLhA1C,FALSE,77466,90558,13092,36
11RPHrpFHGqN8wUPnAicJ5iUGiqBMgg4P,FALSE,0,17028,17028,1
115aTgpcJaM8VQgSrRUKaPo85nenCGaerm,FALSE,0,15037,15037,1
117eLZmyTS6V6GaajaAanVxRyZSAKpE1W,FALSE,0,12300,12300,1
115tDPQ4B8U2zbBb5tCgxtxjfJcAAvqNUD,FALSE,99998000,101000000,1002000,3
116AMYC5SvNhQGvBcwdPPam1yHdjiLfMNW,FALSE,390000,395485,5485,4
117bfNkKxhsD3o7Ntxr3eDVWLBRvnBUY7,FALSE,0,1200636,1200636,1
1168rMGAMnrMBoEjBEMHKvxpmSSBEDV4mF,FALSE,166433,166433,0,2
11WoDoiAFHk5FBCPJydvhHKSbbH3xuz9L,FALSE,0,854517,854517,1
115Mw8j74ygne3xca9L6ibNDER23Bz6Qmi,FALSE,0,3000,3000,1
1168LV8yUE6dKamdMmyRzyvyDCTJ14JgDY,FALSE,0,9587,9587,1
11644L93Jd2rb48JRPALH69DUv3gduq3hD,FALSE,0,19675,19675,1
11hAkL2sEi6hFsMbeQSa9dd1maccyjEeH,FALSE,0,891,891,1
11FrkoqzKnxDmAZxvuiu7CwZxxK6X57VN,FALSE,1937529,1944000,6471,3
11Anywhere1nNoCaseCanTheyXXU2ox3g,FALSE,0,1,1,1
11qEHYmg6tGKKCzkJg4C5ckGdtEdma1AT,FALSE,40336478,40420699,84221,11
11VBhdriz6DQ1Nxx552Ef4t9X8rK5Xmec,FALSE,0,1000,1000,1
115FSAjmAFGYFq2p3K3tHkY7emu5MSKDVR,FALSE,1365434,1365434,0,4
115UhVrF7jg1p6g7dYXL6j8N1NjYDudm9e,FALSE,0,10561,10561,1
11LJbBVwhYJ1gqUmCiSM5RactDnf6JzVU,FALSE,0,234352,234352,1
11UuoeRBa9q4p8Yyz4Wdd5dvXaTZe9fYS,FALSE,0,117756,117756,1
115oqcVAinhuNQTj1Vo2bezqqNdEAXx6Tr,FALSE,14000000,14000000,0,2
116DgunkqXpiCzJa9idgpP4woWr2Khx1a9,FALSE,0,8506,8506,1
115vcnwsuHQzm1ksW5Lc1C9YRHBf2f8W7t,FALSE,928606002,943606002,15000000,13
11m2sui9xMdJtXfyvLRdH4zbiACV4DjiT,FALSE,7186384,7269844,83460,5
11wk16mDBTfaPGL83XUzeVuo1faAg6J5y,FALSE,0,970473,970473,1
115qb8g1aoz2Q477AzcwiHktBhH41y1UNG,FALSE,0,20148,20148,1
115hZatn2rBjENYu5QCL8bJ9FgFkJqyEVQ,FALSE,0,105628,105628,19
1155ynfUdjQ9XK34iw2U83UYW2pKxQN1gF,FALSE,366845823,426845823,60000000,31
11641HjfkWSLhJ1uEo4oQ5CUMuwuzxYEPY,FALSE,99900,134900,35000,3
115Ehfptmqm8jH6oW6UmkLSZ6WTYarENa3,FALSE,530000,530000,0,2
116EWduAbaJ4BQzZBPxAA6vFrsFawxJ2m3,FALSE,0,10000,10000,1
11PrmNiqXe9jbyfmGrjpuPCXfhNv4N1fd,FALSE,0,8972,8972,1
11M7kSSdr2Rs9UdYom3Eb2DbrraRzVs2n,FALSE,380000000,380050000,50000,2
115g4HKuBAe3o23SQRdz8x7Cn8ueFrwMZE,FALSE,0,3519000,3519000,1
11TubWbmumzx77irP6Rj2dCz1qXTHQGk6,FALSE,0,386459,386459,1
11rWVppY9HkpR7zD584jNkBA7WoWGu2Yx,FALSE,0,90000,90000,1
1156F9aXZDrQd4GgF8CEGD8DVU64gwWNf7,FALSE,0,201290,201290,1
11RNU5HhHkwRwCQjxsQHNHaEih4M2YZKb,FALSE,0,210000,210000,1
1158CLoPN7n8MNgWU1gaQ3xBY4wPTENUHD,FALSE,0,20720,20720,1
115mshwrJDtYKv8A4GnVo2adfj8XfD7cZX,FALSE,0,280000,280000,1
11H2M2WzuiN31TqW1CuUtsA9eDSekD7mv,FALSE,0,438247,438247,1
11ENLeeLAGDjtSr8KHCoiL6puqHsrjfvi,FALSE,0,16130002035,16130002035,4
11gcyboKKUaW4nmCELiQU5XCmZW3FCQ6u,FALSE,0,131974,131974,1
11WQ3e1SKoC4YNvFoiUtMVNuMdPTtqK6M,FALSE,0,852,852,1
11vdh8jYgyULeWeav8zYS4fDwMpYr4MzU,FALSE,0,10790,10790,1
11WTKXqWtXRstaBBLaNf5ngCD4c7V6gZK,FALSE,0,54980,54980,1
11cFEEY6kvrJz4qAoftxothALA6fGcdTM,FALSE,11958853,13624953,1666100,9
1168sDV4cR9eX68TcjbijzeumksAGo1ahY,FALSE,0,948854,948854,1
115FNDS9AwVVtwn2c83QzsjEb4fpdhxxVV,FALSE,0,572,572,1
11Gd4sgFm4BVWwh228d4Q9cJ6fpAbFLFZ,FALSE,0,12000,12000,2
115tKvkgvhVGWuogAA3BxEKacjV6zzJ7Xu,FALSE,1092,1638,546,4
11nXMGEvszK5MnJVB91PZhan6GhBA1kqr,FALSE,0,128958,128958,1
11nEMGHtoVFXdeLjmQcGv3rwsVJAwC67L,FALSE,0,8124,8124,1
11w5BtzyHrnn67kmAUwNkBDxgqA3m1VeU,FALSE,0,5500,5500,1
115Vq2Y89pZmerUs2fawcBnXJ1Wk65LJcB,FALSE,62289,62289,0,2
115Vp3Qp7X9snpqcftXdtt9Nfcq1fV6uWz,FALSE,15059211508,15059901435,689927,1502
115iX1Ws7VQmgry6BHQA4MDRwS4WJK7q1U,FALSE,0,2289300,2289300,1
115BAVj5dvGp63Jdy4ZRU8jKthgDtXeYU2,FALSE,38277,42277,4000,5
11gSyTv8YiNC5RoefeE39sj4sWvbUZBhb,FALSE,0,1,1,1
115x4JtwaJVFe3Ax9ck4zvMnizt8LwVZow,FALSE,809553,893443,83890,3
115s7WfUzEMzxSxikChDRGpQKcTWhKnrxa,FALSE,0,1587040,1587040,1
115jK3hZTUb2cHDmcQugyehrGGBx9yKaBh,FALSE,0,2837850,2837850,1
116BqUcUNgb3S2eKccCpyiv4cXgNpuW3qQ,FALSE,918870,920044,1174,3
115xUi33auV6dMkTM4bd87SuoaHPMhd9HP,FALSE,102730,105460,2730,3
115t1Gk4mM7JiAZtUSEG2TySa4uG7RWCVC,FALSE,0,12855,12855,1
115fQP1aRPPV3REcymndMi5vHrBqp3QLDw,FALSE,681713,681713,0,2
11FEcYeawEZQVh19e1WxiEndKGCnbxi4R,FALSE,5135692,5844134,708442,11
11dyXgRiKQQAX2Mt1gjL5A66D89twHU37,FALSE,0,34753948,34753948,3
115WkiCuAxs5PeTPdQsTcuxHtjiECV7cjh,FALSE,0,11490,11490,1
115Y3WBTHVHaZryJZmkKhg8GjWzpVFpJ7D,FALSE,665485,743666,78181,20
11TwZB99EZNSweiJS3aAKGmbYS1kBorfv,FALSE,0,26700,26700,2
115Wp7hPKyHmgAVFFcCszZCs9fSERF6d2p,FALSE,144936000,148660074,3724074,5
1162RaPKvbNZvGGZSoT4iVDoxrmipCTDjR,FALSE,0,65690,65690,1
115Jh3qCAYqjin1Y4iN4fDCqvcvuYvz4rb,FALSE,0,157441,157441,1
11MQqKnL1A6Na6A4fsNhAqDw6Hra2wKfd,FALSE,0,3153,3153,1
11j82yeQuYEziPD724SrDEMMSiDHCP6eN,FALSE,99920000,100000000,80000,2
115YabdASKUyQFpJgbC75iaGmomTzt2ohx,FALSE,200546,205460,4914,3
1162JvQNjHHqVEfsbVR8uDtd8XPnXjrXoC,FALSE,0,3063540,3063540,1
115KdMKusG6zRYMUTHT6CALmE1W8S2uygq,FALSE,0,3922232,3922232,1
11617FaHByhuBkryMtkSNMqHMqNPpuNyAe,FALSE,0,87987,87987,1
115ZApvVjL4TmzGmo2Bsk3QJNqLeoNgC21,FALSE,0,66100,66100,1
115DeUywEBqDfRaepJXuMCqKNWAZVPv6Q2,FALSE,0,185859,185859,1
115TkYifZW9HNUYcVaw66Q6m4SpL2dEWNA,FALSE,0,460911,460911,1
11f1Rz7yAVbT3HRTHaf3Mwy3jk1JwKwTe,FALSE,330000,330000,0,2
11633aPcbY898yAMh4k19LRLEBF3koMgxG,FALSE,250000,250546,546,4
115wgYZSAF9eBqr8hXYGbdxqcQFeSUkQuA,FALSE,0,163195,163195,1
11escoctvrfcSAgzyAxRmNySL2amE289E,FALSE,0,546,546,1
11qu8S3AKAuYzjsvQBPocjktQfhanHsqH,FALSE,200010000,206430000,6420000,2
115TCNjmBT6zhnig8pMZSRcwjJWq4iQLMw,FALSE,0,283828,283828,1
11vaKuSsuvoaC9NCJoG81F6JXdhaf8W4Q,FALSE,0,5480,5480,1
11DFmKADNt2i7w1RpR5aiuSvWmhpXsKmT,FALSE,0,2246100,2246100,47
11N5uXntDsB2YGgSVwzijukGeFNeGj3mN,FALSE,123502644,123668206,165562,35
115CyfKB93yNMzfNM2Bjvryzajibdn3b19,FALSE,0,85889,85889,1
115MyqxpY4QwpMqrCNEqsngfbqTc2qo1TH,FALSE,0,6500,6500,2
115am8YgubKHr5XmARrACrRhzZDCRSfcZ6,FALSE,0,20345,20345,1
11JGUGFJgUyJYQnn2vkJx6JS5Aw1GAKxa,FALSE,0,1040,1040,1
11jXTXiLYg8m4qb8fctRUTU7eNg2w85wm,FALSE,343245,380907,37662,3
115anfYkLVvibdryWUbW5NQvYPAg1eZ89G,FALSE,1638,5460,3822,13
11e7U6Dzfz1V519ut8foUZuCf8gUaxHsa,FALSE,2715332,2734405,19073,10
11Y9WgGeoqotoUCYyoeos9pbSdU9fLxAn,FALSE,0,10980,10980,2
116AssiR5ZCzph68pAhX4QPaUWTDDddzbP,FALSE,0,1,1,1
115qd1SsDppBz3QVuEvtiKDoe3YR9XAx7Y,FALSE,192087937,192087937,0,6
115voRMHxr7KA9Sm5HPtXSDHNRAdFLaKFP,FALSE,60000,60546,546,3
11YezM8rYUD6utDUMqvgWu5L4vSErfXqD,FALSE,0,8049,8049,1
115mvVraZB4LBk9zQCGjgtxemqAcgBfUT2,FALSE,0,29438,29438,2
11wtsDwe1VH3JPyE6EDQn5bEscCXK9MjJ,FALSE,0,2950000,2950000,1
115W3Aw7pRP1oBz6MdXkeg9R4SM1w9PK5o,FALSE,0,1331,1331,1
11vA9WdzHLm9ZQwKqJAG7yTRZudtwYV8V,FALSE,0,6400,6400,1
11U5QQrJK1xueK7C51q3iWTNAphbPKeyS,FALSE,0,9000,9000,3
11fSWmv5rnxZjM5bS3DFWgPzcHadSogds,FALSE,0,654,654,1
115ozBJzwFvQA1acmpCi5ssBdrfom2FDoy,FALSE,175300,175300,0,2
11uJ163sFPsvJngejBGtZB3qtetUnqZTY,FALSE,0,548,548,1
11a72bVmhwmggm2FMLiW2DwW1v8u2B71s,FALSE,0,11000,11000,1
11eQzBJdLLCViGkrpV5DTWrm2PBTuQWWh,FALSE,0,119504253,119504253,21
116HfbqiBnkbdjqD7M8Aca4Y2k9SedbjVQ,FALSE,0,849578,849578,1
11Gq1N4RRnFJnsrd73Z7W4Rt1ovTUGGVh,FALSE,317277856,317278402,546,24
11mpj4trmgB3XdUnGbE7uMCjtqgTFjgTj,FALSE,0,3170000,3170000,1
1161BSd8wbzxPVNNU4uTp5TtPayegeH8Gj,FALSE,0,341558,341558,1
1159fxGpag9Hc8MDcXibeUtC9q3uSCW9fo,FALSE,2913037,2913037,0,2
115GkeEsyHTE7rSdaHNQpn9PqGUJnSczvj,FALSE,35696639,35704314,7675,94
11692Mqe776kgbm6webfRo3uu3d8atXeak,FALSE,0,41552,41552,1
118MdZEE1N9TxyL5tzN1uLMiPEh2Bx8W4,FALSE,21400,32100,10700,4
11AXrpr4m2jB9uaUP9UgAd6EpodsQBqYY,FALSE,0,108842,108842,1
11HR8Ap4vxaVJXVNzz7iKsgmy1TPKM8Fg,FALSE,0,149030,149030,1
11GqCwrrcQ5xJzzjgVb5BcXqTkSgvh6qs,FALSE,0,688,688,1
115a7FqkjukF48sG5PXoL6XnADHRiNCxou,FALSE,0,620,620,1
116EitD7z485X2BeHwzkee1mr92uKSGadu,FALSE,0,2920969,2920969,1
11CharactersAreVa1id1nXXXXXYsNxui,FALSE,0,1,1,1
118UpGMR6kN8kA28jahLoN5WRc9EUK1Wb,FALSE,362803,572852,210049,5
115fYNggVXPh6hpvMfMhPBf6pCJnNAyFTe,FALSE,0,59100,59100,1
11h5LndALXy5g6nZ4cpf8BK72yfhrwB4o,FALSE,0,55164,55164,1
11ceFnGBVZ4WV3RRNL3ogDafzRBYknUnb,FALSE,0,3774150,3774150,1
115zgHtjcu4CqwjnMyaVfdrEnpMDLd4Wb9,FALSE,0,5480,5480,1
116Cmzop1bGeFxQ2nZEtwBwPZ4FrxMyRag,FALSE,0,11463,11463,1
115Nv18Qkt2gFUoQvm9F7kJLQcC6tUgAHT,FALSE,0,197249,197249,17
11qdrSvBnC6YzcZTewS6txebdEhZ9pcz9,FALSE,0,5600,5600,1
115LdnVvZ1mpbkafqM9xjFzAZzWvFCtWHy,FALSE,0,1367,1367,1
115W3P1WMKnjxiocbvFyqq6u3Ah1H91oYS,FALSE,0,5046,5046,1
11b5vwA36TH8Hv525YMYhpzsFf1un1cEb,FALSE,0,1,1,1
116BRSHJBWqAPkSj4xXH2dgnfd7HPFwDY2,FALSE,0,10000,10000,1
115phCNKMeCU1bc3K8etaR4VNfBHX6799a,FALSE,5684448,5910926,226478,78
11Wwxuhe715UGrnW7A17gNLzfemFQMGY7,FALSE,0,6555,6555,1
11qBKec4gZbRyr11LwbKJRFXWPy6mKQUE,FALSE,0,294542,294542,1
115Krcpbvnv7V9cq6m8Y3xfVKmF7XwaoqE,FALSE,0,25205,25205,1
115WsqdLJHsN7Bv2ryXk9arzfL2nrrsku3,FALSE,0,18285,18285,1
115mE92bm9i92u9BoDDcpdL8ujJEgcHnEu,FALSE,0,2839815,2839815,2
11La7KAkG1kXhEaznfz24f9SnvknvhaQe,FALSE,0,41016427,41016427,1
115nyvj9BojSYcBCKyWKfLAjCXVVgYexp2,FALSE,0,55500,55500,1
11J7TDv3LSpwYeVLGzf3vUbK5tQbyFfnA,FALSE,0,1,1,1
115yu195Vb8FT21D5mGdHNNnT9KihnDDMp,FALSE,0,162793,162793,1
11TheFrontRoomTomFishes1nXXaifaHp,FALSE,0,1,1,1
115vy8XZjDV71yVFvcpho6VVakSirsyor3,FALSE,0,129565,129565,1
115d3Yr9ksoe1Y8scyTMMwMHW7zhKabEYk,FALSE,0,5000000,5000000,1
116FefabitJxtWmaVFMrjZouyN8jcH3urV,FALSE,0,3032864,3032864,1
115LP1QWtQL5b6y35qzsRyk5QUENTEiKPZ,FALSE,0,63100,63100,2
1159onKMEK1MwvAkVhmXEoxvcFGBxZx8oh,FALSE,18775864,20606000,1830136,3
115irWXGM2S55dBdwMLxoQ63ZpPyTDukJw,FALSE,0,16000,16000,1
11623byuQrVoazkZ2kdnfNRfpNEJuJo2bW,FALSE,4751766,4751766,0,2
11Leve1sofHonestyAndXXXXXXXZ6wika,FALSE,0,1,1,1
1158DYA4DUQiE7nJKcBCxcJRXi2Ye6Q2t2,FALSE,1812239992,1815194992,2955000,224
11aGB8VF5Gx2BbZJZVNgmSPjjirrTqsqf,FALSE,0,78761283,78761283,1
11p5RT35kC1hZwwCcWnrZzJc9NUf3a9Mj,FALSE,0,1,1,1
115Ac2BJjs429eZQ9DzQpwsFa4MDLRUvCj,FALSE,0,115473400,115473400,1
11SFADxjzETu2p9mqQsrCEt1AtLHBC9uH,FALSE,3343,3343,0,2
11e6kmHVaTN29kPMqDMvrmZHzmq6fiFo7,FALSE,0,548,548,1
115YwdekGTi4KwKbmpEBr8AXPKbuJZNwXz,FALSE,0,32294,32294,1
1176oVo6t8Q2TnmAFxHLfjwNJCJrQphWz,FALSE,1000,1000,0,2
11mMq1WrnXUZu3gVVnv6MuATxjExFfMio,FALSE,0,5030,5030,1
115mRL2A1bF32nCc4uC9v4AupAkajx4F6H,FALSE,0,81790,81790,1
11FCooKZYC6UtA2zPtfYUFQJkNwnCBvXP,FALSE,0,7207,7207,1
115j1G3iMVhbJJUHnoZ83S5ugAsbsSSKrB,FALSE,16493,500546,484053,3
116DeBokpGaPBUp4r3Q6qYmb39EpZJcaK6,FALSE,0,55120,55120,1
115nHzRKh94zbXp5zbK6DW2JPuJxfpnaHp,FALSE,2385582,2697570,311988,28
11e3McYsp18DY5aYR2RmZ5Ebc1HC76Aqd,FALSE,0,106163,106163,5
11VBvVMfka6xbzy7Z37iwCth26CoEWe3C,FALSE,0,7971786,7971786,1
11NT8vL8xrCnhyHQ6d66mDFZXscCYhbaA,FALSE,0,17865,17865,1
11p6hoBJPUCF8i5NDpkenA2D28yFZqqKs,FALSE,1889359,1889359,0,2
11uq4JdGsWjmMg3eJrwApeFJPp2QBXpfK,FALSE,0,11559,11559,1
115UYuPR7X4WauT1iW7X2iWGGrK8Q9trdK,FALSE,0,6500,6500,1
11687edKecpk8d9YZC6AevKcGdo6uh3Zyx,FALSE,464931,1880330,1415399,4
115Hes514vB1JxdfLJMSd8NcHHFhRxhReR,FALSE,225585,237197,11612,66
115mowi7S5hA9Eb4qRjMYhmVvUiHm5ENWu,FALSE,50298,50298,0,2
115Y6qRQ1koYDcUfxXLSdr6nhxJZJP3Mdw,FALSE,0,1245,1245,1
11L4msE1bM5aV46rLq5ZpcaDGu6AQ3VQQ,FALSE,0,1,1,1
11utxidSJZV1a1jmzpyCyJdeXcAZ13HW2,FALSE,711895,711895,0,2
11RVfDVE3oNfiXA4aAaeAnpjYcGUHBw8V,FALSE,0,6028,6028,2
11bwmxoGtXiEQqi3cHnoKQD3PFXjZAQWE,FALSE,0,1623460,1623460,1
115WEwTWNiLxVWCtJ8K47h2FBYjqfhdbVJ,FALSE,0,45521,45521,1
11kLJU5u447oWtd43ZDNqQWY1PdzBvrBD,FALSE,0,86757,86757,1
115Z3LP9GbRP6ZxmT5tGEzq2xhouqhMbgu,FALSE,112950,112950,0,2
11uq7MANf2vizBPYtf8gPkToEeYEo1fCQ,FALSE,0,9719,9719,1
119cPxqussA8iL6QYtNZFKHCPgFHNF8JR,FALSE,0,445500,445500,1
11pbdwiCEz6UeggJvgQC1iMJJPNVxwz3i,FALSE,0,154812,154812,1
115rgjxhJpd2gP24AKku6tMw4WKSDVvAUu,FALSE,0,47300,47300,1
11xSQ8EiXpCAv9b3QP5pYQrjBwnXK6NXg,FALSE,50970,502184,451214,8
115uQKUPRCcX4VuUNvfHfAdZ6G7G6ubBqV,FALSE,340036,10970302,10630266,2
11PoiZ5AwZwqMkX8URmWtzvMLNVsUcms9,FALSE,0,6000,6000,1
115Ny8RZWztj9gJ4ri2XiqrmGrMrLmAnQk,FALSE,0,46773,46773,1
11XhYXuczsBoY4WCv8zJjTvbvCVQAvS2p,FALSE,0,40847,40847,1
115Q74yTessrLqrNhy3awfzeKX9bFViSQe,FALSE,0,54285,54285,1
115Um6CYqw4JcNM7HvzZkXntMEYx7AsfLn,FALSE,0,755975,755975,1
11BkXZdoZii1HibMdG3U72Jr84oWZbyGG,FALSE,0,5460,5460,1
115nWUKyF7JfTAd6CG7Jyvxk5LTn9FZCpD,FALSE,0,4211,4211,1
1164eWuKG77BwrXvM38GY97PtrQnTmNxa6,FALSE,0,2664774,2664774,1
115LUkkhEqMSzjFBqZPTj8Bfqden1dM7p7,FALSE,0,37290,37290,1
115eLm4Fa469xT1abipgnrhuMMpQVDUgYt,FALSE,0,940668,940668,1
115KGwHeL5mToWksW9sAVqHsD7uCc3fHR1,FALSE,0,33928,33928,1
1169TijbAKYMa7uAPLM8pzPdRTmAs7U8EC,FALSE,0,5480,5480,1
116uxgDfmdUSGX26rYnsMCBGNnqBwketh,FALSE,0,51743,51743,1
11ewFu1f8gZnfF28x3gX3SrL5eoj44eHZ,FALSE,0,156726,156726,5
11pRvUobATtth1DKs8UDTrimdkCV5CxvX,FALSE,50546,101638,51092,4
115689cKCdCqoNy9Y8JBcJwW9aQWEUoCA8,FALSE,0,10000,10000,1
11Md54tkbLeCkRZyXQxodEyF6CVzfkbE7,FALSE,0,14788,14788,1
115vP2mR3LiyzN1SktcPqq3WxJffNLDxDb,FALSE,0,84020,84020,1
115HKorjUfadmUzZf1zvh9GU64kDdYXZJ4,FALSE,0,1405600,1405600,1
115Fk2HA9oMRE9gYpNkGxMmwsULdTDpH8w,FALSE,559627906,559627909,3,5
11VkEiRqrcS48eyiWL8CnT7KT27FAC2vD,FALSE,0,10000,10000,1
115N3JQosjY2V38eJVwtLfyhivnE9ksKfv,FALSE,30192,30192,0,2
115KqddAtxkFsk3xvKKMXjcNGAon7rh3nW,FALSE,0,39663,39663,1
1159FG2ZtXfkVjLE9PizZZ9MG3CowCAggt,FALSE,0,7792,7792,1
115pr1pSAkg5nKwYHzcFMASFn5qJREd4ms,FALSE,5376,5376,0,2
115bdwDQdEFNsgEmMXNr8zC8K8F3KSvpnf,FALSE,0,883,883,1
1157bXhPPpyRcy1HeQLPpAbV8dTWiAeDT8,FALSE,0,1076420,1076420,1
115X1ntohMiuy1u9rEdmpdx6q2DEFEV2Ce,FALSE,35626066,35626066,0,2
115RgY8gwZ1JZ9vP6quBWJTFyVS4RSCbwm,FALSE,38850000,47276254,8426254,3
115ga7EbVRviEwZAzB9Uy7a5SFQ1xPZoXd,FALSE,35490,40950,5460,140
115oNhj7e5hKw918yn2T5MXYfeLv5qyBa7,FALSE,0,1282,1282,1
11UJeq1THhGjU3EP4JPtKevDchUDRQh9r,FALSE,27000,27000,0,2
11SG7t1rHtd7vPv9aNHtcqZkSAmZxUPFc,FALSE,0,9000,9000,1
11kpKUHMmLoQk1M6oN3LYEJLDsXp5sbrs,FALSE,91215,91215,0,2
115ffjehauUThS2SBRJ3863sJQkqZRqVwx,FALSE,0,8795,8795,8
116CRD2yXFzyLCAzANsHudVHQkgxXq5kys,FALSE,1770637,21420088,19649451,8
1162vy9fEonC9GBXAVyR4hNRQX7h6pjkUo,FALSE,39010000,40000000,990000,2
11ZtWDSUiMGXSqXBapiWQrwedJipXbL1Y,FALSE,0,600,600,1
115LpnZRcPZpdJGRKBAWyGhTUcaSoADSwF,FALSE,0,94957,94957,1
119SrYL9NNgjfyt61Ds6aSBJWPwG6xFUS,FALSE,354127,354127,0,2
117xiphZ3eQzChEbeZERxzGTquyxyk3hT,FALSE,0,750000,750000,1
115nveGhSH8RmCz3A6i98PpkWK4H2shg7,FALSE,0,5500,5500,1
115YRS5DhcDkJtQvsmZijD28Z26qfiboxq,FALSE,0,45724,45724,1
1147bcYqSb11Yq9AWrocxJLFbFizqEGiaa,FALSE,0,2500,2500,1
114RgSK7g7WxBBQ5FKU4ziSWMvbUSeGhDb,FALSE,0,25310,25310,1
114kiqYdYXvicG23WbFLDHm7f4tXKySf9V,FALSE,48813,48813,0,2
113rbUQhuTv7cSu6FUV5i3LKGfauh1LdLc,FALSE,0,14321000,14321000,1
114iYJ4cN6ED3bgeHjUzXnnXS8cSBZJU1i,FALSE,46192,46192,0,2
114PrAYs2vUzgu9gyefivhL1oiaPDf4iz,FALSE,76775275,76775275,0,4
115WZVnbgia52YhsUJi7YUDXSozPsnUef7,FALSE,0,247958,247958,1
1143LbTVgPhtbVR3nAqJMBB7s8JBfVXhP,FALSE,20000000000,20000000888,888,3
114dAzS8Sw5Hn1NDphRdZkX5JXNmyzVrUV,FALSE,0,214168,214168,1
1147vsRboqBxpUpnLcdnhExMA4KFh1GiHU,FALSE,0,10000,10000,1
115REeTwBMGf5KE8rPe1WxF7LKQkDx6EQv,FALSE,0,5070511,5070511,1
114HJ1d3NsSkTEYLAuWda2PZu853wKGyMM,FALSE,0,1727423,1727423,1
114E19ALmGuPQL8uAwguqLgdrmjBCjwxqA,FALSE,0,5500,5500,1
113acKGKyw2L8prUWiW6uqJC78dmUTUMp4,FALSE,19000000,19000000,0,2
114zJPANdCn1eh2mSQUXwznQbkgGcMsUY5,FALSE,0,64446,64446,1
113Vg8dVhmzB2zfXx1EEVjYT7CjYExiBKw,FALSE,0,4156,4156,1
114Rts4V9N58S6Apso8inK62kTdhRAUD9P,FALSE,0,934096,934096,1
114bf2L157idwbk3qoo3u2Yoq6SttL3oC2,FALSE,41000000,41090000,90000,2
114U2aEJyBbAtnoxnjc2YsA9K5PdudiKWk,FALSE,0,252204,252204,1
114oVHySrQ4HBVxGf9ziRxyt5WC53PbiNu,FALSE,0,13843,13843,2
11555qAVjRWAm3RG9RF4vwA6RSHnJJA3ex,FALSE,0,81556,81556,1
113m1p6GiNqp1HwoDhQJzh5y3dC3sWntZW,FALSE,0,20799,20799,1
115FVh1pN2DqJVT4JkUWVaujjJUgbYm1XJ,FALSE,3567328,3567328,0,12
113pmk7a1YQQ8nKvdRVQHz4UuXbX1szJNw,FALSE,0,44770,44770,1
1157JA4rYT5w9gFQ6uMvenwKjkAp91EBU8,FALSE,0,17528,17528,1
114sfCdDZynunGLWRXS3eSCVzk4ES7zGdd,FALSE,0,2500,2500,1
1143x5HwRdJNiENtzwMsS276eJiqkw2Qwb,FALSE,0,27150,27150,5
114WwotvdTSL1c11vwsJhARdq5cbXxaLmo,FALSE,6074994,6074994,0,3
114jPygcrb1hV76KqZFev7QiFqgm3F9XeW,FALSE,0,2140526,2140526,1
114YTMkpY16mpA1BDLc9iFFXRjB3CfQpdv,FALSE,800000,3490000,2690000,5
113ytJ5rwRavaYrCrmXihYyDdYqodGhuo4,FALSE,0,4232,4232,1
1152yNLtF5yzqWLdqorDpqnZFNQR42sATY,FALSE,921010000,921030000,20000,38
115H8eQNpEYukF7NCzgg2YCssAM6yYGnKg,FALSE,0,548,548,1
113czqSTW7VHiyhUDFL6moLwduiBqT1Yp4,FALSE,0,2365100,2365100,1
113o7Xmqtc7E83UeR5JFjUSNMrTN5zwnA7,FALSE,50024019,51674291,1650272,7
115NLNpAsdzKC3uPZUqehR6qiaduLtxsCP,FALSE,0,175740,175740,1
113aRLL6dFj2Lvvj54gki2BV5qmAz5bRN2,FALSE,0,1077135,1077135,1
114PbDoswL3jSKgnxH5P6RYtTRpqB8ZvgN,FALSE,0,18278,18278,1
114kr3gRtndDW3eThk3LLewgfABzKhyN1t,FALSE,0,2880,2880,1
113ZFbjpG9bto6jX2arTt6DPm238Z6jjNd,FALSE,0,1388,1388,1
114YcYH5ApawLMx6QnQvpSFtaE7phcx96p,FALSE,0,424899,424899,1
115acNgbEECxCP6XHQMUttDukyChbcgR5X,FALSE,0,20000,20000,1
113uwrQ2fyxBExZaidwRjGvcUpV4TXn8mC,FALSE,211910,211910,0,2
1146KRNw5bV4q9zdxFeaGhZhBmLKNKCX8y,FALSE,0,1000,1000,1
115Bq6mW1YpzR7Y99F5SCri6kHTtadgZs5,FALSE,0,7871,7871,1
113zUhCvbEnDfwjn2RVYpzHmNwdrbdEiP7,FALSE,0,1041,1041,1
1154RUq7HDc27eMkL7HHQCZ2Sw5hMdpXTT,FALSE,0,52777723,52777723,2
114RzjUdV3EY213XCkBqG2oJ5Lav8zHseg,FALSE,0,16385,16385,1
113pBMLfXPxP93RKtTda8a87A5Gpf5z9Jm,FALSE,7450000,64350000,56900000,8
1156F4bAK3LTAwtbLS65aiSnYMMET9aFri,FALSE,0,884523,884523,1
113uFunxRWaxWwNadGUakee8dTJfPQyMJw,FALSE,0,1000,1000,1
115NWgV4HVcAmUCHpbKemquSLPxAm7JzUn,FALSE,592546,592546,0,2
114SQkLqo9VvWkBdqfXEYLFCsc6ESwHMvx,FALSE,59947243,69701423,9754180,252
115DasVB1XKbfE5nqPRmKbQryL8kta9DpJ,FALSE,0,35300,35300,1
114EokSwNfnidXDYCrZQ6EUdGkZS2ujYZk,FALSE,0,1245,1245,1
114LNP64TNj5MMYvh4A5YCLTeVRi4WU734,FALSE,0,3368563,3368563,1
115a7cKcvwJXojTKT5gp56QkqxSit9rVjC,FALSE,6600,6600,0,2
113xrDo8RgKHiUFbvDT8A9tzVVkqeGoEFg,FALSE,899110,899110,0,2
113r17CrZLb12EL4m2ftsVi7fxtyiYX995,FALSE,0,5000000547,5000000547,2
113s4Q17hzz45QUveR15A7DdmaL1Mx2cwg,FALSE,0,20576,20576,1
113VCXf18Svin7NrcdGWAHxK67rArj8uDh,FALSE,0,177300,177300,1
113vfbXkUCNe8mtgqP1iDP6EqDmqk5crxg,FALSE,4579955,4888930,308975,7
114BZQ6uchEsFn8tE2ndWnp2VVLBhJCuMP,FALSE,0,1505179,1505179,1
114XTy9ucT1G4foWCXE4yEq6PtkTJipazW,FALSE,34530,503822,469292,15
1149iVsp7Uaf8SDvAWAQWUqdvYESvWaGmF,FALSE,0,6853,6853,1
114KSQgV8C6qg9SSDTH52CLv8f1xALq71L,FALSE,286986,286986,0,2
114RfvaxJqGyuZs9xdq36iaKwyjS4EyDnV,FALSE,546,1092,546,3
113vaqoiRqmjiL3DSAUa3SJRGcKoD6Krwy,FALSE,0,3331241,3331241,1
114RsfJvXB18adEih8cf7um8jTtsPyHf1e,FALSE,4668,4668,0,2
113g8NdSwsY5iGNTHQCwASGg4HKVnhGtyX,FALSE,68183847,68184895,1048,12
114iTiDuUjhxhJNiYemA5jeAQizgYx19CY,FALSE,95000000,95000000,0,2
115JA4hBAXByH9Er7W2Q1dZSjVhiXiTVgi,FALSE,0,25004,25004,2
114RYEpVkh2Rksjr9p1rEBPgPReifgR9gJ,FALSE,0,3480,3480,1
115BeDzE6fQesMp68vXfzKyjMFrfgQGKUe,FALSE,0,492579,492579,11
115VTpeG63AkpPxMAJb5fxWeAEmYh8C6F1,FALSE,0,10000,10000,1
1141b3tzh6H6bSoLSFH1tgLobBrbjgttba,FALSE,16010000,20000000,3990000,2
114tNExbziZ68SGUpE2oqB4k2MV6Ay2MgU,FALSE,1750000,2460000,710000,4
114GK3wnUL7aFmmBiA67MWKFbxQCkavhKj,FALSE,13708,13708,0,2
113Zv3WuMh8h1XgKPvE1zagbTrSa3d74k3,FALSE,0,3720000,3720000,1
113cZtF4uZmpv3Ft18zLH6YBVih8yyUHQq,FALSE,0,754450,754450,1
113fvj8hZhvUunU7npy6bbra9iy9wAjZYk,FALSE,0,40330,40330,1
114SqUPYCgYuREfCupuSxtAGR2D82nR5E,FALSE,30000,30546,546,4
1143GjYsMT9BCwzAfsCmz6k2XUqvDwFZ8H,FALSE,0,180000,180000,2
114QzrxkTkDxSeJVHQxuCxGM6mjqp1t8Vu,FALSE,0,1998,1998,1
114YuwHVNLWc5iu2JhjUjkj4kZx6cWSSx1,FALSE,1156,1156,0,2
113z6j3wTuExbajaSJWz31m8GroVce5B2d,FALSE,5423237,5423237,0,2
115YB7z7H7RTSk9KTU1SAoQkYeTmPoerhS,FALSE,0,5500,5500,1
114rg8Q8UwbNvsyPQyVz2LmmXDmXdfMEzk,FALSE,0,323807,323807,2
1151DPxxrmGWqnZtX81CNNKSwTJ5jYwysL,FALSE,0,1980000,1980000,1
113weK2AfQadm6iZhVkANCECzQaDbZ9DfD,FALSE,250000,250000,0,2
114aj6k5HG2QiDrz3HaHRkvKJ6ZBd4WCUa,FALSE,936000,936000,0,2
113xszPWHfXRpHXReNCVphcwFP8MdL9WvN,FALSE,0,2499579,2499579,1
115GE94c1pUhR5vDCNBHvzN4B7SQnWubq6,FALSE,0,38045,38045,1
114giHC1cEpxjCAfpLS23YFaN1vEDPCGi2,FALSE,0,673,673,1
114GK39haHmKu2Uzt8iQBuuVxwKhBKEN3X,FALSE,0,23139,23139,1
1149LkS9nsCWfoWSNoKLtU2JG3zv9bvyfY,FALSE,1692,3438,1746,6
114hwmKjUnkGwt5QBLW9E9r4fowvZYaR2Z,FALSE,24106,24106,0,2
115P7uCZHAxcUvZdnsMHTemFsfsMjqamf2,FALSE,0,339420,339420,1
113mkGerCijGAgAFK2bYVooSYpstuLpxgV,FALSE,0,5500,5500,1
115DgoVFXYDSssNnDNY19NfAY3e1rfbWpv,FALSE,71428,71428,0,2
113fiTvkonZdiD2tBdSwgPHYPFKWxABfKV,FALSE,14261398,14281001,19603,2
114Das6DC4ivCpAqHa9VsmdXt8KWRpqZCH,FALSE,562967967,617284962,54316995,6
113ia7XhV6m9o7DMd6724ENuJicnc3Gxt9,FALSE,0,258628,258628,1
1141kKecViuvnRxywoNworpKASb7G3jc2j,FALSE,7939235,7939235,0,2
114VZKFu75Jt7jg4rs2ynC4BBbhkUZrbsq,FALSE,0,938,938,1
114Vv4Fc2ojbTifF3S4ZwZygB3zi4uP4EW,FALSE,0,5500,5500,1
115D5ZGqBC3MdwAnniSW5S5LmacnNPovmZ,FALSE,0,235207,235207,1
115PGXjcNidNjNnhLimqxEnk4YC5inrTYD,FALSE,0,47627,47627,1
115HgqZ5rARpyD9x6dhYkJamhoT3t9R36x,FALSE,0,400000,400000,1
113m7ZjG11AdLkP8pRcyT9sEWDyUwMHTj9,FALSE,0,3815,3815,1
114bxaZuAtAV6n1Rw3xSquyeWdk63KmTxt,FALSE,707356790,707356790,0,34
1153gAMkjpVaARoqFBXs52qRgRPqh5eia1,FALSE,0,42113,42113,1
1142epXmvi4k1PBucWBsKLJzHsg5KYuHiG,FALSE,0,1160601,1160601,1
113WZpdFy5ED59tMT5tXd9tKCR7s6vgmdm,FALSE,0,790,790,1
113mRwu8g47iZ5MMLbdvj32rWRgKxE5wgf,FALSE,0,8884742,8884742,1
114sSXP2y9j3Yziuq3VY2RwGCQxhkoUNSu,FALSE,850520,850520,0,2
113g7qLuqeK2AsfJWiGhorJoms6gsHeXCm,FALSE,0,546,546,1
114D1G5nmtzmrdpQXVNRWgEXG8nuSgnAbh,FALSE,0,94499210,94499210,1
114BBkhNEaDkGx4W6AAJnsspdRDGGJdCj9,FALSE,0,287570,287570,1
113WYySrQmnKJXYXwAZaVfCJDNUmPtVAN5,FALSE,0,2500,2500,1
114jDVtffdpV8aPu61EFqwgKAtXYrekYnT,FALSE,153819561,154126300,306739,581
113vPL8BeT8rgvS9vtZ97UA22pH83NkY2z,FALSE,0,200000,200000,2
114JLQ98DdKjmiEF5ULLenCMofhVxf2eHf,FALSE,0,25621,25621,1
113kCstFmQS51Ab9NxxEiD6ozZwhsTkBh7,FALSE,14889980,14889980,0,2
114JNAL9U11zqWvAqgfU3Nv7PUAtmr84wn,FALSE,0,52880,52880,1
113ahCLHQMrJPUYDYYzFu29wdZjp3kyQET,FALSE,57579820,57579820,0,2
114k25w1NJCL6ZEj3EfMBsc7nT8vkBgATb,FALSE,543891,543891,0,17
114WBfhp5QxVZX2cd8bMoEG598ikyMdr4w,FALSE,0,53430,53430,1
113Tt3wexyKW1VEqAMC4wgje9RjiS7aegA,FALSE,0,42690,42690,1
113UhiZH9tBEw3uTV8H1BE48gyfjhR9SP1,FALSE,0,10000000,10000000,1
115BMzJQh8tdN3Xw4ywywg9S7U4Dqezv7R,FALSE,0,23005,23005,1
113Zjhuz4b39nXHXQou8C3yi2jWDwUuLUn,FALSE,0,109079,109079,1
114VbnYbaCJkvDH6eUBneti6cZsXje3Qja,FALSE,0,40789,40789,1
114a5pAyCiSeSfSbuvqdGvAZbxCmkXzBQM,FALSE,0,302230,302230,1
1149nYLAp9yfSUbMRXhsvt4NfscATm36Tq,FALSE,0,3562,3562,1
114YMQrK8wSjqgtYeJEEFzqH3GUudUtsJg,FALSE,11338466,11338466,0,30
114V9H8KfeQpq17LhFHubq9f29ckHBBo8m,FALSE,0,2640,2640,1
114Wivgx7TZnUKcDigd8ZHPViN2SwQR2L5,FALSE,199,199,0,2
113WRK1xj8auaMk62V6uHjt6vYgD56rbNj,FALSE,34234151,34266562,32411,16
113dTg9H9d9QjWxmLh1nzm9QRMuGmEj1JP,FALSE,0,103758,103758,1
115NnNVo8pB2JN1W2D7pu5dG6KG7wtbBQK,FALSE,0,2497,2497,1
114sLPTwqYQHE5W8LCzsTWhDWZhPmz8oHX,FALSE,17064,17064,0,2
115QpaCJ1PdYfFpEkcshQAzZ2K269KotKV,FALSE,36139195,36140000,805,13
113u5pf3gFVEZKn9fgT6Q97it9xT8TW5jd,FALSE,10734,10734,0,2
114siEo8aJeYnKiaXnUpp8x4qBXhWfteaX,FALSE,1105934,1105935,1,3
1158EzrFQxQy2terFrgmjCiA5ifGi656Sv,FALSE,0,2730,2730,1
114FoxZ5hyhtFLXqCohEqAmBVpWaPToN63,FALSE,0,17799414,17799414,4
114EVyMSWA6HcD9GqzMF24fVmwCCSJHjW4,FALSE,0,237450,237450,1
114j2rByEnFt5sTsR8tJFszJ1KCXvq1n2s,FALSE,546,1638,1092,4
115DuYer8EPmNJ4cMoGeQLTZNpQ7LfXEYr,FALSE,103214,228960,125746,3
113cBERrwvhW3cSsumt7yfC5x4cijdBEaJ,FALSE,1640000,1640000,0,2
11546RBRfLQEDNvz6fB6W9FSVLFTj4uoKU,FALSE,0,5000000547,5000000547,2
114GbXZT7FMYc9UDckLXBGRSuWkiCqyP7B,FALSE,1407015685,1464083882,57068197,41
114qZviw4kSeGyGfFfXtnpECxFerhidRQ7,FALSE,0,733300,733300,1
113ahwRFAm5ZwPsXgXbK8A6WfP1SDbDRwF,FALSE,0,98882,98882,1
114iHdgAmwgTns8fURKQ8t9K1rS3T4QGEf,FALSE,790715,790715,0,2
114RqdJx5zjVq65PqghqaqP2PFDcCZGuf2,FALSE,0,6659,6659,1
114mhJpXG8ACbBvwvLoVHeugm4Xkugm8YK,FALSE,459690321,459690322,1,3
1154gRtCxjJhkEFRkvr1CuyT86myRuTgvb,FALSE,0,1135,1135,1
113hxuFWn8shTD1TtH7grJxSY8bzRVRMmk,FALSE,8847,500546,491699,3
114ctHemBi41u9JH8YoqiHEyQaJh55cEUH,FALSE,3000000,3000000,0,2
115avKHJgxC5HhpFvRqyyEuTmBz2CRm6wK,FALSE,0,4299946,4299946,3
114LEwQWc6Z74Bz75uo7hSwDHT5cNRvL5G,FALSE,0,1992723,1992723,1
1145bkfbv4gBDuHPQWuBm616EbNz1HMT8w,FALSE,0,81569,81569,1
114Tq2qYzHicobJjXAvtT9EgPZV2dkqxSm,FALSE,50000,52184,2184,10
114P73UrJrDDW6pTs3miYEH4c1EuvsiodL,FALSE,0,27675,27675,1
114oWUmcnDcMCGKZmTijsXUKCQTFP4x9MC,FALSE,197052547,197082919,30372,30
113bTB7ZPT3ZTVKdeZkcDgTTfyiSjf1ivU,FALSE,0,413241,413241,1
115PxchaQkwcR46EEbD8yYgQGo2SooUS7Y,FALSE,734502,740477,5975,36
115Ys9G3hPhXjVqt7fuSZk6dUwqxiXidyF,FALSE,379301312,380081509,780197,47
114M7FfT2ybDQkRvDYZzuUyJuTAcem3Phm,FALSE,0,16343,16343,1
114iRo4iBwadQTy4XoN5JxT8hgh7TJCRZb,FALSE,0,8146,8146,1
114TQd9aMgaUBPs7Wzek8ynkvgEXCcvUDP,FALSE,0,600000,600000,1
113cdDzuXdXXKTb4ETQVB5JE5f9YCtKuB1,FALSE,0,1000066,1000066,1
1143Gs7GjLoDjt3vL81u4ALVjd9kJzsmPj,FALSE,0,45956,45956,1
113yxPwt87g2jyF2cz2uML66tdVpBFHfLA,FALSE,1000000,1000000,0,4
113UtQNjZzvwzxfY2YdG8bU8MJ4AenH5oG,FALSE,110868,110868,0,2
114AhqyG8DjCMfrh7T818azgj5BbGfxUbk,FALSE,0,4038,4038,1
113qPmXgp6RiNYjQj9beFEgqDamCvAchZQ,FALSE,0,1810000,1810000,1
1153PYb2qcevBrijP6qjt4SMo8Dv5CpcJf,FALSE,0,14030,14030,1
113pBs4pCq9B5VjKwPDwXWZH5UQBGKBwao,FALSE,47542714,50010000,2467286,3
114NrrJoi1mqkHviNiBxZhUbg5Laim1MwP,FALSE,40000,49419,9419,3
113pccdeUYcq99iAACAH3BjGsQAAuqcu5F,FALSE,0,620,620,1
114VTZGCsLCSJeeEU3EtPeegnPepiUmzKR,FALSE,0,96774,96774,1
114p96vPaUZdcthqeC17C89G4Vpup3uzkG,FALSE,0,130378,130378,2
113uvs11FKYfGsSSYhytrN7vXRnyW7qchE,FALSE,0,2004,2004,1
113xWaqHQvtJhGdidM6Bws6XtuG3BuBope,FALSE,7452,7452,0,2
115RiuJR8qnv9v35KK9HEy5rPixoSJHuh4,FALSE,0,7076406,7076406,1
1143xfAfKoUprzeyyrnkxXNqT3htNVZoem,FALSE,0,4000,4000,1
115G7LA3nA3CG2FD7Fj9Bnu3tqMyGWQf2P,FALSE,0,6026,6026,1
113UkrH95rZriH5LUbEBK27QekQhisreFu,FALSE,0,20757,20757,1
114TNyx9pjjNKF18rbpRFg75K4LkcNUqs,FALSE,0,5159,5159,1
115JGsBUfEtLVkhtPVRmHoqCZ5EMApmKh5,FALSE,0,2500,2500,1
114pijHyHVUtuASmQ1wwK1Mg9yksNU6ZkN,FALSE,0,2500,2500,1
1151R1UeMJBk9DJCEkhTN3BsfverBFZd96,FALSE,167785,167785,0,2
114up81AG1sc2q4gfwsrvLauM8KGH8Sn8e,FALSE,0,3,3,1
1145HgcovVSDmXkzB37G8ueJtwgvVbSCkg,FALSE,0,1000000,1000000,1
113k1Lfqw5KoeMen5HYPUu7y1BDMNMnLgo,FALSE,0,4614720,4614720,1
113uHvtsTU3t9oUt2YCT2KJ4SHUXQKa2Bj,FALSE,0,85033,85033,1
114oUsA3X1q8Hp2ijy8A1EDsXptrecbbvq,FALSE,43121287,43121288,1,7
114wki42UxgVh6VQjDEQDsqg6mbhnUVG5d,FALSE,0,10000,10000,1
115QK9TpgUbU5uo6w19P7zC4Vd5WMhE8AU,FALSE,1652285,1722016,69731,93
113u2NTmMUBfffM8de8XMXqK4XQbdggoaJ,FALSE,0,1000033,1000033,1
114BMoDz1pu3jpfHr5trqriJjwURdaY3AB,FALSE,0,43400,43400,1
114pxGnEVXUCsAsCLJnEmtBk4HRvb3mXWi,FALSE,0,2389,2389,1
114syTFzrhe1uXgg73iaUAVWJRkV1ZW6Rj,FALSE,0,3370000,3370000,1
114rv4eTtuVbnV5wsrdVEeb7Bf1KUcwXeg,FALSE,8500000,8518649,18649,3
114427KFJikJbB2dTJHAnxTDqLrUPhvUNF,FALSE,0,1092,1092,2
115Ywsm7tTEPKWsSSdFNRbj3wQUVrbK9PK,FALSE,274799,572421,297622,4
114PqLHsNDUjc14UeSPuoc491tSRSHgbu9,FALSE,1141678,1893077,751399,45
113juVNomqLjyFcs8wsTP66ban3k4RiKXJ,FALSE,15947371,15951237,3866,72
114QpzNZCW7EqT178K2uzNLpAo8J3W7hgy,FALSE,20019390,23170000,3150610,3
114ETzZaKoGcZ8sPcv4HywEXGpwEnCpuzZ,FALSE,0,25221,25221,1
115VCkh3nh2xWXqq8CP55fDCdtAHUj1RDm,FALSE,0,10000,10000,1
114YK3zYAjpGEDwSUs8vBaupSqNN4kPv4t,FALSE,0,23784,23784,1
113zLsszPEvLpftxfZosG8DU5o5UTY6vn4,FALSE,0,17811,17811,1
113yBB4qWFjuwNVTx4SVwzfLczWbv1TbFT,FALSE,0,1092,1092,2
113w725UXrcRiFzBX2ckN52PNuqgLePb1S,FALSE,0,2227,2227,1
113UWprYe5wyGhSq49jjYbS5gJNGQwbxqk,FALSE,0,86380000,86380000,2
1145Jdd4MMTJDVcRmR6ZyRZDRZftcTo2ig,FALSE,0,1090068,1090068,1
114vCmZiDvR2REJoyVKu4mZnTY5crt69uL,FALSE,0,3000,3000,1
114iv9gGvBXmX6Wu1yj5JxtqaDMzkXJuDy,FALSE,0,297430,297430,1
114dH6Fi8aCmPaXXf3mseg7Q1KZMhuemxC,FALSE,247974800,248043373,68573,238
114R5duhy8Lr3AZr77bjwNods4HmHQtjiD,FALSE,10376701,10898404,521703,18
114aYW4jzNPZg9KbQduBTBemJbFMdDsTMi,FALSE,0,4924,4924,1
112xE8DCku2vEyVWktLUDqKw6Eeqf7y7Ty,FALSE,1540,1540,0,2
113RyFsgiB8cmxFD4RoWfKHxyQqbsxt6ka,FALSE,120700,160400,39700,10
114WRV8Lzj4VapT8hQwP2X1Vbdght3pTUy,FALSE,0,310102,310102,1
114NLET8dktupxuAdDFeV6PBo5Sci5PnMb,FALSE,0,580,580,1
113cabkx57XnY2zow87uvunmSdjCvZmNUw,FALSE,0,6918,6918,1
113cw9C6t57q3mAAhK69cp9vM1yp7DjSja,FALSE,5511,6057,546,3
1141466Fbkq3WsinhbGEtZHDQFVHKd4BXu,FALSE,0,487570,487570,1
114eBSPh8tLXBgGUFbfZ7YsJ2qEfXzEjrx,FALSE,0,51300000,51300000,1
112yPJSJRLkyQCAv1zEcM1FhxxrCaPrUdY,FALSE,487753,487753,0,2
1145MxkR4JE3fwH6hdaLfbyMNKm5aNLRJ,FALSE,0,1000,1000,1
114eDHajEbLQWjawp8m9KYEH3F6NCSB14h,FALSE,0,901420,901420,1
112vsNaGjE7kdYi4x7Jn1VH13hcbJLZBKS,FALSE,0,17335,17335,1
114rydxTLSJpP36LEVcuBUQrpH2Cc1tNc9,FALSE,0,999695,999695,1
114NVayQiw4C2MvD4qEHoGXdFzFKs7Tykp,FALSE,0,45297,45297,1
113EDoNPKiiCByzJuduZhoD4MMeQC3RFu9,FALSE,0,20187,20187,1
114CR5rMGm3zhWhmPji47kNdiD6sjiEmEL,FALSE,0,1449,1449,1
114YFzCn9NYeakL9ah6BWvt6d2F7YxDw6F,FALSE,0,1000658,1000658,1
114pfPXRgxZiwoJRqdkdrbrJ9KDNcUgYzc,FALSE,0,3750,3750,1
113VgYVzCb38P69kx1sK8sAzwkYzGUhzyd,FALSE,0,419457,419457,1
114bvjLKwdLjHeDVVkX71GGqtaJXjfbWUR,FALSE,0,591990,591990,1
113YXAKL8Y4EgeLMTDmH9mgKZddvrd7ART,FALSE,0,78415064,78415064,1
113GaSS1rPvgLiGHjqj7D9uLJ3ZTLWjdpQ,FALSE,0,5000000,5000000,1
113fJZikQgisxwh8NdY1NgJVGTxMH3moYU,FALSE,0,546,546,1
113srWAhuNc9FN2KvjBQEdtg29GuWKe9mH,FALSE,0,2338492,2338492,2
1132TQFwjQBYqkdSnV6ioAtDssnpo5B4Z4,FALSE,0,349729,349729,11
1146aeznENM59XNZVASQxzgnc2rqAEWj49,FALSE,0,98192,98192,1
114A9L2eYi6vpwt3hGrHGFXnwSUyic1mJG,FALSE,0,80780,80780,1
114oopztYE6J56FJNnJb3KxqwSULpRwxgG,FALSE,17049,17049,0,2
113ZZu343bhp5GjueuQ2XhDeUWsTa2Cfhy,FALSE,0,220000,220000,1
114BdQLhpuGmEnHbd32gtXVwXXYfLK1Wqv,FALSE,75758597,82058322,6299725,65
113LyjkYBAzWRZyBjUEz4MYcTG8wboxyef,FALSE,4588872,4599017,10145,19
113atptHo7kaWWw3SFoQ3RqSmXuhAhwEt7,FALSE,0,5069,5069,1
113VVMQNtuZME4ZePva3Xh837xh4jsNGxx,FALSE,1663860,1663860,0,2
114JiPFuccLBTVCDrv1WgLAFbUkrwEvAZe,FALSE,0,5500,5500,1
114TUA5CJVbaNcV19m6sKn6HgLengfBdvZ,FALSE,1460,500546,499086,3
112vqHhd7mfB38h6Epo8RTEqji6e8cVsXp,FALSE,0,46254035,46254035,1
1151TeaMiVNbhGTWxTpmqRMcaELu38eXNy,FALSE,10100898,10164305,63407,14
113KUtjzWPEKPFZueB9xV1sLiRWtnmbcbj,FALSE,0,14200,14200,1
114mjpxYNQ2JvuyfgX7P4EzFivmUptdgBN,FALSE,0,10991000,10991000,1
113eakUmddevgwmW7yo7Mmtu9YxjfXSwh9,FALSE,0,50034,50034,1
1138MeGt82chNZh6F67yiAwEg2eW8XdiBt,FALSE,0,73635,73635,1
113kpXy8HBUSgsEjWavR4JEa3kbadyVb8R,FALSE,0,281731,281731,1
113DJ2HWoXYA8dHyM2JoPgNiSMPtjZNvHk,FALSE,0,44655,44655,1
1142C4EvBTpg1dEJZc8to5r4myNA5QjRag,FALSE,0,19210,19210,1
1144Bw4bjBGEPBbSwbZVHNvrLJ65eBq7cy,FALSE,0,11300,11300,1
1144LW9jUNKtvAhqdPGJeQcdY2a2LcnxeN,FALSE,9273,12287,3014,7
1153vifpN7nLJyRdvEAV1VsGwPf1yWqmNh,FALSE,539530,539530,0,2
114L8Nr349EtzsrS4RrjqmSkUUHYmuYdpg,FALSE,0,1015000,1015000,1
1138MVVALR9cVsjjXnBnAw5hS93hBN7nYA,FALSE,0,637359,637359,1
114L7ew1JEY6fKhQZbyYgnAyvRdZhVggP3,FALSE,47804,47804,0,2
113BX6D1xkRFyuh2MTvRZdGNbzDXf4Z15b,FALSE,0,82357,82357,1
113jomAQZwYaaAzZScnSjj56jS4sj6mryS,FALSE,0,48729,48729,3
1153TDTCR9jDguaM6mo7oncf6CKtyL5F1f,FALSE,0,9089,9089,1
114LXjEUytyQxCP4PKoHa5Lt1CGhBK1vhw,FALSE,0,4007,4007,1
114f8FtG1ScPYan9phfomJrhU3VrCXq78E,FALSE,1721030,1721030,0,2
11342VgYfay2wMZTDhXwWn94LWCcif2Wn5,FALSE,0,1,1,1
114dY6mHC71eR7GHj78Z1p8iApiJ8gVe8P,FALSE,1329974,2493710,1163736,3
113fUyGqKDgF1v34svPbH96q7qMsMSnH1z,FALSE,0,113762,113762,1
113AquhKMmLL8bn9Efxe5hLSRvNLvFC2uh,FALSE,0,5000011094,5000011094,4
113v291kieCQ5Wk398C7zh77c8ozjBCVB9,FALSE,0,539915,539915,1
113m8cj4ERgQxoDvrdEFJE6Qng8tmZnbhb,FALSE,0,5476,5476,1
1143PuuXeB4ZmDVBhQewmXyzPf3fTxxrLw,FALSE,0,53375,53375,1
114kU55wiAPVRwHdK59FpXpnTdwJNTvGbN,FALSE,0,82769,82769,1
1147iXyJVzYdvZs9Aa85tmbMsf4xQSieFC,FALSE,0,17743,17743,1
113kqVLWvJv8n78C3PwbcchLs5YDEsssVd,FALSE,0,1055,1055,1
112xQXpKWSdqtAzPs1BMQtyjdyz1L5xCTL,FALSE,0,1000,1000,1
114mk6BpKTJRzn2bQVYiDP3xg6fmWs1dLo,FALSE,80811,80811,0,2
113qZonsVQQY6ajr5bvX5kHPhaRRPHhaas,FALSE,0,136836,136836,1
114wk1YB3ecmNDM55pxpn5m9Ke7f5vrhcT,FALSE,0,15143,15143,1
113LFGKaEn281WQomv8ZASXFWWT3t5r734,FALSE,0,592,592,1
113Ypt55puYKWivuCYmuBJACqfqzkix2eD,FALSE,0,30953,30953,1
1151cZD8NdDRgXjmm3Uc2nvgMQwqqJs8ro,FALSE,0,2000,2000,1
113C7P9KoF1tpBw4x63LpsJVd472dijcoH,FALSE,0,16487,16487,1
114GGnCEaavPBBTQugbf1zt3XfY6coKTBR,FALSE,0,7870,7870,1
113DyPJAA4aZYQVMwr46nqUCekQtKPiacY,FALSE,0,94400,94400,1
113SerjsBbq429a9mqC76tNaz7uaWfsm2m,FALSE,0,1035014,1035014,1
113xS96nk8fcRGxtsYWwBXU8R6Q7UQWHY1,FALSE,78749,78749,0,2
113BXm8YsSLJFWbDM46pZSoLUhKeJNdRzQ,FALSE,0,1245374,1245374,1
112wPuXj8bJS4PNBqRCKfhphVEr1Sr4LA4,FALSE,0,1000440,1000440,1
113aMf1yMAb7gv127ykxSLy4iJGVabWtZr,FALSE,0,1000440,1000440,1
114kwjpZbYJ5uzp9LEjm7npJPWpUkGqYKt,FALSE,0,594,594,1
113bXWuKoZhSnwuETmYBxGgNsn8sCc9N3W,FALSE,327000,327000,0,2
114sQWVEmcChScDY972EBCCbePBnnUDyga,FALSE,76539236,76737882,198646,79
113t24ySpvMBYSt1JSDMpW4yry2RGUEETw,FALSE,0,100000,100000,1
114iCA6U2Qm4GvZsCjoZBkTDBPg6EAjh9u,FALSE,0,17702,17702,4
113hqsmQG7qWRaLugGwugHraBfvQ6Tcejk,FALSE,0,50000,50000,1
1136RMXgi3KQfet4uAhYsdLSfbpJ2Efiph,FALSE,0,9729,9729,1
114nN5HcCUPR5aaaS9AbuMpveJ8jiX2HEV,FALSE,0,702,702,1
114NmfDQwpzpxeEkBrhAByA64GMn4RkVtD,FALSE,160000,161092,1092,10
113ieq8qUttvyrrwEqSUfzNgCTf74KxrDe,FALSE,563398,563398,0,2
1151RTiGC4EdRGtEBL8UrUyR6VLKYXV5wC,FALSE,336386,507984,171598,42
113icoSFtS1D7aDASLUWk9p55TTvYnTecD,FALSE,0,1000003,1000003,1
114KxuwpeaEESFgSCJJ2RsujNJiHBZuCgU,FALSE,0,190985,190985,1
114NMYWtu6xcnUd7i2rJK4WdZ4asXXCEHd,FALSE,70000,70546,546,4
113BcroTJCUEi5XpvUo6vbbF9iZUiM8mfd,FALSE,0,28687,28687,1
11533pYbbu5WWh4B6oLb367StWBfwqqnW9,FALSE,0,146195,146195,1
1138kafukv8J1hHWeUgQoFdjdpdM2v74YV,FALSE,0,165762,165762,1
113ghgemmf38QUUpbLgRv5M24WSQQRajXQ,FALSE,0,186187,186187,17
113DUqWEopk1Fs1B213y2esDqDBxNehe6H,FALSE,578792,600000,21208,2
112wAG7twu7f2uqMHBDCXSHZ5oh5Ad1sZ3,FALSE,0,10860,10860,2
113V5tZaRQzqTfzuQehkUVbNZPJnBvg8yi,FALSE,0,3116,3116,1
114XXWiX8wgofo6FDCko3NvderKt1E9AL8,FALSE,0,164032,164032,1
114tLLju5r8nXLt9ZgkkCbMbVfiv5C73FT,FALSE,0,180930,180930,1
1153ojqNxxYTBeMwZ8K35t889QahWmBHhg,FALSE,0,9833,9833,1
113Vf8zH5fmXHX83xy9Ek2AhXS9QwFahZh,FALSE,0,14690,14690,1
114DCgV253F7iUtBrSAQ6sR6a76AxeNGVT,FALSE,0,194684,194684,2
114BKqjLyFRrgJxZrsBh7amwQ8L7mqQ4Hv,FALSE,0,65684,65684,1
114fskoDQtjLojaRmo627dgMqhDXwaiyVh,FALSE,178649,178649,0,2
113CTtagcJbKv3Y78VxktA7PQeAjHTBPTp,FALSE,0,4000000,4000000,1
114M2oGdhSozwkcik4tAw5NN1DytcQ2Thd,FALSE,570026000,570126000,100000,22
113udADZRkR8xTPK3RTSKE3cQx27b86MWd,FALSE,0,5360,5360,1
113D7rRWpo1MLQWTgvsep9BYRmgWDsWHLG,FALSE,0,78750,78750,1
113pyMSEean351RxA98hMyQBUGVcThHuW4,FALSE,48616503,48617050,547,3
114ySrUunddEgjsxE6A3UuY7NhhNENj4nA,FALSE,0,9192,9192,1
113d2dCvzgdMpHDgfutoxAWsmSFaGC5HMv,FALSE,0,25592,25592,1
112wmTMVYgyoE9urdBArQt8bMc4GnB2fEJ,FALSE,0,3000,3000,1
113H4Hoa9P7ak47Du2EJrMye2rvBfUcsLJ,FALSE,0,2312,2312,1
11412ccFjhSbkvCas9JvYHWAcnkyXAbDvY,FALSE,0,684,684,1
114ABhnrHEMXEdgzN1VpbK7U3ueq3iqB6K,FALSE,0,20000000,20000000,2
112xSyVnDVXfVs1QzGJ9fUeVLUtE27cNVE,FALSE,0,699273,699273,1
113PZwsFuHWHzYQU1iwWsyoeKAyzj7zqWf,FALSE,0,1000,1000,1
114kLxPWV2a15HqhBLiVmgYCU2EGRhgLTG,FALSE,0,52978,52978,1
113pgM77wz1zbTq9M7gp4DhkXteMbogYW8,FALSE,0,870622,870622,2
114s4uTFTKrsejBohMXAgPTDdxeg3ZLb9k,FALSE,0,302929,302929,1
114kfnvqAeYW9sdQrUJtik5QPq7fuwH5Nj,FALSE,13000,19000,6000,4
114VznHPo3dmu8ZRrAmMLCfzgXtKNuQmQP,FALSE,0,572,572,1
114pkcKx2cDtuao5rp6AXNijSw73iRnwge,FALSE,0,1607378,1607378,1
1147DEdruSpd3shEPYWWLUMWDkVkQ6nnvm,FALSE,0,493486,493486,1
114kFUipSEd6wFtrqQ5dLfN8fGhwsf96Yw,FALSE,0,72880,72880,1
114t6SqvcJa2reSu9hUKtCrk4VNa33vYRA,FALSE,2000000,2000000,0,2
114xXKB5QMQBc8UKbdawK6aNisg6oAGp9h,FALSE,0,180553,180553,8
114Rg1gg3kf9ghjHeZTzoK5ikaR1sKkKdP,FALSE,250376,250376,0,2
114ne6pk8zE31CMh77u1S6obgZegWWijhk,FALSE,0,58500,58500,1
11481cXtrYdSc6PHZ8P2FmD372XDhgoxqU,FALSE,8642903,9449573,806670,27
113XnycaGehmEsRruyB6fqngWAbNn4oBd7,FALSE,0,940000,940000,1
113NJuXdK5Eyt513VByzgD2ShuJB2F9erJ,FALSE,40000,50000,10000,3
113D3ngZKURKEvxKuaMsfG3fNnb1Z4u2L2,FALSE,3045334952,3048601607,3266655,27
113Vfcgbw69XSAKZxKApsvsaPXczNGwhxM,FALSE,0,220800,220800,1
114peq9eeawx2zqSWi5pz3von8gv7MzXxZ,FALSE,0,10000,10000,1
114MdbGuhiGbNa16MJLWYZiw6XokiUcXK4,FALSE,43120,50000,6880,5
114oqnx6JXawGGEynhRHKSpiYrfCphkfov,FALSE,0,623152,623152,1
113MbpGMCreeYg2nenAhuXjhSFnk1byQr5,FALSE,0,5515,5515,1
114AmbmR76wo6Y6iMVGSc34aUMfisMYQMR,FALSE,0,20601,20601,1
112xExAx5Q6cGrAKY1hKjuwsnyx6RiLEPL,FALSE,531978248,532050000,71752,4
114AHvksCCupWRsdtxoETMGbcHi53KDZfT,FALSE,0,3000,3000,1
114Ba84JSedjLz7u14oydT1egThD7jTs28,FALSE,4145984,4976457,830473,193
113AcyvDj2UVdGnNYA1yoU3nP5X6tDSTa8,FALSE,0,5430,5430,1
113CuKtpoyuVUx8MqL1FwtB2qmPxfei7HW,FALSE,0,3000,3000,1
113aEVmYDqo3hxPEMNeYR5JnAbTYBMSdwX,FALSE,0,235999,235999,1
113wqMvGv4zB4FiHyGjg1NsJmVpCKJ45WY,FALSE,16889000,17000000,111000,4
112xoHFRSK2Dn2kBVE6545ahcB9p7hGdKq,FALSE,0,931,931,1
1155F9xQRsQWs5v4XwYyR78si9y5zLPWzy,FALSE,375548,375548,0,2
114wbanritchev5HzwqN45Vw2KopEEjEvr,FALSE,0,1416884,1416884,1
11335fwaEns6RycmjEvSf4HBi1mMycJZm6,FALSE,0,90501976,90501976,2
114QDmarvAD95W38TPzFZXx8hy5nm2sbQQ,FALSE,0,500165677,500165677,1
114TUS2YF7uGJWZSrgrvAaTGthGSms6xHE,FALSE,2413429,5596800,3183371,3
114L5giYFtymhyYK4pBDB18TWqJMFeWuXo,FALSE,0,91127985,91127985,1
114PHdCVgvkRtgFFHs6d1gV4WyBPXx8HLk,FALSE,0,630,630,1
114pQGxESviCvNz6ias8CpTsgMAp1ibLkE,FALSE,0,3596,3596,1
114ywfmG2cM51SjPzrnnLmz5A5X2b8eDJ2,FALSE,0,221593,221593,1
113pTxfo2aa9jz4Z9wofokD5zdXdP8CpoW,FALSE,0,4691,4691,1
113G6x7t3ofWLnBNhE8ZW51afTnWyEVwAA,FALSE,0,2046,2046,1
112yqHaxDCemgFYeDn6xE3JCKrmtFyvctG,FALSE,829000,1448000,619000,2
113bpMHDPQQjD88suSKussJsY1SyY5EdaY,FALSE,0,5740,5740,2
114eoGvUXZcUFsAQFD77KvaWLhS3rxMeqz,FALSE,0,337910,337910,1
113NBc2B8vc6MsmWGvC5L2ktviGKd8yhNW,FALSE,0,41997,41997,12
114uGRZuqstdikU1XAZ1RP4vbqvVrx6xJc,FALSE,0,5586,5586,1
114wRGnk34ZzMRvpyQv23eH4vEBuodsm6M,FALSE,0,350000,350000,1
112zn3cQTQTJw7qGAHDTm7M8wdqLPJrpvR,FALSE,0,2738,2738,1
113AFSzS8UQ5Q1p4VCeVtgtLBAWKqWG6Sk,FALSE,0,45996,45996,5
112xQkARjWN6CUGx6cLPSCFj2ctFPWfbUM,FALSE,0,22387,22387,1
1138aYtVrrmhKohTW6pxgAJXcPjHSauWya,FALSE,0,48903,48903,5
114iRrmJKeLXDFvSRh9v3psziSwZBAH8vb,FALSE,0,16326,16326,1
113vyGLsydLSQ5kU3tLKcibJUtM3nc7X7D,FALSE,0,14585,14585,1
114G8hRMFB3j1cXMTZpnRUjBVv3CDE6yKu,FALSE,0,48957,48957,5
114zx81p3GVFf78yceEQJP3bv637EpmEb8,FALSE,0,79000,79000,5
114zABoKDnEhkNKYQ6xBWwDVddng958zyK,FALSE,34542,35634,1092,6
114dwJQPowrdLMtoQJHYjcbU82s9wVbHog,FALSE,0,259725,259725,1
113HUvuyk2qPZZX6WzgsWjjxDdk7aEuiYK,FALSE,0,2511691,2511691,1
113rQ6ddJLczEb7g2XnEFLKsPyZLzDWeCX,FALSE,0,2137521,2137521,14
113F3525dPKhBRfmaDNEcUo3UpGnKEAcn8,FALSE,0,3632,3632,1
114Ki48KKdm3gcC8QG36bFKcYiGjCzd3Xr,FALSE,0,5000,5000,1
113p4MUXqm5zwhaNQ85csHPHBvYqKKScbL,FALSE,1924477622,1924477622,0,137
114RSK3qaUA5e8VPC3GgHvDM2qSfcnNKrp,FALSE,36561909,36591604,29695,662
113JN2WVo89RKRmKVgYA9j1fxkLC39KGF2,FALSE,0,1500000000,1500000000,3
114ouAYWBCAYFpbNkLvC6jCJmbK9RoNsJj,FALSE,0,290280,290280,1
114jtCSUeRX8opmPiPUDewp2YhNTywD4xs,FALSE,0,912,912,1
1138JjBNhwH44VCHgRkUYeDpiZwC1tJhGx,FALSE,0,5460,5460,1
114qos1angnaAQUs6j53HSq9gTqkSyggHL,FALSE,0,21480,21480,6
114WK7mXJYJJRwsRwGJqHznx3cehPPuJP7,FALSE,0,8706,8706,1
113j7DspnPtZDc9XT7UQbjQ6Qf2QKTwLCu,FALSE,0,1705915,1705915,1
113X5BQ5fV538xD77ykByWBS5oYm8PBTru,FALSE,0,100050000,100050000,1
114icgTVL1UNp8xbYJrh9DeYuTuS8LezG4,FALSE,625803853,625804853,1000,11
1147bXPcPFAofEGEdXRqVMLjjEp4qVK36a,FALSE,0,601337,601337,1
114RSCcsTPijATcjcHv8dP2sF2YVCRZVqZ,FALSE,0,861000,861000,1
114htZ1BbNGYfkWZAUfgCThrH7fZwdRZmr,FALSE,0,406811,406811,1
113fAPYCmkU7y94GSKNxYabH5mUnD8odL3,FALSE,0,47427000,47427000,1
114zcn17zLP6s5TTbW5AR3U52SwdMwhhNE,FALSE,187626,187626,0,2
114ZrFGPUoXMpzB2YzUqeTg4Ze1sMxK4qM,FALSE,0,1043,1043,1
113ZbiVZY4GvUvffdFcgvuVHuKbBTQWsZZ,FALSE,7460108,7464653,4545,45
113j7VLMYW7KaUWCmiKTiEwjmhXzBMdBZk,FALSE,0,1000900,1000900,1
11388BHsqCwgkEVdZfxAhx7omqRoFhFyX4,FALSE,0,2461,2461,1
1145pk3B8eNgiNT7JT6G3wAaRUnxpJrBKE,FALSE,0,5000,5000,2
112zemgYWAQyE9YqdSdUuGr1RtKv3TVaup,FALSE,0,3904,3904,1
114pbqLoBqcKQYQDzgmy9k78yApipVR4aK,FALSE,0,15276,15276,1
113ato4s9UaXWaKYGjJeRB7D5ANucGz8Re,FALSE,0,2151,2151,1
114ePodXAmQQX9oJcAAuGaM8qcAy3Br5kK,FALSE,0,105463,105463,1
114684MJMzi8jMR6vfDEp3KFQrv83PfZBJ,FALSE,51003848,51003849,1,5
113JA6M8CVSpVLPTpMZCV1nNVEiyCmLJ6E,FALSE,100000,110000,10000,3
1138TLkVy8Mja3V1FbWgDjxGBoqUWGx6iQ,FALSE,0,100000,100000,1
113E8wmyDkQW99ZRYb118mqqCRUGrVMANH,FALSE,0,613900,613900,1
113CGWGFDuoqNv9RRL8p9iCxABLo2PjTEg,FALSE,0,616949,616949,1
113Y6gQRDGUJQWbMitKaNFjPWtEYZJFFeA,FALSE,391848351,392018113,169762,39
1168hj5VXfFigRBvKksrCUSBpAuSquMvT9,FALSE,0,571294,571294,1
115D4uPTu7eDdgh8Yih6xQdxKw1KLzuCjF,FALSE,0,280483,280483,1
115QfQxGuqrcUnxauGnutMCinjgc17mmSG,FALSE,3911167,3911167,0,3
115AKRK6QXXSLMadHqqZJAkrQN8ZRfzgot,FALSE,3659728,3659728,0,2
115887en6FgvVwBtfwe5iaK3ANh74GnsZo,FALSE,0,2500,2500,1
11A4eQeWrdeLWkJVWhAfpxeYnMnTy7pU9,FALSE,0,672741,672741,1
11FYxFtxVs7emgmjG7q2HtdbE7zsUE9iF,FALSE,0,138276,138276,1
116EZupfEyn1c6KQ7ZRtwxoTeMT8aHcq7D,FALSE,410000,1230000,820000,3
11dRVPeaR2oE4z7PRFN41SWwADtocMSYJ,FALSE,4686792,4850603,163811,21
11KTUw5335dUL3ZJtHBZVcx3B38hdbC73,FALSE,23929,34590,10661,4
116GwvFupwppQgMLEeiiQF2UzyQhxq7LCS,FALSE,10141368,10141368,0,20
1164Cwhcu4RQWwwGxSmQQ3Q89WT8iQPYXz,FALSE,0,185981,185981,1
11Skexsf4scMs5QoTkpv6YopBfRxhy2nV,FALSE,0,1784,1784,1
11671hKdxaAEFYicMM2PgDMsYdgwdQ1e4L,FALSE,0,546,546,1
115hEco8RrUvRgJG3gyz1gS94393VV4HZL,FALSE,0,1148751,1148751,1
11AfutFiqdbGY9BxfDGxrCGk9WaSZQh4E,FALSE,0,5810,5810,1
1169ZEpDntJKktoL2taQzbkXa6E9SbENMd,FALSE,0,7415,7415,1
115MivH6BeW1sVzVThxdRvsZg1VZw4Prfa,FALSE,21010000,21050000,40000,2
11CvGhrWGpoe9As5S8bZnYywSH8LaubKm,FALSE,0,1070,1070,1
11nzFiwaqmJEgscq8n8Bi6jsVDSomouEf,FALSE,0,1001348,1001348,1
118HyfsNiNPXSAmGKwGFcqL3zAxsSNKMV,FALSE,0,954616,954616,1
115fegbsWLyPR2YPu6hRF7QgKGv2aYybTW,FALSE,0,214946,214946,1
1164kUEHdza1LyA23Ak4qff5M7vJ67reh1,FALSE,0,552,552,1
11bcjW6hRctYTJD2EyxZZb3D7ML85c5XB,FALSE,19000000,19000000,0,6
115WHVs2HWXahjDynoE7WbaUUWm9yEdWkW,FALSE,5139344629,5139355166,10537,289
11Xi66hzbXU74Uwofps8bseqNRpatpg9E,FALSE,0,1022,1022,1
115uxD6YbBtKvQ5xJPrkEMuVuq1Wx2dg34,FALSE,0,1000,1000,1
11GxczAXfYBAKNCzqt5p2hDvSkt5GhFja,FALSE,0,30570,30570,1
11jRvT3t8nCwWDAUKA7rpF5fGKQLcEwwE,FALSE,0,580622,580622,1
11MTyd71N4ZmrmejaeL9MQEpZAzhfioJF,FALSE,45414,78360,32946,6
115vH4EqmrvpR1wSJox4GFf7ULCKquLr9r,FALSE,80000,80546,546,6
11EmgVicZRwczwsw2YmkGaRrHgtwY2rNE,FALSE,0,1,1,1
115W4boy3BLQzvEcQ2CjVXjo3jF4HTRcgv,FALSE,0,1371929,1371929,2
11pmvDxS3bUGAttUQ7BSCUJ9jk93h2sPR,FALSE,645137,645137,0,4
1195xxsgZtSn2XrWdAANzwrw8jvtGY6is,FALSE,0,1,1,1
117t86qiZJTZFbJsxofb1ttfTz7HVfSPt,FALSE,0,1,1,1
11vUqt4qUM9h39TCktrW3JU4ygEovFYaq,FALSE,0,100,100,1
115MQeFKEEywdUVntmhLodJLtXAzRha1xV,FALSE,0,320000,320000,1
115Gsjmphoh8CRQtZEN5UvubFeZnaMc4K3,FALSE,276028,276028,0,2
115TXM9atci6zJMFSqoFg4n4H82GASHiQx,FALSE,40000,45000,5000,3
11cZSdohQZbtaH6ULYWCqBo7xv53jyBpq,FALSE,0,761958,761958,1
115hnYbtHQXLW9L6JXF6yx6nqGQEEXxPEa,FALSE,0,428214,428214,1
115Hww4aAzcbbHMnfKn6pqa8Yvx5dfo4F6,FALSE,6846,7392,546,3
115KtWoTsoAwBqo2JKDGxAoLmXytAXUJX7,FALSE,362966,403915,40949,13
11o9Pxcrr9QaE8hwsKGWgua7kRgjaGrfk,FALSE,0,927,927,1
115CqEQnhnT6Qtz3SfchrYVwqdBEEHWTtu,FALSE,0,4768897,4768897,1
115n28XxJHUUTyrSZCRbSuEjLTS2HrLvtK,FALSE,0,297740,297740,1
11RT8ANsbAsXmtdWPRcTuZKLeUP4PhNkt,FALSE,69783,502730,432947,9
11g4XpgHKhXDhCynAPmhAZPzW7SydGzRk,FALSE,0,10000,10000,1
116BotGxhidv9riUxdLYDMhWPRq5rycqoV,FALSE,0,1000,1000,1
11669rJsAWFAez67VoHCbpasRbp295YrEv,FALSE,0,2029334,2029334,28
115uL2xVMiWSFaiwNWnXKtDVvqJ5amNMBv,FALSE,546,1392,846,3
115QnE51M7WkRQB6qnhJn9cum2r68nBAxr,FALSE,591948,592495,547,3
117xHQ2HrvRKbwXoFkxho6xnC8PgcoySw,FALSE,37380660,37399224,18564,78
116CdSmA8JtCypHrYL9iYeo4K2Yd76V81q,FALSE,0,746,746,1
11oo7St6Uzwq4rGFqGzCTdmaPJQStYoap,FALSE,0,5500,5500,1
1195fJxTH1m5umeJ5NeevkYjvRSECAr9M,FALSE,0,2568,2568,1
115jmgrTQ2wMyeFN6At313YsEcjQvjg3tP,FALSE,0,5294500,5294500,1
115BRNzdrbbijyJY1MSgF3i8WfSjGMvgpP,FALSE,0,11949,11949,1
1166oTVZd4ox7LbBKScoWTRPc5E8Vmze5J,FALSE,0,199298,199298,1
11572Zn3YGSogteWJTpkMDeq7HFL7mk27N,FALSE,0,33131,33131,1
115JVxLxLoteK8A7BCGR4WMjFgfhi45pd4,FALSE,0,2815240,2815240,1
1156Xx2BPhGuU7XeQJPXxCLEXgHv3WiSsG,FALSE,1104515758,1104523500,7742,91
118U3mNepqi3LnKdBugr7QpZeoDQBNvyX,FALSE,0,178896,178896,1
115T8gak7EVkdkxEYVGr4SJffJXUSMES9X,FALSE,594026,600526,6500,5
11iW53up1JUwwtPDLV1QuAbo9ZCKSjiVZ,FALSE,0,3283203,3283203,4
1187iCxp3jwBCvYxcMrm2U8a9sAgKbbV5,FALSE,0,30271,30271,1
116DgHQGz6ruxtm2U6akcZ28bcsa4R2waH,FALSE,0,6999,6999,1
1165WH8MMMUz63kj5BDRrZAwphFX1FNhcK,FALSE,0,125035,125035,1
115z8JvVMh2uLh748z68Ag1aJPnj47CaTQ,FALSE,0,721246,721246,1
11ZHrF35hgfENkAtXA5MXaBXHx84DD2LX,FALSE,0,143687,143687,1
115LFK6ZwwQK2s62gXCCGgy3nW66bZJfJn,FALSE,409464,796598,387134,184
115D2SGh5SA5nPUtZbXQScKUVFQiLFjXSH,FALSE,0,10957,10957,1
11ourExperimentsAreToBeXXXXd2393y,FALSE,0,1,1,1
11ozn3nb1rJ3bhnqikBnjPyMgfZJvmywX,FALSE,11930518,12011516,80998,35
11Z4B9CRRQGz9QrGNxXsaCjPEFq68cFbd,FALSE,16715965,16715966,1,3
115CUHXHrJhnnjuHhNGqzzp5czx8kUmtQK,FALSE,0,330094,330094,1
11kVCjGer8Vwum4kte2s892yMNqQHcX5i,FALSE,0,5310,5310,1
11ZLrMk8wAPDfSKJSQqbtCKKoezBixzDs,FALSE,0,3781,3781,1
1158jTyWZgBXUdNcEqSAdgkQCD85P3cb1Y,FALSE,0,5500,5500,1
118a4KAoQpN57ECaKqgt7sfaEKbjkksP7,FALSE,0,6425,6425,1
11UywtAn6xsxdscrpBYLZ1B2RX5ui9zeD,FALSE,65851600,65871600,20000,22
11Y217e2UTnzmvM54Av4oN9vQtAu5bdJh,FALSE,0,5480,5480,1
116LVbAbyZUj9cQr5ePyYyXoYLg9yMpN4,FALSE,0,5095,5095,1
115Ame2hkBb1EXJEpWnsi47CczmzZqENfB,FALSE,0,1000,1000,1
115j8Ua9yRRmjo98VkBx3YnimRDL7B7MZv,FALSE,0,33142,33142,1
11poa49sAbBESTWpNcuZyTSbunTQcgMuV,FALSE,0,7509100,7509100,1
11g4zEmtXgyPNu2gF2B1hvdij2auBG7uD,FALSE,0,1,1,1
115EiAtx4ry2nCjCugM6H4nKPJwLGbVnzS,FALSE,217813,217813,0,2
11XBkiUSNeLauqKa6n3Zry1vv6o34j1gi,FALSE,0,4441,4441,1
115pyYptoe2ghy3YPiN9rNSPAsMzHGLPS9,FALSE,0,9000,9000,3
11561QYmYfUi7MS4nKYfa4PHiYtJPVd8Ms,FALSE,29750000,38362500,8612500,40
11cxqFkNARCjoPDVSwhU6ownzjr2D8HDj,FALSE,0,284521,284521,1
11HZjRrsNRAYKoj88HU39mTSjxugjSm25,FALSE,1043609,1043609,0,2
1158orczUARCMiBXNHDK7YkzKw5VVZnp4H,FALSE,0,1000,1000,1
116711psgXXXA1smz2nhAaRyhqZd5r85jz,FALSE,13518218,13518219,1,5
1157rGtGyd9kKdMzZj6pjj4WqN6GE5tsvn,FALSE,1558787,1558788,1,3
115JriHHA2L6Nh9EcVpPDpuikXgDZug9Dn,FALSE,0,6068,6068,1
115jPi213cizgP9gXt98RgmtTiECf1sWuJ,FALSE,0,52021653,52021653,2
115meBUW34zM3XQGTiKZnVRfmxWErJtgnY,FALSE,200000,253100,53100,12
115hvcVZppse2gusEfGfCmP7AdYUS2VkUb,FALSE,0,14648,14648,1
11w3nVjexPFwa7j9pUnctKwkeyZeJ9qea,FALSE,0,520000,520000,3
115smtoYVGJXQWRrFYac45gHeWmNNjy2Jx,FALSE,0,11383,11383,2
11kuQwJr87ojDyTM5wtcAu25TrFTNZG7q,FALSE,40945,40945,0,2
11cQpBvSECKmEePYBHgAfLA116ge46gs9,FALSE,0,430603,430603,1
115Pd5cjFZTNtME6nEkTRHNcvpuNEXAvPj,FALSE,20080,20080,0,2
11qAT8iTM9kPXn9MQV9HEueBcNX1qccVV,FALSE,0,605,605,1
115pYmc5AQ8Ev4f9wooZiSdU81oNbtgDTC,FALSE,0,452335,452335,1
115ekbYJKQQNc9JBAjUZmM6Pum5KvvsLJc,FALSE,18000,25000,7000,6
11d794T5hPTjtAFtiFsvNpNxwCCKxNPdy,FALSE,0,291632,291632,1
11S2cVdK6hEeTxQcJQnNuLyTd5cbHhePn,FALSE,4667343,4667343,0,2
115DmBP1JdGjmv88keS2WeVxQiWWFbQJpc,FALSE,0,25000,25000,1
11FUEbo57LpBXCeJEsKDTnjkcfhbWha6n,FALSE,0,840000,840000,1
115F95jBg2WR2q3rQVnXUVdrGUzDGgao2K,FALSE,84706,152312,67606,6
11CoekCtEz92wc8yXsu7iRytuUn5y7CjJ,FALSE,0,100000,100000,2
1158khKj8PedZtf2Gt9qaX2sjnyPd4rBXi,FALSE,0,568,568,1
11jYvdEZjo2oBF45bwdxGZWnpiTtbgF3E,FALSE,153247,171968,18721,12
115TypuQKbpqqQ4awX6Bhjy64x9FruXmpX,FALSE,0,5500,5500,1
115Wamz9Yb9cL1i8cmNZ883vFFZxixNcQK,FALSE,770000,770000,0,2
11FghyFmiZHJ5RiV28qLK31mgEFiXsH7r,FALSE,457223,457223,0,2
11QcVjhHyxi6Cvxuh1FLiDT9sqi5rwHAw,FALSE,1319063,1326330,7267,6
115k8PRN6rqzHMaPVKi8Cyk8bc1vYzWvK6,FALSE,0,2551112,2551112,1
115E3j4PzpzogpD13P63owAcBivbXdF88C,FALSE,598000,698856,100856,7
11ZuXWmnXHumnrBS7Fr7JVWW3T9QDRxJS,FALSE,0,3000,3000,1
11wa5CsA2nTFxFxTBtpgncjUzPoVEaZNw,FALSE,37047054,137158210,100111156,7
11pdo62HmqszXAqm7KgQ6Qr7inRFBRZT9,FALSE,0,235466,235466,1
11URRLEerMtxk6Rh6DyUtGYuiQYfv2Xdk,FALSE,9934,9934,0,2
1169gstunRafbVbChsxPvtyLLtx73uaFHw,FALSE,125826,125826,0,2
11MathematicsDeve1opedThereax6W5a,FALSE,0,1,1,1
115tuKu2fMvx4urkz7f4ubbqRTgufwcjBq,FALSE,546,1092,546,2
115GsTRjBynRVbuRDQ3x1XsneCNK2rRqMx,FALSE,8916,8916,0,2
115VyWG8T3kptEfCPNCBDAWbypDdMxckXf,FALSE,134000,10814301,10680301,2
116GZK3vYD2xWUEGYZdohV1ji9jTu7Vtdx,FALSE,0,2500,2500,1
1161R6VHzeZba8UD9kP8Zo83qffTamBCFT,FALSE,0,37127,37127,1
115qSm7iYkykgq7iLgqK1eYU2qpxRABDmx,FALSE,0,185000,185000,1
11D1wk5HS8TX9cCAxNtkWws4h5Nrmgk1B,FALSE,0,200000,200000,1
11MJQps1is139eRfsRkPhA5tw6p121EZW,FALSE,11352927,11352927,0,2
11CVEe4JbKXi3uTFuBB3D71mSzJ6pTLmn,FALSE,0,5064,5064,1
1156yqmiFQjiSKYjsQzpBuswT2G3vuYuHa,FALSE,0,229787,229787,1
11g6Q5LAfJmKwasvnu7R9tg4eZDgr1foP,FALSE,0,267324,267324,1
115D4S2R7jobN1Tv5nysh5pDGuKaTyQokd,FALSE,0,1091833,1091833,2
115o2SjLGd7vpB94ZZZ3iw2Tcz2C6QpbLq,FALSE,0,2222289,2222289,1
115GRj6fuyfiG3qHdp3oVGNssuKYCvkAoz,FALSE,0,326651,326651,1
11n1Kvq9r2EMQ9nUYzLVSqQDVSU1QrCZ6,FALSE,0,22048,22048,1
115jYxybJxqKHN3v47xjXD1ivqAzw8a8Ak,FALSE,0,2245,2245,1
115DY9NtCAAFoGWjkq3EGUP3rkjeN1Gr9W,FALSE,52624860,52903663,278803,6
115dGGJzUpajWmoSWTegHyEw7ynJZt4qmM,FALSE,0,4330,4330,1
11NugbFmNtYHAsuArrAxScwtL1v4iuPWX,FALSE,80540,80540,0,2
11npMDjL4N6ZXrjm2Eq5EqGMpNu15ZmZ9,FALSE,2156460,2156460,0,2
115owq5HzuztjwSuLGUkx7Wk5RoeQowYQ5,FALSE,57331,57331,0,2
1155xhrDvz9tJM1ujWgkkpVQMxpTjrLahH,FALSE,0,908511,908511,1
115dppUdpVgLorV2KbmhLduSn9qfqppZQg,FALSE,50000000,50000000,0,2
115EnbdYM3Qbfh3HhcFssR7h3EnQSLdcLN,FALSE,0,73423,73423,2
116izdBs3cxwLHmX5TGHqn6iWVYTDVT9A,FALSE,0,10000,10000,1
115qbgiF4mBiMcL4wPjEGgHNHU81TXifPB,FALSE,0,5365,5365,1
11urUowB5GcKrPx1vCAZL6jrKm3CrD25u,FALSE,0,100000,100000,1
1158NVCicakyrqaAUe2qao5Vfu2Cnni6L2,FALSE,0,5480,5480,1
11VSvdKrsKfdqpzhoGvohgE7Qg7gqZkDy,FALSE,0,253284576,253284576,1
116mqcMbJMJboZd6eyDgpTi4YvzG6J5it,FALSE,0,1292,1292,1
116G7SQjQyGS8SCGMsz1tVtc5ZFeAyug93,FALSE,0,11508,11508,1
115BMoVE6MNLPqqzhM1YzPX5qia6bZLF2a,FALSE,0,19848,19848,1
11kgYXyZGbv4vBqVwWY8YYjk9xcQ7o1WQ,FALSE,0,11027,11027,1
11Vtm1sUx5Mkdvm55PoqtLfu5CFYUY2g3,FALSE,0,1073292,1073292,1
115nT8bipEkkscR8aEP1bxCwEdoy1EfWRn,FALSE,0,2500,2500,1
115LJSf7MXYeVLfxrbcFox8TaBsM7VBEfC,FALSE,14665,14665,0,2
11SZdC9iL2ZB41QAHHLpL9yMdvpu3HNoc,FALSE,0,2000000,2000000,1
1169tsAt6DViXn4LwZvrYvcGteWeZsv5pZ,FALSE,0,100000000,100000000,1
115cC994qunbFLSBBvrg6bMG9nLtUGPAJS,FALSE,277648839,277649931,1092,25
1155wYPZzfhHHteB6Ct9pJXorNwUitrUCm,FALSE,0,39166,39166,2
11joDjPe18rj6iHUTuvudpSV4yx9xNhYJ,FALSE,0,36770894,36770894,30
116DtQs4QMmSrZxb2kxnDMgY7xhEY62v2L,FALSE,0,197400,197400,1
115i14u9zEMXdFagzHfJLRgubqAVR2kxgM,FALSE,6034,6034,0,2
115ncZ8xvG2UNGc1FTTaw9jvUaigh2oSmx,FALSE,0,10700,10700,1
115kfxpoSGFcDd275qraBhti2Gu29NGyW1,FALSE,0,10015,10015,1
115tDAn5dawWnj6BShbZFeqkerQqg3d13c,FALSE,0,17338,17338,1
1166pNJgnV9FJr2cReBmurdfgXK4mWwmKh,FALSE,0,1417,1417,1
115AGfHcPzhmNRhXNUEsHituT48Qmxg3cB,FALSE,0,275804,275804,1
11SV7scCQWwb6ZayGED23TKB8sq7nb2HW,FALSE,0,1779,1779,1
11uhoYp7Lw1GYHDnGFYcDS75NkGmD6kV3,FALSE,0,9726,9726,1
115faDLvdGomRmAbg9ro8rnv4q65pd6fR2,FALSE,0,5430,5430,1
115cvDwaew3wwxLgPWtoSvKyp8TVQ4NbNb,FALSE,500000,500000,0,2
115yC9Ajq7mwp4iahZSnHHvSW5GBRAghCR,FALSE,13610,32184,18574,9
11F3H5W2s4HJG8k4EF7V6oGZxGCwbaKaW,FALSE,13814,13814,0,2
11BPGsjiLjLPeTvGVAhVsBRq2GvMP1NA7,FALSE,0,3600,3600,3
11XGbdtt6d5TEv8UevGbuofv2P7tZYib9,FALSE,84149,84149,0,2
115Po1fDcxhVz61nPT1UCBXVg915sYcz53,FALSE,0,2500,2500,1
115ggTb7U5JqtM8FunCymPwwNhv3o1i9EW,FALSE,42607,505460,462853,4
115Reo5xV8M1q9iFBZuNSmnmhiXDzUT9o9,FALSE,9534361,11086650,1552289,3
115cvzhuHsQcqYEcPumpFxTmUx7vXvnxQN,FALSE,0,388274,388274,1
11LacusornareDictumVo1utpatXq9xHL,FALSE,0,2,2,1
115ghZ3yLb9hXmsqY6qux3n5NH1XpABVka,FALSE,0,5990499,5990499,2
11qZ2TR2TM5iwWirn2UGpNrxpMUVe5HM4,FALSE,0,3320780,3320780,1
115Zf7oFtz7pVG5BcReNhVYbuyo4ow4p67,FALSE,0,711,711,1
1167BGhvAku99QxSQUE5BDbfpPPzkoYzc,FALSE,0,56374000,56374000,1
115rAucB2D2MGPbUBFH1WE7LDtEHRnBybu,FALSE,4195696,4238979,43283,23
11Vp5qstSSzoUHVwdmkg9nFEKJA2bo9WW,FALSE,552933,580637,27704,5
117La6yotpgrn5ZdcK8jztp2LxBtVbHn1,FALSE,46357989,46380406,22417,89
115RuYrPxyj1GB43NyzMkFVKo9Lem7BGnd,FALSE,90217,167143,76926,15
11DependingonTheRangeofXXXXWRJjmH,FALSE,0,1,1,1
115EtnFhFekShRHYt6TdqZsH88qQoePzB4,FALSE,5091,5091,0,2
11oWeyReGNWrn32NmQwiRQnF41YtYYtow,FALSE,0,612070,612070,1
115QePCKSbYCWD6A9y6PXazywKocajcwaV,FALSE,0,6000,6000,1
11BAvckxHSb9qPg793bhAdmoSCEyAyhuF,FALSE,73905392,73905938,546,7
1157mWmj8jtLUdwHD5Wq666XEBPB9xTr8W,FALSE,0,546,546,1
115o9gLpsicNHxbN2jVQ2o5KvcH1Te7EiA,FALSE,5662400,6500000,837600,2
11t3ABLZ5hhKg7vmKA3aGJV2BnJVtTL4L,FALSE,3715561,3935227,219666,9
115H9xZoaqmnz2PqL8wwBDQgLHo9XcDmVr,FALSE,205094,205094,0,2
11m1fjZsPBtCaqMgRTMoFnNqFsCrwY5Eg,FALSE,0,15020,15020,1
115oqpqxw4Mi3AfVY27u4iqqKh98mjocXb,FALSE,546,1092,546,3
11R4SqRBWUcmf28h1HpP7dXaNexZS4U79,FALSE,0,1,1,1
11qgNcWsvmgGQKrwmNvJjp3F6N193Cf2H,FALSE,0,5480,5480,1
11UnsignedTypesCanon1yXXXXXat8otd,FALSE,0,1,1,1
115itDsU4HVSYh4cjqcx6ePpgpBpr9dCzU,FALSE,0,67713,67713,3
11GrMe85sdPHCNVoJftqNTJazCxwaL2v5,FALSE,1887486,2809325,921839,10
11eLbkBdAQPN5LtkbcdXFRMoLJfrKtt7s,FALSE,0,150000,150000,1
11w9wxk8fBZZYDWjciBUroBzvovWk71dY,FALSE,0,912,912,1
11DQsWSwiRjq5deVxxoFtr3okKC9h9h1W,FALSE,0,5710,5710,1
11iPpucWmV9RuXXo6XhFkrXkkLDegPHWc,FALSE,0,1,1,1
115qG8mqeaT8xiKUe15eVeVYncMHPNEuBw,FALSE,0,5180,5180,1
11pfD1D14WtGWKmu5d7XHkU4S384aHUCH,FALSE,0,546,546,1
11Exks5cnsUuMmJCERtVstNQiBhXfXrcj,FALSE,0,1,1,1
115DcwsxuWEonq3gGnHdgcybAwz16DPHR4,FALSE,0,546,546,1
11i9XKzywim3Xxz5MaCJXhSZkpdYHL9U1,FALSE,82565,82565,0,2
11639adPupKanTuNQJ5eEELzfZ5RRh8cwN,FALSE,0,1632,1632,1
11w5igE1SfrTbx1jKuEDbqtpNbqmVnCxc,FALSE,0,1000,1000,1
11BDWoDbrmvxBi7EZrReX9w76UYscNzLy,FALSE,0,2300,2300,1
11N9D8FP7SfTCvotQGmgsgpXKBCfsBrBn,FALSE,0,398409,398409,1
11RTbGti9y6d2163KVq6PpyqBEGGPb215,FALSE,0,40000,40000,1
11wstvT9HdzSwhH6Dp92y8URBMhaWF8q1,FALSE,2782,11490,8708,2
115wUgCkpDZkeeBdhPQyP4B98cC1LbZZDi,FALSE,1016,1016,0,2
11GTXWdgRR7tRxiG5ZMBADLeq8YqcCrCW,FALSE,0,571129,571129,1
116HeEQbET5TpiNeqUdJQww6VQVa4h9brT,FALSE,0,67494,67494,1
11HcroDmy6FBaAVMMdhcz7jAuJiXHGBwS,FALSE,1030766,1030766,0,2
11FsfhQt4H2v6nzQE2mBthuMTyLrmBksU,FALSE,0,12866,12866,1
115ifbB8EW1bFKvViwpznH6ryLEHb3M6bE,FALSE,48052943,48052943,0,40
115kFedE7g7mHbQiyD3xTuVfDpvzxj659P,FALSE,0,431423,431423,1
11Debonairesorigina11yTheXXXh9Gxo,FALSE,0,1,1,1
11wFwtVwZh4PTQ42j2stmhX39U7aoja6a,FALSE,0,5139,5139,1
11ia4j5GqXtE1sXVnePx9dZDHMzBr1g2y,FALSE,4797900,4797900,0,2
1161Wezo7P9s2kMr3yrJBJH2syWheXDJ57,FALSE,10088321,10327632,239311,4
115VAvtzudzxnxgXrjaHFuRQaUzft652vn,FALSE,0,15602,15602,1
11wq3NgzwFo2wGbkfNVnP63qY7jyGbETR,FALSE,0,4266926,4266926,1
11pdshh75pho5JjbMmdveKeDZfuWiLQSG,FALSE,1052000,1052000,0,2
115UnGRDFFhpnR42YhjT1CWrxYEnyn8dGe,FALSE,0,1595,1595,1
11tGw3uozuES5PYq9PtLSpzLbZMV1M8bS,FALSE,6870390,6870390,0,2
11EY5rx1tKQQCzNygv8HVkQc3q3wUoHkc,FALSE,0,40000,40000,1
115deM9q4mnDjzBCv91FUyPM5vtTtBB3Ji,FALSE,160000,160546,546,6
113UbRJED1xwPH1azLC4Wmpz9xnPxyWCVn,FALSE,0,295770,295770,1
112ttaXXgCAaYBBt5uybE6aA5XHASE1ai6,FALSE,0,1,1,1
112Nny8YqYVwY1xaj44u2xbV9F2j2ngga6,FALSE,0,9147,9147,1
112EpNYwLWiWaNymAroALJUAjnXhoyAm9C,FALSE,0,39980100,39980100,1
113cjpsSckpkWeS6qBXrAGPRAUAnMSq7gd,FALSE,0,7950549,7950549,1
113J9PJBGT4Yijg8Uxgg4i28aB9UwscXBU,FALSE,0,2400000,2400000,1
113vgqmXHHyzoxSU9wNm9tXT2NU1JQYrSu,FALSE,0,354500,354500,1
112q8EjNnEc9m7JLUkwhZJGSgKVqcUubLq,FALSE,0,95303632,95303632,2
111VYP1rqG9bFrzX2h2R2A3yGoQer4Jm,FALSE,0,614350,614350,2
113Sc5KYDEdh3aF2Ku6wN56kMooGi7CDWq,FALSE,0,9620,9620,1
112zXbwebm3N1ns8q85y3EX5gjrzGSNARB,FALSE,0,2500,2500,1
112hbxy8KwG1oAwhRe7MKhVUKmaRzV1F2t,FALSE,42568074,42568074,0,2
112Pu5p71EriLEkyoNsqFpc5VH6trWHq6L,FALSE,0,653820,653820,1
113Eii41MUsWV7pnRXQC1k8eUGorRqQuQJ,FALSE,0,23595,23595,1
112yJtVKzwJ12wBk1jYKy3j6bX7WVEnCuK,FALSE,0,10000,10000,1
112DFNpoBiMWgM6YPSKJaRmQwPxD8iyraK,FALSE,1000,1000,0,2
113YdCgJQF7GVyizBx3wE9rLxQVSRWcVce,FALSE,0,773634,773634,1
112tPFFqLY5a62U5NfxzSzbbMTAs4d9jYL,FALSE,0,66206,66206,4
112zhdUcqyiom3XUv51JrJGCL7gua1FWrR,FALSE,0,1433,1433,1
113BQq9B83vdhgYrH1ATknpjVFo36DiXQW,FALSE,0,580000,580000,1
1124NvJMDr4GkrnSYEj5ebtVHi9MJkKYUY,FALSE,0,25550,25550,1
112xUE8xMbe3PDRw7bb1QhN5iZKgBXK7qX,FALSE,4348,4348,0,2
112mWTyYGrMpfydM5JqtPy2F1Asrj67Z2S,FALSE,0,180000,180000,1
113R3nk2VdJcuNnMaBhSrnxtj5ensqCZ3,FALSE,0,12000,12000,3
112g9hpZvwyC5dYGD6c6eMZRtM1dzXQ75K,FALSE,0,4026,4026,1
112XB855Totq5skNfvhp3haTqWkg2eE3Nh,FALSE,0,43468,43468,1
113vEQ1sxyGkapxpqqJBshSasmoAWRwu3Z,FALSE,884750,884750,0,2
113XA31D5ivbYqL6559iow2ydNL2NvVAJz,FALSE,0,6187,6187,1
112CYeTEUX1kX2ctAgLXN99ui6KLCQSxp1,FALSE,0,1002820,1002820,1
113tffzXyqc95rci1VY7aiGkZ6UWWxVJw2,FALSE,0,1178,1178,1
112Fdm13a3WemY9C1J9DB2fVceAgTt6WqJ,FALSE,0,6757,6757,1
113Hz7RxaX6hAGzXW9w8JPc3qhCKR9EyAN,FALSE,0,488513,488513,1
113PNinoackhi4j2CL7GHjFAXTSPbxooMG,FALSE,0,95636,95636,1
112h3BmyiWKuFKLMrzYL2LdC8MuBnS7g1W,FALSE,0,288076,288076,1
113jsgZ7EBo9Ca39ugkwFqrcZ7QcB3bDRg,FALSE,0,14488,14488,1
1131jJ6gkFuwD3NaJXfXGmmSfCna2gP9cu,FALSE,1005343,1005343,0,2
1124Xhtptn8vmsGRT55NxhYMjSNWkHW6Li,FALSE,0,367914,367914,1
113KohZyhBSXJLuzje46tpyyUapmjx69Zk,FALSE,0,130849,130849,1
1125HuTjSzsdJvvSuefADSwL2oWDEQnRt3,FALSE,2304528,2322569,18041,4
1133Tfi4FAnM5HKKqVdbxurYi8oYyGLwmw,FALSE,0,497347,497347,1
112awXNgQqVKu6nTinDHjT8udYNqiMZVUq,FALSE,0,23463,23463,1
113fUxRdt9WUeQT2BYHFb1PZknF86kZxwZ,FALSE,17210000,17400000,190000,2
1136RSJadEyoKUcqz2Zji49FVt4ohHhw2G,FALSE,0,100000,100000,1
113QBRaDxaV18aq2ysGVu3RAMPwRNJHkiC,FALSE,0,2414,2414,1
113dq5QonV22TvyP5KqTCK1DmTzigDeybg,FALSE,0,200000,200000,1
112k9aBMh9cYVHPFcsWagcQMtAYu5AvdSP,FALSE,0,348000,348000,14
113zAswKEp8svQZuefMUzq3vGvn5QHqZad,FALSE,0,1,1,1
1139teRhhK8UcKRwaQ8L5dqz6UwfQLdB8o,FALSE,0,46310,46310,1
112RfP93Xhqn2WWBWxcyAUfo4FPB2LCF4j,FALSE,11786531,11819301,32770,4
113BM8kyGxQNuyCSe8LV43Pw6EeDMxgtNU,FALSE,0,1000347,1000347,1
112dhTevcnsi5LMupjsmsWFW75bMf3iAfg,FALSE,496600000,496600001,1,3
112GG5C2hEx1nTxhHtygwp2PvH7fRbkhgZ,FALSE,0,546,546,1
112pRVY1chUqL9o9fhQica1Dh1pqoUb2aF,FALSE,0,9499094,9499094,1
113CYCxhwpHATVwGS78BeyCaAadNuUk1Ac,FALSE,0,25020,25020,1
1126qcsixZZrf96SqrT6iPcwXE6cUnvwgN,FALSE,0,1478,1478,1
112WmSvzCMMvWGR2ws3W6iMDm1kqPbh21f,FALSE,0,118056,118056,1
113z4sRkV8jpakYw7hCysjHA92dc2GiGWC,FALSE,2493385,2503474,10089,54
11112FhgND4A6gR4GySkBXXAECQm35ctm,FALSE,0,11000,11000,2
113BFkBWzZG7nWfx1hZLRgyGLkY4QPohU2,FALSE,92000000,112700000,20700000,7
112R5STdYzbTPzbGGhpwCigQf1ytqwRhhw,FALSE,53499,53499,0,2
112kprAx61f5Gt6rLaNav92gDqBNvo3qEv,FALSE,282460,282460,0,2
113dw9jZqLCfNkpzbj7H6Kh8nJQxbZCjmw,FALSE,5762008,5762009,1,7
113y8grn8SugipNW1MspHFZWcrcmkETNk5,FALSE,0,86418,86418,1
1138sW9cNqkhjWzZwyTHFymumxfHeGK52k,FALSE,0,91385,91385,1
113eWvL3doGAA8gSxysiHmaHpbybz2x41x,FALSE,0,2713147,2713147,2
1133k6y4oG3euEFCuNUxspi7s4YtcMT3kY,FALSE,0,2496610,2496610,1
113GqppBCFYoGv6636yu2Jh7u4x3wqEwWg,FALSE,0,1094524,1094524,3
112oRfPeJUwLThvvixrAWNhiij6MvKPfKE,FALSE,36629213,36629213,0,4
112yTgHDEoMAPa9tTTxKUiLnnMpdUoXKHv,FALSE,0,1325,1325,1
113xcPucrrwe8h5F9Uo1oNwadcMvX7Fqet,FALSE,0,45796,45796,18
112yBU5GTHEiE1JkBwoEi7czwVqUGAMu7A,FALSE,5261,7638,2377,6
1135pvHWEceGpGUzkbhrxnMHEssE1pKoax,FALSE,0,641,641,1
113q7jKDr1ZWUyPMxmgzmiXZxrh3CeBg29,FALSE,0,3000000,3000000,1
112DSrSi2qd5iZNoSWUSEzMZQ8XvUT8omy,FALSE,0,85500,85500,1
112ErUgiH5HnW59YL3oNq9tFoB6fEgwbTc,FALSE,0,9786,9786,1
113sPsoB65grYsJLngeDBnSMuDZAHEVTqJ,FALSE,36000,36000,0,2
111UK1xHcHxkQ2mPBpzZLCajBK4v9vsmV,FALSE,22108353,22118532,10179,247
112e4vsn1T2UxhZG4nt7yTR332hqsZHehX,FALSE,0,13627,13627,1
112JN8qrTDXY45NbRCrTD7KCyT8hNBiQu3,FALSE,40000,40546,546,3
112ULkLRxtK3SNcrJqk8QRuC6U78bMfdCY,FALSE,0,8674,8674,1
1127dSR6vRDMkj8NwSMCjgXJFgscjAP1s9,FALSE,58628544,58628544,0,2
112FwfoV91hDhTjZ8s8wW6zJ4KVNPvPLMC,FALSE,0,25495,25495,1
112vJm25bTg7SfygNi9qhJGe1DmnMSKTrm,FALSE,0,128000,128000,1
112nECr9kdmah76fdLdvfwCmjCaUf9wP1F,FALSE,0,34422,34422,1
112GkMCtYqU9EUTEFdhwQkxhaGuoXYPbRi,FALSE,0,1075638,1075638,1
1138ZvyHVZRYnExQDKPtuUkBcrVbSCoFfF,FALSE,844219,844219,0,2
112Tyshmii4vmkfp9SbCmjfZGmW3j8jE6b,FALSE,2855243,2884243,29000,13
113hh2h6QmokdoXzTY3tqABS6kNdFbT6Nw,FALSE,13667,13667,0,2
113wPfccffkvjJgN3cndSRpocsZj96xiMZ,FALSE,8669222,8692232,23010,2
1124TWvVwLX1G78vfRwmT3nagNAWJoASqb,FALSE,0,942,942,1
113qVwmensFWXrDqFroeWmhWKe98KkWtjM,FALSE,3205132,3205132,0,12
113FfAucyrdKBbeCMDGVY7o1m1KbB37eoa,FALSE,0,9746,9746,1
1126WZiXJj522jqUzbFoeyF38xKCWTvWA7,FALSE,0,748583,748583,1
1133GSNxCRR3Ex8R6fMASgkwTA1AVXbCCv,FALSE,0,559,559,1
113CYYaSTYcM8bR3q5vPWyLmBTuGm7irLV,FALSE,0,19409,19409,2
112UiZGEcBDdhxWp9zXKptz3AWyhkb328x,FALSE,450000,450000,0,2
112ny1A3DeKiF8DazkjVbRbaATtTvQvRsh,FALSE,0,3823,3823,1
113LiDWuCmn8UBsm8WshB73Ecca2KggwXA,FALSE,0,1810000,1810000,1
112Bytv2qywo3S16ewTLPQxKbyE8YMFzo2,FALSE,0,63790,63790,3
113jwZuzcPwpkKLaiqGAg7djqtRQ2q9FDn,FALSE,0,15600000,15600000,1
112CfTEEgjY4Ua4WzgqDhGwDaF4WHyjW3r,FALSE,2299847,2299847,0,2
113oHPDUf632nMbhTZJ7VZtB3MHjgwB5Y1,FALSE,0,363287,363287,1
113Mq5Sq2qcr94JtF7P7ySXeppYVJFBVj3,FALSE,0,989412,989412,1
113Na1bNJAVggM8ZzZbVgy4bNLDEhn5Tbt,FALSE,183000,183000,0,2
112H1QKie5D167zr7rXdqvRqTmU2bJkP4K,FALSE,82620,82620,0,2
113TkFyJurBNK9Ww8he5k8jUXpFCvgBmZU,FALSE,0,99996000,99996000,1
112YfjLk67PkN8YvFEZch1vFeQ47sX3b7o,FALSE,2689878,2742476,52598,6
112mLQjX8LD6vtRziTQpkzA8RxfQdcEQ57,FALSE,279130238,279130238,0,8
112H1DAWkV3CPtGmU99KbCDt57R2oi1omA,FALSE,0,2923138,2923138,1
112Ns5RUqEC8Q1Xrq27xNm4WdUhJPkW7h9,FALSE,0,548,548,1
113AXv6W6sXswCKoL3dwq4Rzxn16741ygG,FALSE,676882,1048417,371535,3
113H7fUyaCDo6WHeHWjmBUWKpXX5zFd8TB,FALSE,0,26660,26660,1
113SMZfZZ7ye5jLNMUfyhsT7GCS23KUYUM,FALSE,0,21857,21857,1
112M6DTUwzuU2zp2C6FLnaDbyX5THWd5aY,FALSE,840488,840488,0,2
113q12boAjdyqmqLUhsrkskR4VT2LKoUsH,FALSE,0,1000,1000,1
112fFc62vWm1fePHZQbnqb6y6hXYxvFXa2,FALSE,0,28416,28416,1
113cv9F6NyYu6wMEySXkYXDSNwKDAWxMC1,FALSE,10000000,10000000,0,2
112LL8gBAYu8MK8RZicv3VWw46S4mpCMi7,FALSE,0,700000,700000,1
1129dshgW1fDRnBSBaeWdkS3X6bVrx88ZE,FALSE,0,1000,1000,1
112bcRwSiaVRmhEB5x3FaQLq8AVrTFqJS6,FALSE,0,653875,653875,1
113QCLZVBNPdmmdWR93TKwfQS4jGLE83up,FALSE,0,2181021,2181021,92
113yB6ThoYq5FMgWsTZ7wRUsWLtyWWbp2J,FALSE,25000,28000,3000,7
113vZSp6A4R6RdpP6Qh9MFWp6Bmy2Ab6HD,FALSE,0,524000,524000,1
112RZykQsokwRxthy4homkmEmka1qBqZVv,FALSE,242610147,245217933,2607786,309
113QWNK2hHZ2HivxkVyDFSbLr88D2PoEq,FALSE,0,550,550,1
113YKa9Gs6V646JyZdSpW1doUZgsebpYqm,FALSE,1180029,1180029,0,2
113Es8183UEEBFR7UC6wLeqbj6mogK5DRs,FALSE,15326,30373,15047,3
112FcHiayZ8qXJSaaN8kDn7PX2efdHACev,FALSE,0,228127,228127,1
1124yvSK8mZetCjaWxyRvzGDQbUKFBmeAn,FALSE,0,5500,5500,1
113LvyvDYpienypRGPZq3Tjy3977fL8aj,FALSE,2486400,3671000,1184600,2
113J8PqMAV7UmrVXfx9LjuvZfyWYCuAyGj,FALSE,0,11000,11000,1
111111111112Dk8JJnSyoANH4Ayc8ht,FALSE,0,550,550,1
112BwKjw7w2GRRAWgr3jea9YsGe8U2ZNES,FALSE,0,10000,10000,1
112iAXH6Zp4jTaVFvpym1eV9N1jmbwTE7Z,FALSE,0,338156,338156,1
112HDycT2eAywvV83zrrHGf3NDtz8NPEg3,FALSE,462952,462952,0,2
1123xLHqq6b1UaG8NViw9GLUdT194uha9w,FALSE,0,10193420,10193420,1
112iJCGB15CEQqGHBqeTx7NuM2JLtS5NSh,FALSE,0,1296,1296,1
113kGVjzcL2XEezYXVEtDQ6rUMqFvVefPL,FALSE,40146,40146,0,2
112PyvhVo94PJboaKJ4S1crDC3JsyPncCh,FALSE,0,3139,3139,1
113UPgQYsXV1vNTmQcaAnEaayotg6J8VbP,FALSE,0,1497884,1497884,4
1134cdn6NCxJGE1Pto926eAANpitoMYw1L,FALSE,0,61066000,61066000,1
113hdhywfzwqHZDju7GdbLvqZjFawp5htP,FALSE,0,14300,14300,1
112WoQcNwyfP7pMBbdUs3ebfPakAWFwTtS,FALSE,0,3680738,3680738,1
112oYv9fHMJFs3jF9EGWucActhLXn95cJ7,FALSE,0,6054,6054,1
112WFkerPsACn3YGezdyVdeRiDMbGAXPJe,FALSE,0,975010,975010,1
1133T76EDFxPdtACr55iaPDJxmAgkVxGwo,FALSE,0,10634,10634,1
113Rf2B9fP4BUu9sVKTf5SD77ZXVxFbTg,FALSE,0,9144361,9144361,1
113jFpjNK35NdhuDRg5LPZ8ePR29bgUnvX,FALSE,0,12746,12746,1
112M6dfzMGciKphY75CrQDTDLcTZu8ssdo,FALSE,0,187570,187570,1
1139bfzqyG3bRebcoAHeE7Vs3z18Em7r19,FALSE,0,5480,5480,1
113DFPuTgG4e4AXA5BffBwRXF1bsk2LjPQ,FALSE,0,12600000,12600000,5
112hEmsjawdytEXBFbx9WmT5ipr856CQEJ,FALSE,0,10980,10980,2
113Goan6Cshs6hKKuLCnW1Co8v2Z24e2Km,FALSE,0,4587564,4587564,1
1127B3HhbNidgaKYkfbczZWbvAdfs8Pq3k,FALSE,0,100000,100000,1
113vut11LxoppK6ZFfiu1LBLremE7j2o2b,FALSE,0,2918817,2918817,1
112hbh45utQ49zgVLpkoVPn9MuYWBUiL1a,FALSE,0,47044,47044,1
1133en6naNNM8vGDEgRHNkiPmwtyB1Uqrt,FALSE,200546,203276,2730,3
113vv8uFAFPR1s96Ega3nVTHfNR8Ugf9B7,FALSE,0,50875,50875,1
112Ymjooe7H4Y3YFaqSAZGUvqtzyE6Wfg2,FALSE,413251,413251,0,2
113Fyivafku31Q5ieVDbtYHSm4FxMfsC3H,FALSE,0,1177,1177,1
113FgQKV8SvmZzWubqoQF3UTYPvrYaESiL,FALSE,0,10000,10000,1
113MLunodZNqmZ23b4vEQ3UwqCBHcEKNsr,FALSE,4251500,7383500,3132000,4
113iZijMHsjfyq2y8GD99cfmneEMrcW5Jn,FALSE,0,1000,1000,1
112SWnx2wumGnuHfnQogXigALa5AvvhRK8,FALSE,0,10000,10000,1
1137NYXcQZaFKSYfspbjSoSNx7VkcWyoxP,FALSE,63910,63910,0,2
112PLDyZiph9zPo57hR5UzXbtc155nLoq,FALSE,0,14800,14800,1
113NqcDgMxP1SiaNooRct5gCWT1HeGQGCo,FALSE,0,44955,44955,1
1128Li8mqP3JFJJUNpThbc5Wbg55tcjdKe,FALSE,0,64501,64501,1
113Ub8y7LipsdEefYjbwQTbjQ3eiqUY1c1,FALSE,0,5500,5500,1
113QRxMfzwim36SRWhE7iHiao6tBdzYcVx,FALSE,0,49166,49166,6
112WSuypgjhCrMRLxmHB9jGbehmWqbPPAa,FALSE,0,65853188,65853188,1
112XHv7sqEqhc4zb4NNLCG8wwuHmTQb8ou,FALSE,0,52715,52715,1
113TZBcBmEu7YXaeqWgaShAtikQFAiTBoE,FALSE,0,1605,1605,1
112rurzVMgwRj3ufEEgwM17QnFUk4FTfGG,FALSE,0,1524,1524,1
112HQBNZ7YvQ8N9SLsJaP3C8yG1GnPak1R,FALSE,0,1040,1040,1
112p5vcdqzVSwWhTGAJM191PfLAmZNpnRK,FALSE,30000,30546,546,4
112VcB8XRmaT4ZXUwLdWy71gYVvULMAXr8,FALSE,52000,52546,546,3
112eo14CprktRtXcAomdRmH4L1uxdwkZDy,FALSE,19328,19328,0,2
113em455xyDGzP9iHygifHmjJDyUDnWbrN,FALSE,0,23261,23261,1
113wuroywSnwHaYjG4yiTqbudQhNNZ5HDc,FALSE,0,2760214,2760214,3
113KRPMfqJgHBzYQded1oVFDxPMBMTgcAZ,FALSE,39994,39994,0,5
1131BUVVDFzDVc5qLpaa96Vm8uHe8sdyuA,FALSE,0,5886,5886,1
112aUNK14bt9CgJcsZQpgkPFAGxTCbFLqj,FALSE,0,10093,10093,1
11337VedMZwhbDDEaWdGsgAcvW6vrNPWtD,FALSE,558400,740960,182560,2
112FQPUEvZzEf49orcSCc6fvCdvXWD3jEj,FALSE,0,368800,368800,1
112KVoL51LPW51b8fd57ARC2zTsFchzMpp,FALSE,0,100000,100000,1
112nwWKXjUvGx4bGwyLxS8YLhWiSQ4RTJd,FALSE,0,87722,87722,1
113doELohfa6ss1DDQWkMethGaKTAZte6p,FALSE,9110,9110,0,2
1125ixQU43GaAjVfErCdcZ2SRXQni49YKL,FALSE,90614775,90674486,59711,39
112By8c3pqEKaqUvTDZGfw4ftKGDaCERqu,FALSE,0,218085,218085,1
112H4bugBfnKTS9qffZj5ipdBavgpbnZQ,FALSE,0,602600,602600,1
113x3g7NjnkUAH4hVcW9JgU1pPwKgTpYZQ,FALSE,30800,40546,9746,3
113FDuHLDDsQkCwq7JtBVVLy2BBpgj65EX,FALSE,0,176577,176577,1
113oiiZPU3RhoDHVe7bv3479ejndxMnecB,FALSE,0,5300,5300,1
113HxrJBbV77F8fFpvFtwANggjdKmmrvu6,FALSE,873415,873415,0,2
113kV6P5nnu77CCyth1npnPaNjETDGGUwE,FALSE,0,79240,79240,1
1128EBnx3hs2ihBU3TnXMxnvvTnnLcsWQF,FALSE,0,882801,882801,1
112b9ez1EkRpxKfQa46Av3MU5VcjMQfP74,FALSE,218571925,218631540,59615,13
11348YuKeodPNsbfDB8wNkK6SboVtK9Uqp,FALSE,0,90588,90588,1
112txxi3EYHHdKAdaXNUhaLVotL3evAro6,FALSE,133444721,133444722,1,3
112bSr5KCNuWoBoKtNC2MzrQ43mmB2VAfJ,FALSE,0,856,856,1
1132E662LXDvHBdi2HRhXPru2Z4KhVBGRk,FALSE,0,14103850,14103850,14
113AuERYiG5Yf2y5By4oDtR1qgBpTXE8Gu,FALSE,0,5500,5500,1
112km16sDSHXn4hUpsjFycyCBjLbqQwdZY,FALSE,0,1086,1086,1
112LoGPumn6edCCXqr9SuTbdAZrvhQW3Zp,FALSE,0,344334,344334,1
112Naus3TC7xfnc2NA4cDQECK9yQttt4Fo,FALSE,0,89644,89644,1
113QLa2zdkGkYi8ueR7SVzRB2bnmvBLXqN,FALSE,0,373505,373505,1
112aXtGRFCcvWHQSqxzNqNXzXkk5A1UHne,FALSE,80411,80411,0,2
112qyugL1CfzfjrWJHQXNH3GA4pJnUVoDg,FALSE,0,11040,11040,1
1134TknZEeXaER3GqnSLrppW3aksnFMu6Z,FALSE,0,548,548,1
1126XTD61DBSCmN5v46Cj9sNM37p6DWozy,FALSE,0,20208,20208,1
112wCGD1VXnfX6XgR7dSDc3tgjwhvPeeTe,FALSE,0,181540,181540,1
113FHprw73rFPKSt9RoLiALG9xgxHnJvKK,FALSE,0,100000,100000,1
1126ihhs9fye95gQafYPdPN4ZU1t5wK8sR,FALSE,0,1207,1207,1
113qjqcUsu6VKCetRdLfYg8JFX8bNm1uUV,FALSE,0,100000,100000,1
112Q9TY7joTJx5kskkdvatNTAHrRN6Ggia,FALSE,0,39500,39500,1
113U3ZrebdQqZmk2nZjVgvsgPiv9ne1GSG,FALSE,0,14847135,14847135,1
112XxcnXcAggrn5sgRhSfvHMoKQvb9NjQX,FALSE,5683247,5883247,200000,2
113L9pc819TkkGAmXd7m971vN9EkzAyRaR,FALSE,8576512,8576512,0,2
112ezS1nneEiRVc62Bfmysgt7tub8oypQu,FALSE,1133088,1133088,0,2
112kGTT34NL2ag2FgUF8ZhnuFs6nVxsNUM,FALSE,0,5500,5500,1
112cKCm2HZ9qjRjDfuL8ZHgL2BGg5G2adY,FALSE,0,715,715,1
1124u13bdQjwRd1e6r5Mf3PhcDQi8W6ETK,FALSE,0,89074,89074,1
113UmHtrPkiW1RfKpZmoHwvGYweciRu8A7,FALSE,0,139101,139101,1
113fBT6tjFuTTdm1ejScHiHaBuc3AG3qwM,FALSE,0,10,10,1
113NNz8FEE2ezSnuJpXRusx12vsQ9hNx1v,FALSE,0,4999,4999,1
1122wZo5cwLQ5d9wVYYgchcfzHAmr4kgey,FALSE,167890,167890,0,2
112tSeX1b8kwDDckbiJesVCQa8k6u2YcyX,FALSE,0,700000,700000,1
112LNMu4cXZ17EktsBxojPRWWGvLj8NpNr,FALSE,0,657346,657346,1
1135EeweNa4ri5dokxWAgsMkZ8f1j7Mqfi,FALSE,823749,823749,0,2
113yZXhGhmhceztm312NBBD9LubVwQk8JD,FALSE,0,107323,107323,1
113fYY5xTGFcy79fJM9nPAHqJeiTWk2rnq,FALSE,0,10000,10000,1
112ZrgS31MYvNJqsbwGC3PPUWR1BabHDLD,FALSE,100000000,101600000,1600000,3
113v5Kfet1WP1Kk2Ur2atM7avTN9BBHZh9,FALSE,0,55463,55463,1
1132R95LHdfg8JH4vFUwHou7TNyJXzhYdK,FALSE,43000,49000,6000,4
111111111111111123bte7BGnZWEo,FALSE,0,2730,2730,1
112hV6akQJvwps7ohHvQpYTxck34C2hyJN,FALSE,0,33300000,33300000,1
1121K2tXwzjTmvr7iHfDN2zMzdfZXKAqqy,FALSE,0,10000,10000,1
1131zbJR77aFDrQmDKqezUL3M9RfuFHQE7,FALSE,0,2232,2232,1
112CUupf7Xmx1KC58QsL4iLME6VxUDKZm,FALSE,0,10960,10960,2
112YTANksDFbovNoK1HFd7im3ArA6tqqqT,FALSE,1605722,1606400,678,3
112Q1RtLoVyBkNcioDpKCGQj51LHjXxzwk,FALSE,0,3258,3258,1
112iThZdL8kveejfbK9r65bLFcdWskFEN1,FALSE,11940666,11950333,9667,4
112Dbc3SZp7JC5rr8iVidjoWwZC66cZGmA,FALSE,0,17000,17000,1
112kiMpSobVufxv4PUd6cTCZMXt6cvpEZv,FALSE,33600000,33600001,1,3
113Bi9eZa77MLFEAviA6wK55MiHjz3PWmT,FALSE,8184,15276,7092,10
113emfJQPZEYXhNB3treqTeHjisbze4zU1,FALSE,0,740000,740000,1
113YH8RpLoANjDmi6xBTwQHJgE2pj2oQpA,FALSE,0,54448,54448,1
113QWRs5Zo3pt6bq415JQgie642BdeTTV,FALSE,0,546,546,1
113YZK3vfv8MbYZ81JWBef7u8AnURDCTaT,FALSE,0,1262250,1262250,1
113kHTHYqZY69LwkrcsRJ7M9FgmeJQiJzh,FALSE,0,4662,4662,1
113DrFM1SbUxBHRcXXh1p4UfBb9Jh2yAk9,FALSE,16344783,18007688,1662905,12
113MwsC3aUoXJU7ufY9XNp5ikuFr6rwWMN,FALSE,216580,216580,0,2
1122NzQdzu7mwHtW5LRTJ8y9jyDcxt2K3E,FALSE,0,11000,11000,1
113UyouecoTdZEhEj5TNoa6vY1RXKwToC1,FALSE,0,850870,850870,1
112zGipKAHefUYJciz8WM6h71sd4wcpU3n,FALSE,0,478354,478354,1
11256Z3LE3qFPCymk8Y42agtHwG84mG2fz,FALSE,0,83895,83895,1
113EVRfnpKkw5BGiNw48JH8fryoMPQJV39,FALSE,14025994,17183491,3157497,12
112NKQAkfWD3Adk2B7xkJ5k5pfejKWBSzL,FALSE,0,548,548,1
113Lf2u3rPnYKmneNJ3yQdr3xm9YzfoWYu,FALSE,0,39358,39358,1
113v339ipXkFvP7QoxWwaDMQh3af2Q4zzf,FALSE,2.79E+11,2.79E+11,25298,711
113ddh8XEwBoCYU6sMrEYx6vXVGQJaePR1,FALSE,35876960,35881960,5000,3
113hH6XoqCgdYvWkVfj1rT2CWMCBJGv7Fy,FALSE,1510000,15072065,13562065,14
113XaGYwEGiErC6bDNor2hHdhr5QQgHZtM,FALSE,0,305687,305687,1
113skqr1AQaaH4eE5mX7d7gNLUE46wbyRL,FALSE,0,4060,4060,1
111dv9kwHbg5dnd4JvCyGioGmyAXUFFv,FALSE,0,5480,5480,1
112TzbynZfa9oCBf3e1R5FnFHc24eVfbtT,FALSE,154585477,154591884,6407,470
112EydEmBHY3FyPfxiHmSfcokx4MiwRiSU,FALSE,40774513,40774513,0,14
113QXrfXkLQoJs37T2m5Y484pKLCBHgKB8,FALSE,110000,119700,9700,2
111TzF5FZYv3W6VaLEZGqyMZNXwnQQY5S,FALSE,22867,22867,0,2
1132bGKAQxzidR5W28UZRNxkgM2ZoLr7LV,FALSE,0,150000,150000,1
1126Fvi3R8cEK4xzRXjKq1uUPfKsnFBskM,FALSE,0,957187,957187,1
113k43KBofEGKtZEapiyZga8oUKgEgnmfW,FALSE,500000,500546,546,3
113CyQ3Dybq73VYxs3R8DCvL1UFHjPS4GZ,FALSE,61825293,61924131,98838,39
112V1ThyZ9bGAgkXVYyYoa1gMWqbri2Lh6,FALSE,9328919,9328919,0,2
113Q5VGTPWHeG1rwYitbm3yUFYPqKtGeFS,FALSE,0,2500,2500,1
112kx3SLuz2VhCR3sq6damJpWVYQ2ouGVM,FALSE,546,2184,1638,5
112beMQSp4uLQZsZWnDo1u5E9AVHzsH71p,FALSE,2319728588,2333755939,14027351,17
112Dc9QHiuw8dTNuwcavSydoX1PpF7GxLN,FALSE,0,7774,7774,1
112FRS7Yjd5GkCwhh5arBm7UAqxSuGHQU3,FALSE,2184,3276,1092,10
113toUUCdXVJxSewUPimVjd7PdmKfZEVym,FALSE,50865414,50865414,0,2
113bGFGjD33HLG97aix8kwUmft2q4zuiDv,FALSE,171169,347325,176156,11
112txdwn1qoqsjVLF2y6JtoFWgPNU9p3jG,FALSE,0,177360,177360,1
113h35hSESdVJ3gWihFLiPkMoTWvKA4XT2,FALSE,4317534,4341505,23971,96
113JbPvr1VtgJa99iFSpq8XWoUDVMzWv1e,FALSE,0,19639,19639,1
112XgZcD5tikqAJSBAzfgu3JwcHjWGdLns,FALSE,0,740,740,1
112TQQmyt6djXhY3YCgxAtMD8N6p2v8Ft2,FALSE,59300000,87191331,27891331,5
112ANH1V6UTHEpzSmv3TYY8kUBhdZwsTM7,FALSE,0,40615632,40615632,2
111vKrwPeL2chNqQVUJBWrrUMDx9VkSe,FALSE,0,5500,5500,1
1111DzAd5YAA1VXRETeuA6EgCyNXCviUd,FALSE,0,5500,5500,1
113GB1cPHagphJ1bQZAMmWmLNhJzQLfkH4,FALSE,80000,180000,100000,5
113LjfCRFhbnW2wk9ypcudZC6Fuqi6AftT,FALSE,696282050,2297792262,1601510212,6
113EhJfpGkN6W2HhVr7ZUVH9fNVrdCZVTb,FALSE,0,6525,6525,1
112MfX8dHpUBRE4RHUPqQpNXSCsf2KUahj,FALSE,0,3000,3000,1
112ZFNQJd7eemfvGHiRjeEvCZQMWhoWijZ,FALSE,0,54300,54300,5
1126rmvibBvymHSQwDDT53Ty5HEW3zHuxa,FALSE,0,247022,247022,1
112cB3eL2AkFaCPZKD96LB7mu7EqCwgqrs,FALSE,2200000,2801211,601211,5
112VFizfF49cbycAhkV876hH5KvzUvgK8x,FALSE,0,5500,5500,1
113WtvJtPvkoUUeMppS8wsEJXhnLMj9ibW,FALSE,0,280904,280904,3
112AiXVqAfcAU7ymvVuuMkE5kZJtJ73yd4,FALSE,0,11253,11253,1
112kZQJXQBhFZriV7FkqnTu2NEJXhJAjYQ,FALSE,0,163755,163755,1
113okW4k425qTdcJBxbMZEsJL33Cb6k5xm,FALSE,0,200000,200000,1
1124mvMc8u9zEPw7xTbRpXMTwt2Mzqsxa8,FALSE,31254350,36254350,5000000,8
1123rgfGHuHEiFveMNqNJU3zFH7FD76cPY,FALSE,0,804000,804000,1
113vVsrLnbfjiz7Xr8zGEr4SNkPxU9BiAS,FALSE,5020,5020,0,2
113gjAxxDwNzqcwgfbAArLCUYochTTxMaw,FALSE,0,35166,35166,1
113xTs4u1jyVbtiHoVw4dCVsQKcYFuPDe5,FALSE,0,4900,4900,1
114DQaaQvR84kww8tdCorTLnpRqM83oGaM,FALSE,0,1000021,1000021,1
114FYn6NoYMEDKEsfs89gB48GjG3ku8Wkt,FALSE,1620471,1620471,0,20
114H95uy3UyHpfPM92J45TSSytHZugPSxN,FALSE,17099918,17099919,1,3
114BCMUueRzrTDHj6RNfsWUJVwC31SMDss,FALSE,1822000,1822000,0,3
115EqM5995GQjHVJFRASo7NR9vV968xiox,FALSE,0,1000,1000,1
114j2MtQXGDhM4PsoKhyNeMbYc1uo93FVV,FALSE,0,100000000,100000000,1
113zCxYDLBiTdEDnaG2CA2akV9zPKt9ujg,FALSE,87666190,87666194,4,8
114Qi2PJUvLA9etFHxya13sAFApSQ78ZWs,FALSE,1047867,1047867,0,4
114W953D7miCBi126dJw6EMcRrCgad526E,FALSE,13546,43546,30000,7
114APjVazb9Sf7eCzakvbybbnB9tdScNm1,FALSE,0,20000,20000,1
115ZRrBrpnpKPN25cGNrutxSpXaCT72rnR,FALSE,0,301269,301269,1
114Mvd4hEyNr2kgCWE513pqQxaYp1RK3D5,FALSE,0,33287,33287,1
115Q36LK4ffyUV7zsSAnzLGXTjUQSXXVr1,FALSE,17216,17216,0,2
115RbKSdRxRbVpdCp2NnvfxYtcLM4omoru,FALSE,0,996954,996954,1
114XgDq8qHQHRshgVsKQK8kqk6xTm2X6eE,FALSE,775898,775898,0,2
114qd7h9HtPM65Q2hPKe1v2Q6SHjBPcp9m,FALSE,0,1000,1000,1
114fte59HF2NMtwio3N8WbVj7Kjs59NzsQ,FALSE,1587,1587,0,2
114ETwj4UyCJevdagW8T7Gr5gMoWnWTxP1,FALSE,0,384679,384679,1
1149r75DwXCs5QF4J2vH3LddcDLtp73fDq,FALSE,0,62499,62499,4
113Xyun6YmR97Q46BLPFCaFFvGUGo5NBXo,FALSE,443750,443750,0,2
115HzrYRHCPSLzV9Qd5heA5ZG9yXAv9uaL,FALSE,343967,343967,0,2
113nACT5vhKzCYcagefaZbDu83m5xr6vwe,FALSE,72950000,72963560,13560,4
1144VbrowdGvHcgUBxnV1M4fGEqcoE1p48,FALSE,0,1000000,1000000,1
113jkcMKwvawHdENmW2GJjcFM7tn4t6jDs,FALSE,108700,108700,0,2
115LoVjwbvNWLR8fTDhCmdJCH218YNNVSs,FALSE,0,50000,50000,1
113mvcP9CJrAGfqx2xy1FUxWEcg41hUpnX,FALSE,0,10000,10000,1
115AcYEL1Av8XrWpWoiHrtSD5c7UozauSq,FALSE,113643,215595,101952,9
115DknSHQEoxDRcpgdHJBWy1f9DKkNk3mE,FALSE,0,60868,60868,1
114wENcJpkVnfaxch73JP8iTfXHqWNWGxK,FALSE,105790,106337,547,3
113tJFAzQ1keoeXFmcp2RF4xJdED5eN1yS,FALSE,0,19000,19000,1
114QuEgGDVunt7PNw5zj5UwiEvVsY7Qa2u,FALSE,0,739010,739010,1
114FwwB5Vsz2tAHH52beFUpuVqYZBFGE87,FALSE,2825280,2825281,1,5
115FpU5hh2VCj9D3S9QmixJfxRZtYMS9aS,FALSE,0,9655,9655,1
114bdWPdzFZJ3CsVokpUxqXt6BP8sKq5pZ,FALSE,0,5672,5672,1
114oo4nzbph6D866MeXn8SpgAA8SBy6Kxn,FALSE,0,30499859,30499859,1
114JkJ76VtoGosfyCLUnaMKw6tBS1Frgek,FALSE,1505259718,1506637328,1377610,553
114KX7YazqkLKe1Nw7Q3cLuu1dEd1AbiQZ,FALSE,0,8764,8764,1
113kotZDo3k3i2z8PvTpfn8Y77UkpH8w6s,FALSE,0,336896,336896,1
113orVFTQn1FFPwLgzvPd5wPXMwRqHhUms,FALSE,1092,2730,1638,7
115KmbvTqCpnFk9W9HTVuJssi2prQ1fTiH,FALSE,0,12585,12585,1
114eFf9try69cGvFudUaZGXLXqbkpjtiXA,FALSE,0,1513,1513,1
114tfpFTADtvCtSMQA5XpH1JYYnrFK7bx6,FALSE,1626,501092,499466,4
1155CvbRzpSqRtfX2BbrBHtcLRT3GFA6wS,FALSE,0,1340400,1340400,1
115W9k2SM5zJtQUDS5WPAbAuBwCwF6vQum,FALSE,0,163667,163667,1
115RWttuwMbxyLBQQxgMaZra32gfsqd1yy,FALSE,150000,500000,350000,5
113XeLDzgqrdzD7eR8Wa8J5tedBVxcdiWk,FALSE,0,340362,340362,1
115BPNqotHEzGo7HpbM9To1obCnLupUbAT,FALSE,0,697,697,1
113nYCq36b4vczfA9uZNGCoENhQK7mCWvF,FALSE,0,36061,36061,1
113dK1TnJBm5Po2vG4DhqeGG6zbFpsPAux,FALSE,0,170000,170000,1
1144xqPsVcLjmpFq5Yu5aUFNgLVG57s9yE,FALSE,37077589,45621831,8544242,4
113ZpovE7yffpLFfizpYjeQoDuX2DN3kii,FALSE,85536615,85846121,309506,2
115Zx7Lig9fLpE9pdQseTcKVo3hWuitbRu,FALSE,207949,207949,0,2
114TE8utNJzA8MjsPE2YEdjF7bJ2UhwmeG,FALSE,1351034,1551399,200365,3
114HojVHcw6XYUNJ3m6pm2XBdp7efxRvg5,FALSE,0,278738,278738,1
113q7jZTNu4v9uFzvES3ZXsca1xxbMjQYK,FALSE,0,4408,4408,1
11455hpdJGWVfPwnX1y5s5dJyHqfrThY8Y,FALSE,0,37110,37110,1
113XtbhPAMrzwv9SojeEb3LbXehZvHCYok,FALSE,66658144,66658144,0,46
115RWyqJsP7c2WrcKoa7uSu7XKXdKHymaT,FALSE,0,25773,25773,1
115PJnJ231ot2SHdSSQ7WEZ1fMiyvpzfQL,FALSE,0,5587,5587,1
114n7W9dryRJ6iKuC4ni1bLjXu9tSZGXWP,FALSE,0,71340,71340,1
115Rqgvv7aPWhzQxLmBs24JB7fWG4WPFBn,FALSE,0,10776,10776,1
114KCq9JA6DJ9f22yHfzaX2YsodN43dHQY,FALSE,0,6963,6963,1
114c7aCPQydEjbhnzX7nqr9wAVrH4FSvJ5,FALSE,421923,421923,0,2
114HofT5hzPhUreiiTJ9iEUs7w1XeVAGau,FALSE,90757888,90850151,92263,97
113kewskzhF1XEGDmVYaphvzVmHjiVk69c,FALSE,756824901,756825502,601,189
113ZiCd7mM26HK9gvzGrjApf2F6pgswNry,FALSE,2165570,2189229,23659,8
113yZxvm3zyanwyw5oxYsKtZzuoLZvQWdF,FALSE,0,1562,1562,1
115PZnF8qV3SL18e5W7W2QP6Z9Ym1MkPfN,FALSE,0,902,902,1
113jBPbsrPPQtEi7Uchx6dtbe2e1u8T89V,FALSE,0,5000000547,5000000547,2
1146xjnwAsVyPMsADKmy5tDpKAu5tkxtz5,FALSE,0,80100,80100,1
114c44DgMp1ASGEZDuntBtrX3XuG8xk8wm,FALSE,0,3610000,3610000,1
113ouFU4P4eeaYAPTDJr1HBB4Jg57vLovi,FALSE,0,724000,724000,1
115DCqF95T8UxqNfmNcZdS31u8XccJTS7z,FALSE,0,330515,330515,1
115D1VbMzMkCjVPUnizF85M2p7L96v92HQ,FALSE,57221,57221,0,2
115MJgocwLybtJHjPJReKGecjSLFSkGHfG,FALSE,0,617530,617530,1
114iQJJTesKkvuQv7t11iNfnEzuxSV3ZZd,FALSE,0,546,546,1
113kpd3Q2we5mw5zhWuXofqo9sS4w1WXwH,FALSE,0,230000,230000,1
113mbBnwbLkwCzL89J2BRkvhHZFuCJNHN1,FALSE,0,57116,57116,1
113YmiFdWo4Km8ic68boXbsyC6MXbuFsMu,FALSE,0,10000,10000,1
113wBC4ZfypcPzthVsKKYucJ2JxNVHtyf4,FALSE,0,50226,50226,1
114WUAKDzfPSJxtGxcsroJFDGRZ5yAj6XU,FALSE,0,571440,571440,1
115Wcapc9BhfwpxHWKEH3YRZJ4dkeqYdoy,FALSE,0,2500,2500,1
114vwjgBbCGKxnXrtoShAtEdb9kRpFp8q5,FALSE,28046,30546,2500,3
113xfpcNxHSaLrMUNpNtoXGn5utucws7Mu,FALSE,1500000,1500000,0,2
114yVqkbAD4TzHJg5mKDgaTHvvQ5kQQmpL,FALSE,0,334205,334205,1
115a8deHuecdZVWh6BUTaffgVjCxGdL9eh,FALSE,0,15430,15430,3
115PLq2sgBDrjJ8z6VnAkWr77BjXqzNQr1,FALSE,8064167,8064167,0,5
113maJF215vAugXFewcFy9AiFT5E43ke9g,FALSE,0,716765843,716765843,1
115Qj8JnTPPBXdqJTmEctVZfmw98hMdtub,FALSE,0,5291100,5291100,1
113eMiTJiqw41L9HeANRr7E8D9nYtYspn4,FALSE,0,87570,87570,1
114K9pK1jqTXb4jeAUPitwathwu1D9MZ3u,FALSE,43785269,43792461,7192,13
113kBJFE4MUX5ugi5RsB7zwLMgA5vmvKMS,FALSE,2061900,2061900,0,2
1141EgbjhUrh18uxwPui5iQLNneA5nySDz,FALSE,211094,211094,0,2
114tRt4nyvwCGRN3YWFbUTrCeAaJEpUcct,FALSE,0,2355,2355,1
113bRayJjy3MkJ94LWs8e9gVfa2H1LAsoz,FALSE,160000,160546,546,6
114pG6rQv5TfdVee79vZxvnAoMCfubgd9i,FALSE,646160,646160,0,2
115ZXVjK5y3dRopfyKetJsqYUxNmfWBd4i,FALSE,0,3093,3093,1
114cyHc5rSTHJTGSyoxEq2BDWvopj42iKu,FALSE,0,3611,3611,1
114Jg5rLp6CaV81iv43Y9fb1W5itehkVwM,FALSE,0,5500,5500,1
114ujGGGU1Y6i8oLqkAFFezKt8ZkLMxy5m,FALSE,0,977,977,1
1154FhoxmhbJ9EEkSWJ4ojnno4qKBMQetV,FALSE,0,5500,5500,1
114J2VVkb1XCvx5jNyYzVGXkvRRc4azG6E,FALSE,27742,51092,23350,5
115SJusFbS7swy2Gz26h5sudsp5U3MTgEa,FALSE,109758,109758,0,2
113wtMZiJCpJj4JDF5PqVFYcBA6R3Q73ZM,FALSE,0,30082,30082,1
114VSAzPUivofPtujg5XQhJjeQcsPA2cpC,FALSE,1017168,1017168,0,2
114PoYgza9Z8Tu9hAt9C5eGaYMrEvEUo6P,FALSE,0,954,954,1
114ruUc4um3EShfSmDmJoBQYMEENsH356y,FALSE,0,62601,62601,35
114HQJoTLU6ethhzzRvn7v1Ak5A8jNhW4y,FALSE,0,100000000,100000000,1
113dU8XiRLRi3bpF9pEmbfUag1bnzxQDuL,FALSE,0,6000,6000,1
115VETQERoCcw6Dk6q64MsHMoafNZcK3LG,FALSE,9643522,11304817,1661295,19
114EUyMPKvCgoEqz3gNEMiDq3KoMpCX6RW,FALSE,40131,40131,0,2
1141AtK6hyeKyPR3eNtR8Yo7vmz7Es5xj2,FALSE,0,65419,65419,1
1145FWDCz24puScybTWdQ4Sy3K57MkDMiq,FALSE,0,1051,1051,1
114c2ajRiBMvXH1WK8YJrDBf1QdTxx3ajQ,FALSE,0,59891,59891,1
114Vwp8jr5WAv6pkQxya1vUa5GAP37dG7W,FALSE,0,3490923,3490923,1
113wHCwYXhANygZZ3AMePPxXkonhzuBHi9,FALSE,39210,40302,1092,6
114hfvE5njCM9z9fVZbh99o8pDkVcqsNWh,FALSE,0,591638,591638,1
113cUWE1FKogHXrTCnXVvDzxEeiGcepz9h,FALSE,0,355267,355267,1
113UgCJnyLVsPsa5469jWqTrbV15nJCDkm,FALSE,546,1092,546,3
115KGiSofJfSEknPHCmMq4C5wWVxQAQvWx,FALSE,0,98422,98422,1
1148QFhMy5HNnfsuzcsAwtPQyNosAtBSEi,FALSE,1310000,1319900,9900,2
114RNaemaAMA63oj4Md4FTsF1XrVQV8LvT,FALSE,17073254,17073254,0,2
115N5b3B42QTZoYH6T8igH777a49DnNwiu,FALSE,520000,520000,0,2
114UX7i73SVc4rpFRNoY9MP8vv9d4HPgXA,FALSE,0,209430,209430,1
114KnADfBZERhWw1SWwWSuuy8kfZAQfz1U,FALSE,22918434,22918980,546,10
113xXEWmFitnPoDznSa9ePmuJ1R7ufRDSG,FALSE,0,148102,148102,1
114bVeX86pSC94ibAbezDYNvQ5cr7p9weh,FALSE,870000,1310000,440000,7
114truopBKpdv8Y5Uui1ykP8s3AaQgjziN,FALSE,0,92000000,92000000,2
114oHa5iADuNXGMZVAo8U7vJ715aoyFDk8,FALSE,0,5000000,5000000,1
114JWDH9zLk5QX6Awn628th386QetYEMGn,FALSE,0,10000,10000,1
114Yqix8zkRyQQSKUxJL7eBV2rB317CrLE,FALSE,0,169185,169185,1
115J4PiWiynYJo8vsJBLCTFAMW5WTv3Vww,FALSE,0,16668,16668,1
114GyByQSg2CYMf8dhYaPbuLvECHz2peK,FALSE,1051290,1131290,80000,3
1152xVV1BMn17R39dnJ1JJDaKg7j7ypHvq,FALSE,13104,16380,3276,54
1149SAbyaBwJuUdpPkQwmRs7TxSLNA8pQm,FALSE,25000,45000,20000,3
1146pSVmk6aXGYkZnkZpjGkt5jtFnvqGQ7,FALSE,10945483,12945483,2000000,8
1142A1oezVF3NaW8584kv6eGaR9FmTsgWV,FALSE,0,1169,1169,1
114fPAEosMCmdAXhd6g2ACoTpp8iSD32JF,FALSE,40801402,40874766,73364,25
114CH3bTbBAVFdqyvFA8KJyogjKjSRnLRQ,FALSE,566522,587054,20532,2
115XD435W8mWPsrxU6ta2difTDR9YPGp6F,FALSE,0,873,873,1
115SPbs6Krobcsk7zSCRpm1ZKGdffmJgX4,FALSE,2984000,2984000,0,10
114SCVkGZCF69VtZWA2FWrJL2LPTmUejfF,FALSE,0,546,546,1
114Haj6tqw5FjjQMF8u8ZDZBJEutYcX7jD,FALSE,0,227310,227310,1
114XYtiA11GzeXZVvtKq4hzxx7Qd45DZjG,FALSE,0,587526,587526,1
114MiTMoanBtHJeHpr5JxFJ1AsDM4rB9W2,FALSE,0,5500,5500,1
113ph94DKVRhUMudVpcmwQRbCwAhvSoddS,FALSE,0,2400000,2400000,1
113tNHkgAmqbuyfLxk537K41TdzxLtmuBd,FALSE,0,3018771,3018771,1
113qmEZbs8w39U2WAHC8gGpTbFURhJ2Crw,FALSE,0,546,546,1
113YnMgDVeJE2SxK6ZJSeikRRf3sN6w9TR,FALSE,0,10000,10000,1
113knd2ryZAXE2bqqG56xKTdYTQnWySrEc,FALSE,0,1039,1039,1
113Yb7Lx1yRYKM39FQhgyHRrCjYLHJwnoj,FALSE,1501638,1502184,546,10
115ZkKYfMsy1W2fd18Wk7jAjHcdVpSAxEj,FALSE,16155860,32860208,16704348,6
115YWyKAx7FfNfz88ivfXJaDvFmJGNnB1Q,FALSE,0,546,546,1
115FHnQca7FmnGuVGLP7RS2D4fk6WcxYcX,FALSE,0,2725,2725,1
115ZajApKyMEdK2NpSBWApesEN61Ws9zCT,FALSE,0,546,546,1
114pkZ4zA37xVog6prBCxhhdjVK7zkwsdE,FALSE,0,180556,180556,1
113YPJ2xCU7VMNs9Q22jviTBJVgfYBnEqD,FALSE,12300693,12349317,48624,5
115HfXyFTYKS9SttjVb4Spob96KjGjmA7m,FALSE,0,30200,30200,1
114YStoFwfq7GWwzgvT6N6WdSGcmyhBAz8,FALSE,0,210000,210000,1
114MiTMoanBtHJeHpr5L8Pra3cwNzeAyeY,FALSE,0,5480,5480,1
11474Mgkw7mZokfax92PLhGQ5wpmdNegVE,FALSE,0,20031,20031,1
113YZN9B82FrZcCFxVtDRDFGGZncSCgtp9,FALSE,0,1572,1572,1
113jRAtRbStXAygXPv3gi3roCcgF9V3dDr,FALSE,15700000,15750000,50000,3
114RgTMP37Sa1wpT8xoS8XNR2M3XR8NyEH,FALSE,0,8635579,8635579,1
113XfRWsPjDB9aDanhPb7hCpihdDe4yahQ,FALSE,6318626,6318626,0,2
113hsHZPTMdoqAroCurBjWHXv3peMYuAd,FALSE,0,875301,875301,5
114edQT1Jfw4qhwrM8thJiXpyALcciLK7Y,FALSE,0,30000,30000,1
115AppQoaFq9qbuA2v1WDExEzxZVky3Dvu,FALSE,12918054,12918054,0,2
113bHnRyD6jNxzwSqS2FaB5ftbd9c8qH47,FALSE,161984,176571,14587,9
113aV3cr6FAr7eRFhdMw6QSPg4aaCKZeb4,FALSE,0,7182,7182,1
115DBt4RbKY8uBrJwaHH7h48ubZ9z2Yncf,FALSE,555493757,555593975,100218,282
113hYrWhPevR1SCebkNbYb4fod1UMAfnr,FALSE,0,600000,600000,1
115ML435A4Dt79v48ZqmPYfs4Bu7Zomt1J,FALSE,0,3974015,3974015,1
114oYNb7LUUoyskVqRDpb9Fhno6sD7eKFm,FALSE,250000,250546,546,4
114unA9dR1hn5tSDeAg8Gd6ZmTw6nF7TmT,FALSE,0,500000,500000,1
114k5nSeYqBo4xofmis8zz3tkjK2zYeLgy,FALSE,0,731786,731786,1
113z6iXdnWoC9qL3aWm43zs9AojJ8p1LPp,FALSE,1515679,1515680,1,3
114GeGizUw2e4VJDMuJTbsKUkmT39rcVMs,FALSE,30000000,50000000,20000000,3
115NQ8S2CJtX6SuoEjZcALJXXiXLpVyncW,FALSE,0,341350,341350,1
114CEGZExqnZvdXvx7o6Tz6PJdRRSFgf8h,FALSE,0,999,999,1
114xBHJ4abiauYidXDWfc3LNn5gWd56jK,FALSE,72809,72809,0,2
114v1XwhnPs3gPSyupSBALVnsH9f4ykfJd,FALSE,0,13343,13343,1
1159VLG31ybrddPNJXjZrzS2E6yDJtxTca,FALSE,0,24026,24026,1
1159fe2oVd4Nm9GTThF7TvWzdwcoMA5kpN,FALSE,0,100000,100000,1
114D241H5q6bPszTDpFd8eEE8ZgvvtyXgW,FALSE,0,5480,5480,1
113sFdwJ9tiGpnXLmLUuADX3MCLgQUCsyY,FALSE,0,278952,278952,1
113cMGHDKHvzHssZPVisSHtmDcZhX4aK8C,FALSE,995017,1020961,25944,8
114x9k2ySyEgv5dtTyv6G4fStVargRTjSF,FALSE,0,65366,65366,1
114C5uEaX5PM2mzKXHLEc98vRvU1Vb47ix,FALSE,0,2288238,2288238,1
114v9i5b3tNCkCzrNTupeygf1Gxh4XdP3j,FALSE,0,4601983,4601983,1
114fKvPLLgnoSMjo4weUgQEeLXHZXwKmjH,FALSE,0,587600,587600,1
113woPHdGa8MraFbPfSspHG8WtP1M16FYy,FALSE,0,10000000,10000000,1
115TqHVCfdkM92SWEjyPBQbTTZbqCjuLqo,FALSE,46650000,47710000,1060000,2
113rq6XRCuxrh9ZdAptn17HCahAqgnDqFm,FALSE,18481,500546,482065,3
113m66TXYYGHJj31mj3Lm8mV6Rre1VTku4,FALSE,0,326680,326680,11
114XY9WSuwn4VQWEjQ6f9NNE5iTTQCq45z,FALSE,0,1481,1481,1
114GBwqXbnkueLTvUigf451SEfsnpWsvW7,FALSE,57460000,57500000,40000,4
113kibAUhSgMRyoEZAfF8YjFycd3CZVpQY,FALSE,11670000,17057500,5387500,4
115FBNHdyi2p3NXeA9PUpjXxru7kTF7sA8,FALSE,0,47179463,47179463,1
114o95KET1SiyjGwQsJrTTBQQMVG2uRRRd,FALSE,0,498419,498419,1
113XaxkgESxHCtNjRkh6p3wZSNZZiqtrGx,FALSE,0,41483,41483,1
113ed44MaK1roF5hLW7qA6tkRKu9W3kLVb,FALSE,411358,411358,0,2
1149BvFjcXaaWdxEgwqoF3yMCzouH9dhdn,FALSE,0,500000,500000,1
114KAzgXFL6x3cati63n6uuhshwRP7WVvE,FALSE,107297,107297,0,5
114LkDCxkvakjqrTnsTWPDpERjS7vTuc8H,FALSE,0,830,830,1
114L9AQHgnVziWY8pbJjc4Zzpkd18yfWd,FALSE,0,546,546,1
113twy85XeZzzJ6ZEG1e4L19ngHecWpT25,FALSE,0,16698,16698,1
1158BpU2w6pSrr8kFmM218bBLdQNoveqov,FALSE,0,20186,20186,1
114nU3r1bT8HEdoacaU7nEJJm1Vn9YnfF7,FALSE,0,2500,2500,1
115Vdyt2nrmtTamCAs5ov7Zbgt82CaNg7u,FALSE,0,550606,550606,1
115bQHkTx86wo4va5SHwKKZSoCncjrAWRV,FALSE,0,37868,37868,1
115MafgQ3Nt6EDwvEGuE5CcjgtMtDYaq9C,FALSE,0,1,1,1
115Pyyhj6XpzERPGw3aHeptXNT3Hosxsrs,FALSE,0,413894,413894,1
115TKdS5e4Xew3uqjbx9oqLrYTcy7ZPRv5,FALSE,0,2925538,2925538,1
115WozrcFsGz2BTY6eWen9Vp9A3MG45xCh,FALSE,0,629,629,1
1159SCDorRxfomeZ6hctFVUgm4HhnP81Lx,FALSE,0,607863,607863,1
1144K2JXGdQy3T5eLpiQbFsjTMtm9DRgCw,FALSE,0,2507,2507,1
113dR2VUduWMudSGiGiHN5d2pGqnWMZRjq,FALSE,0,587,587,1
114BXPumH7xfV4u9Chd1oGfQccaNVMWjjQ,FALSE,705,1252,547,3
114AHHUFemSeJTbAHj6riEDM3hFAhAbJT7,FALSE,13000,19000,6000,4
114QmKncMsEiFCtSh1wnxsfkw94Sy3KRVq,FALSE,0,2250,2250,1
114rK5ZVJRLAHngHR7ivCdT2Jcfn3FcpCF,FALSE,0,5480,5480,1
114V6iWzVwDQWX79hBZK61dS8FAeUZNzJ1,FALSE,3116,12546,9430,3
114PgNABDwoehc7Tatu7qmfxg2eAj8j6zg,FALSE,0,398507,398507,1
113Vc4hzSUNGxxhhr1N1hTwRMskV1EMrT5,FALSE,0,9506,9506,1
114avwiKbE9Z8n1YUYB4QeC5WuSFHf3pVC,FALSE,1042761,1871902,829141,12
113htDEtWGyY4JkR36B5msT5QNYVLAQHJQ,FALSE,0,566524,566524,1
114J3CNoqVrxXxxvJPosT7G9FfQm3AARjk,FALSE,0,1200,1200,2
1151SLhVTVAFpy6TdBFLfzBwsq2KNtfcN7,FALSE,0,3731000,3731000,1
114MiTMocKaeat99kvSeZwFb6hfLRHi23X,FALSE,0,5480,5480,1
1151fVwdZ6j3iYWTX9TfC9rsfZNZ6RG6qQ,FALSE,0,2872,2872,1
114veMB8St6d6FQNC4TGNZAZW8nNTKvgRi,FALSE,0,730887437,730887437,4
113KjZrQWFjyY46FHwQcW64rPhwbg6CAcN,FALSE,0,48299,48299,6
113D3sKSHYRpj4Kdko3VeGdCd9RdUiKWSD,FALSE,9446,12470,3024,7
114GYSwEZyHTDf5KUdVeHbQaD9LiPySdmm,FALSE,0,31620,31620,1
113bxFfMCQj4tqCNfstv5xKt9enMzF1zoB,FALSE,0,973332,973332,1
114tk6FpNPkvcTcUtuiTBVw7hcTUUzvk2F,FALSE,222408,222408,0,2
1149NJAKCDsrUv8R2m9CBmrnrwiXUkfsDM,FALSE,15100000,40212000,25112000,5
114fV9PF1ybt2965QY2sRZrGKpNYYRyVK4,FALSE,0,7817,7817,1
114tpj86zqUctgYqj1R5C1DoCrQnksJKpd,FALSE,0,469466,469466,1
1154esQ2yXn7mQ7zwy6WWKjMqz4n4drumC,FALSE,5522881,5522881,0,2
114vhjjzoaMv9uXT7rccmifUdUyA94zgg9,FALSE,174055,207377,33322,27
114CD5GrbhQtpXPbhdJTMXWNAGWiocFSuc,FALSE,0,2735575,2735575,1
114ixSeWzrr8So59hiw7aXyJMWRMcs55TE,FALSE,2496264,2503152,6888,68
114iQ945kxX8aCcXpogHKTM4gYMP7CFSgd,FALSE,0,1000,1000,1
114Lt62QBcfeHXvuwGZBc6G8SADn78iCtg,FALSE,0,358943900,358943900,1
113KExbZegMDkjqrAoFKUQXBvvUJwJd94x,FALSE,0,124230,124230,1
114eHyc2tAdPTaLCXaYMsimAAetMpJAPw5,FALSE,942000,982000,40000,18
114m6ahN8JMZvBqM5v7wYayYyUX5rFGDVz,FALSE,880595,961867,81272,4
114A7NszeqWcPCvKbfPoRbJ3opxRUMMHw8,FALSE,0,12993,12993,1
113Mg8uaEoBG3av2ndPEtZzuMc1BmsYG7v,FALSE,546,1146,600,2
114a3H7TdprYT4tgWVD89zPwYWL7trAhH9,FALSE,132970,146500,13530,11
113EoygCqvgTuJbbBAHekYvURtBwPBDVhj,FALSE,0,9514,9514,1
113J4TYX45v8WKS8Vrr761JeyqD52KXJEo,FALSE,0,44580,44580,1
114ty1JKZVG1Wvqmr4C7xqYtyAMGRCzZrc,FALSE,0,527984,527984,1
114VLnDr2eZQEp98L3hFeX3qo5WtgPKMBh,FALSE,0,20965,20965,1
113hKC88KQsasjzbqfYo3d7ixUL9QUAq8e,FALSE,0,4273000,4273000,1
114yMAgUKQjNFvwpesrnet5Tar7nbGDVKc,FALSE,0,54480,54480,1
1152yVQwoqoNjPerMKFKG1hdLKqFZySp2,FALSE,0,3202800,3202800,1
114fgc5PoRowkKoMP8tihRxJRt4LhzJhey,FALSE,0,1000,1000,1
114EKYxmkHm74qmtHgbstTRNNBZJLFY5Gs,FALSE,0,2981,2981,1
114T9yvvwr2d3sZEMz54jGfgmsEkzKKwdn,FALSE,83760,83760,0,2
11353q2NGMsRcZ1oiTKYfDGCLztTjh1oP4,FALSE,0,75519,75519,1
113YwB9ZYKiaNtRoMACbSxK1Mq1RdVhkbW,FALSE,0,144721,144721,1
113srMgx49j3nX3Af7hKMkxxQLVDKhexKU,FALSE,0,4764,4764,1
1145Q5V32H75wR8q7jPQCL9uDxxPV1XiXL,FALSE,418265,418265,0,2
113Qc6JmdjPQZSuR8A1FtTGcFRT6Pukci,FALSE,33759700,33759702,2,26
113tHHKaT3HsMonAc6d6YgXRmy4hC9LnUn,FALSE,0,54256,54256,4
114mw55rU426CHSEjXFa71nfYHjhZu5ZK4,FALSE,0,43220,43220,1
114fRq6rEtqNdLtWrKimvhBfqs3Pu57N6X,FALSE,0,2031,2031,1
114FV3NYXDubnWkh6PZSqScUQeusMNY1We,FALSE,0,2257,2257,1
113HKqzaWBe2HW4v5ucYxQURjMqwiyvdaw,FALSE,0,8163519,8163519,3
114pcgUYVRWYirZ17H3jhLAcU5sGVGpZ5t,FALSE,0,36320,36320,1
113nNWGeghKMuohtWEAeHDhDiaWQXYh7XK,FALSE,160000,160546,546,6
114kUuj6feTxsDRaUH4mLyCcTDpPe8dERx,FALSE,0,25690,25690,1
1139amFaUdMHiQRRDVNq4VfhKonUbstaTd,FALSE,0,69444,69444,1
113eeqRcVeQEACcqUkm1TzbSLAQhUyA7S9,FALSE,41017179,41048682,31503,22
114Xtnz67MXmGDi4w4AhJQ58gqQMrjorKq,FALSE,0,5185,5185,1
113wzW97NBt4nBqXjuyQuAFRfhG7Kn4gJ6,FALSE,0,25000,25000,1
113KLon5tQENBaGfpNfwkRkhYSwNTL8RUz,FALSE,1420000,1420001,1,3
113pswvvuM8wGrDGT4dmgu5vYvK4WP9Br,FALSE,0,119270,119270,1
113vZr6wuCbdwdJ4KnfWHb1pvgA8B8rPu4,FALSE,0,7566,7566,1
113oGmwpi5oEFcNiRLf8XgdEadyP4Gcvu,FALSE,1111808,1111809,1,3
11552B3RjGjUDuAW6BY7kSMCQVqJDDaYcw,FALSE,0,3518,3518,1
11468LFaCi2MZkr4z4SnVER147d9nuUXKH,FALSE,0,2500,2500,1
114a5vYw4wH2B6Xtf8wm5rHDbtWRQLGS4S,FALSE,1053390,1053937,547,3
114M89VBuoZae6Qkity1U3bRt48eRwCNsG,FALSE,0,37850,37850,3
113Wffw2dkziY2paZHGpNYhVbevfKVt1Nr,FALSE,0,44675,44675,1
113Anu8uCjwvKvegKJyJhje1RRgLCFJukj,FALSE,0,37076,37076,1
114Y8kQ7LGfEFLKVzvAoDCMMCW1qWujTE9,FALSE,0,6000,6000,2
114EnaHXVqx2sLmTiLvHfR5JGg48Je3XHY,FALSE,0,711326,711326,1
1139bUF1YboG9vaTi7zEURewoyPmobcGym,FALSE,0,5500,5500,1
114k2XUAVRvDwnGn4VfdUZ9SyWcsJCvtcf,FALSE,0,540456,540456,1
1141a4uQS8rJUBDtqGxhSuXjJa6i5MVTUb,FALSE,176803519,177763250,959731,9
113z89X99pUrJncj3SyYRbDrra4bMmd6ie,FALSE,0,850000,850000,1
1144vkkS4YEozTvaTon3z3HFMrD31Jo3oe,FALSE,2155053,26408792,24253739,64
114VrbPngBRfWdghgJ5Q9uokJcZeofNBS9,FALSE,0,302236,302236,1
113g649Xo19SKcw2VX3sqc5wqqqW7QV5eS,FALSE,0,10400,10400,1
113Mt4N5jbphs7RjngmFdyT9EDyPVsmsMC,FALSE,22240,22240,0,2
114K7PgscJ8PCkNwbytfrKCyuptDfFGPop,FALSE,0,856904,856904,1
113UBH5FnwFjs98DTQxy96y45mF6H2zdSM,FALSE,0,1000,1000,1
114NzJ3E5vgQ5KFPubUu6DATH3GYQ5iiiA,FALSE,0,4000,4000,1
113rXTe1sn1DrjLdMbmHv6Tcji5fcuiVVq,FALSE,0,6400000,6400000,1
1133gFFmKGJSebUi5QX5y9BeVAKm4fk32K,FALSE,0,39882,39882,1
113Y4uyUonyjpyX4WAh7dJEmTPSFJpWT9M,FALSE,534550,646376,111826,5
113KuB1wYyEvo8WzNytgueK5wLhUpG3ff3,FALSE,50000,96545,46545,3
113h55MpkJWkJhAehVrUH1YJ5RQmVb1H6x,FALSE,102730,113650,10920,6
113KE29vbCfBFUhiL4wZEaYNZt4iDNDzW8,FALSE,0,48100,48100,2
113tR7kD4Aa4tGBJMXfy5knNSnabXmdepR,FALSE,0,7570,7570,1
114ViMsKTRf4LRCnY7j7mAbNbiJb3vbGwb,FALSE,0,40085,40085,1
114tTBYTgacYt13RsSmvMFHRorDS1tpCru,FALSE,0,191103,191103,1
114vQwXxc5oQsx6b3ZAbgQ34dfHavCGAsS,FALSE,0,30345,30345,2
1147csyb7Phcaw3rEssA2EBjsW7bM6RngN,FALSE,0,50000,50000,1
11524jHZb7DYQq4ngH7TZybfiri221Eimt,FALSE,309039,309039,0,2
113BcFwzvq6GMmraRRFiqT7ApGSf9dDoUR,FALSE,5564153,5605972,41819,29
1149ssDB5y93MbqaDD48VqCoEPhB39U7N4,FALSE,0,14266,14266,1
113qfskvSXH8oUDBLizRTZ5c9LSUntoJdf,FALSE,0,8900,8900,1
114YeziMDxpjhkX5Nnwb89zBiHymyBqc6t,FALSE,0,5500,5500,1
113t37Q9ZA2r4ihbcMJa3kHXD1TmSc5Ppr,FALSE,422390546,422391092,546,9
113C2zHBjLHbGxj1G3KFny4AZb8y2gXAQ3,FALSE,0,20285,20285,1
113E63vLnAq74zQzRqGDMgiK8is665tns3,FALSE,0,4549300,4549300,1
113xmF2PDGeZAxEMcEN8btafuByFcDEa6u,FALSE,0,28192,28192,1
11446VqjMYKZ6bit2fEo5Kn3CPFfC8aQDu,FALSE,546,2184,1638,5
114Uu98xLh3Cq14bBGZ8mxChPr1SEjM7nK,FALSE,0,483359,483359,1
1141jstHbsfAAFqNCGyZgL4qbYfQDRFYxr,FALSE,5005500,16423766,11418266,6
113UBKzq2YvS3PTwquLqGPvcuC27mZwWZu,FALSE,0,1,1,1
113Qwznrpww9qiYLBNsHfTttNBWZFUZN8w,FALSE,67349,67349,0,2
1138JcVrDZh5QS3eT3ViLETdbKbDu8FoPx,FALSE,0,548,548,1
1146YYrMm69pHfp9gWskC86Y8dzCs75V7J,FALSE,817696000,817696000,0,19
113WioH8RjJ75988XRGUDvazMQvDHgJ3cP,FALSE,0,30000,30000,1
114afzvF8hVVEwwv3QAfSDpMKBumAbhxR5,FALSE,0,546,546,1
114Nuw2W8aeJ67ep28jbBTspkgM5q5JDR7,FALSE,0,1060000,1060000,1
113Bb1Ey7ZAsS1SPaLhLE5DJLCuCjqkZUM,FALSE,0,15510,15510,1
114kToXssEhU1M9KSaFMAGmVDTorVvQLnH,FALSE,0,4222,4222,1
113mpYqwLPbrVcHxqzKquE3dKmW8nMBG3d,FALSE,78211685,78211685,0,114
113jJLzxUYQ7MjnmKVBYoTa2AQtMgipYWT,FALSE,0,994316,994316,1
114CpSmLxMaFZrV8fCHpSw8CJCT1cu5VU6,FALSE,176241582,176271646,30064,9
114zdLicNZcWKWewiD6N6wjgNFFLQwVug1,FALSE,0,30593,30593,1
114BbCWdR15QfcsNthfU5CqXpqbmZu5VDG,FALSE,1203746,1222976,19230,5
114kfMmo44YkHSZGoX4WTr6hsQ1WfAS27k,FALSE,0,48720,48720,1
113GHazAz7CUjRqVzh2TQmig112SLFEN3L,FALSE,54800,68102,13302,16
113EpsQmjiy1UNJARZViwHdYZMxLBRCeFF,FALSE,0,725100,725100,1
113MNYeSD7rPA1PmufvzmZ5t2pVA2CCqN2,FALSE,0,31347,31347,1
114GEHvrC6SiQDdEbVti3GTH7GvjWznqN,FALSE,0,388738,388738,1
1147GLDRmejzvHtZnktsH27uu7QeedXvU8,FALSE,0,18141,18141,1
114GSVxWCG2ZhH6owAYZwiBze8Ygh1Ch7g,FALSE,0,1035400,1035400,1
113mDbjVFwxo1MAd3w7XhedjWahcFpUs3v,FALSE,0,3235,3235,1
113gorraA26QiwHhJeA5KqJZVJwUnftULv,FALSE,0,6196,6196,1
114mvrGeWZFNQ7PPXWwmQdsmvyZNacaxzt,FALSE,0,36216,36216,3
114Hued4PLGkVdSs1MctnPQsE7pwwokW1,FALSE,0,1533610,1533610,1
114pXFEgnziPFDT6KtsSy8yBbHifso7wn7,FALSE,0,100000,100000,1
114P5oS3NEZAzNe5rEu4mQKiCPLore5WXX,FALSE,0,7125587,7125587,1
114UwT1xFbUHrHWSHJNTgmLW4n3BBNUXPc,FALSE,0,2826781,2826781,1
1151nifxTg4NwezaJFNb6iqwAHkj4tVVUe,FALSE,0,588480,588480,1
113qJwNndz1SV6XpSjPpgPkA5TK8Z4s2tK,FALSE,0,32984,32984,1
114wV3K4WEPiHkzWk12HLeUzEH6vmupPWM,FALSE,0,27370000,27370000,2
112wKgodL3HaeHmg5GSDs17agxP2mrsGqt,FALSE,0,20438,20438,1
113NjbEVNBbferayEGqimMjqgpYnBb34ev,FALSE,60000,60546,546,3
1142TGWLjhJbYdmGVTJYjujnKuobASnDPu,FALSE,423972,423972,0,2
114gECZxbteSHL2Mrz4pgUZeqWRJuFakA8,FALSE,0,5483813,5483813,1
114ktimE8GfxS1VfsY6FjPfdgFXpY9b2r2,FALSE,0,15980,15980,1
1148qn8nNs4ZXmYc93DsAbfEvbA9BaJoSz,FALSE,0,1553,1553,1
113NoExzgBPkPD3uTMqK3HG61iSCR1cz8G,FALSE,0,54182,54182,1
113MrAGKiVM6pX4116yHDDmFTnkP5fPH57,FALSE,0,341546,341546,1
114E5ML5K2rsu1PYciEWB38wrbGUbk3HCM,FALSE,0,79248,79248,1
113p2H5qnugDeqoqAYJ83bzTFuvwcEp8zx,FALSE,0,757290,757290,1
113Z83RRV4RYcENjGP3UXz2yfg3wrpLRuv,FALSE,0,11386702,11386702,1
1141v7ZKHtSLETtJNSAcJFt2gix6thRE1y,FALSE,0,746098,746098,1
1145TpNu1buM9fegUA87BcTQpTJ8E52une,FALSE,0,301420,301420,1
114qdcyB4HHjMkTAZA4hAGcHbMKYo5NK2p,FALSE,0,1000,1000,1
113Rc2qy3yW7i1hQKUuqEeQxvqgQAi2HDG,FALSE,0,400000,400000,1
114pF4PsfrrNUiKNUZbgNjgQVYZzhDV95R,FALSE,321594,400000,78406,2
11388Vg16v7AMAVGEjWBgJsRzAs4y5ny92,FALSE,102400000,102400000,0,2
112xRNK1wTCbQquBGKLNjvu2z3NnqN7fhR,FALSE,0,52981,52981,1
113joVkXiKkaFR1qProSciZMvjHzeYfyaJ,FALSE,0,8633,8633,1
114mGwKqoRXDn5Mv1s4jsjqQ4dzjopD4rD,FALSE,0,546,546,1
113qC1pJjUDLjqbQCud1Rmj9wSJJ6kxuqF,FALSE,0,394706,394706,1
114HKvn1gpY6XYWf4TU9GiNRne8NaEseEX,FALSE,0,100,100,1
114vxYoXHBKbZ9AjtVypfMKzvHoMiBYPP4,FALSE,937500,937500,0,2
1135BLqgKk7zCSSjqvBxqUnRGtjgE8YQGK,FALSE,0,55790,55790,1
113F4FjyT6hcbs1tkX6ahJHwEY7d12bnu1,FALSE,6039,6039,0,2
113zxS86pEZsd9RLBda6c6PvHcjMPcr8NJ,FALSE,0,110278,110278,1
114UQC7xd9tt6Ev8UFHWr1CDj76B7aQFEC,FALSE,0,99987,99987,1
113Ur8TvWhKFcJCVrArJ4dcvAyV93kFZxi,FALSE,0,1579,1579,1
114fWpekrDHyYBXnX2zyTqszbUPVwD1y52,FALSE,10001968,10010000,8032,4
114VfmJmNN2rbbi1CKrmL32FwwmiVL5pq8,FALSE,0,5480,5480,1
1142UR14wvZ243C8cNYjPCXmCXTVACSPxz,FALSE,7891157,7900916,9759,20
113m6g67q6LzmxMtHjijKBEcBhWANE2UTx,FALSE,0,4200000,4200000,1
114P9HFQA3V5zuLqVfyRMzjkrg659hGk9f,FALSE,0,31726,31726,1
1145eUyihV2G8aEma4ynFi5cpe59mhESnx,FALSE,0,963217,963217,1
113E9yRFKtdRewsm7T7unW8KEgvbtuXmcW,FALSE,407304,407304,0,2
113jKip54BJHm3Eue6LExqyUb2bLGgHJFn,FALSE,20004520,37859370,17854850,2
113FjLyjZ7bFfCdZMmRcWyTYnpcBZSW41L,FALSE,0,2000001094,2000001094,3
1134Sc63M7fyCJvCqJTKmxgxa8BbrwSwbE,FALSE,0,1820,1820,1
114xMxfaLBquvRUuCxRY4Wdf6QvJjqLW1A,FALSE,0,128032,128032,1
1149BPAuk84uwCbkCfNAnuu6MeMeR83zDn,FALSE,0,121959,121959,1
113WanHyv1GJfvXVd9js2gCZYeuchZ4HBb,FALSE,218149,218149,0,2
113XfrpjyaeX7nhzTtGbc2s3UykHko9du6,FALSE,53639753,53687204,47451,35
114oPcS8D8a2jdxweX74uFg2KZi1KcpPhR,FALSE,20216182,20216182,0,2
113QA2vfoWTeg9rJtpsCg2mKQeC3u68G6c,FALSE,0,100000,100000,1
114Rd3zqitYsB6GweAPfhHCf81LafowBNu,FALSE,12525050,12525050,0,2
113ogQg9mb47KbCrNhSptGgHJehj4QAnPy,FALSE,0,3116,3116,1
113f33riUWfjtzCW4u5ySuxT38im2XDPjJ,FALSE,468497,469784,1287,3
114ReUS3sR6yDTaH69bqXnvF96WVjc5sBd,FALSE,1415942,1463942,48000,33
113bf7xUcR6CviuXDj2sQs5VyRtWjXC9qh,FALSE,29000,189000,160000,3
113cX2bWmKUqgGmSLgwbfh1bVheFQeBW5P,FALSE,0,58431,58431,1
113PGDobfLurSDcCzsGjruGgNKaMv5sZL3,FALSE,0,38240,38240,1
114tcE23qfnmX8h7Skrc2jJpjoTXeELEat,FALSE,0,22236,22236,4
113JTxp3Zhckzzk4cvsZ5kyxLQyEe8FQd6,FALSE,0,615588,615588,1
113RYauXiScSrfiGDcssJV3avFS4Uvb56d,FALSE,0,546,546,1
113fntZCcAtBVYajHBm58MaijV7w258j4R,FALSE,0,729766,729766,1
113e12PZeicWme7bE9Q4imxoRHjzpnCESw,FALSE,0,161475,161475,1
113o1zcSb9HG6YKXhX5WJ3JeH2Cf8SWiZG,FALSE,0,5500,5500,1
114msAfZTNjSN9JYAWDufrB3MjSkYCWAVk,FALSE,0,12849,12849,1
1154FrjK9vYABAVedoFgSf6NeZjFuiFZcq,FALSE,0,98830,98830,1
114R4Zb4vqnYehKyo1DqkJf8db5Kur7fcm,FALSE,0,13000,13000,1
113gU3P9EPgRvyXmjJMEfu7BVLyL1UNjrJ,FALSE,0,5480,5480,1
11411uMLhdPxzzTsZXNjKNfAZ4VaTtcrkZ,FALSE,0,965331,965331,1
113oo6wdxVVbZw7bLHLsyHB5xrdtRZJuT,FALSE,0,1990400,1990400,1
113WkmhH4fCTryskh5wANWoVaAxC1uAsew,FALSE,0,251769,251769,1
114GMFneRacbMehMKNh5dBGwFMiJH1KgCS,FALSE,0,7570,7570,1
1152SvHRoeQyBiaSkmNy6HewqVTvH4RNK3,FALSE,0,10000,10000,1
114wrCJnzt1vHXY3K4Ypxhcf4RNJPZj1xA,FALSE,0,994845,994845,1
113QzYpheWzHa66eGPSsnVPut2qYUrGE1s,FALSE,0,1000,1000,1
113GGyJk9oFH14TauHG4fFCGhwJkZvqa6h,FALSE,0,2657,2657,1
114NpMgdm1ij8SzFP8cU2Wqj5JWuVoif6X,FALSE,0,2053481,2053481,1
114kb7i2Nz3VQy2ihRWCTBaMprzksUCMko,FALSE,202710,202710,0,2
114S8XeHCDfKgQU5oBEEyX1qUdDygoyZ2c,FALSE,0,548,548,1
114RyLhvGBsRATch54RGuoJTGzpQPGfDwa,FALSE,9602981,9893027,290046,23
113kufcPBNpXg9XiJhwtsmu2vJa7Hw6mzW,FALSE,0,26736869,26736869,1
114M7L8rdvRMhmny48Y4f3B8y2eQRoNixt,FALSE,4458881,4458881,0,4
113pQejj7nUSmt4sTabVeEVoWpFzasAXmL,FALSE,0,971285,971285,1
114MiTMoanBtHJeHpr5JxFj6ygf5Xrmrhj,FALSE,0,1000,1000,1
114vUq2q28JkD8VjF9bZacqY89vNDV9MPH,FALSE,64460000,79500000,15040000,6
114w595uYVvf16xKMUknZTxWJDoVnpQacn,FALSE,0,1500000,1500000,1
1147cDWGAHPfSt4VBPnUnJj5hdU8pF4d7E,FALSE,0,261785,261785,1
114DkewMfo3Gj99GLiCXBvkLwsk8cAAuU6,FALSE,1247000,1372000,125000,8
114729FckSGM6aW4dzM718z7aCAgPHchYv,FALSE,44868,44868,0,2
1154munghFS5psCZ7bVL2XdCFcofsyECr4,FALSE,0,10940,10940,1
114JUd4TfHJMMqmnnw6cW95aKf1BGpu4iP,FALSE,9676,9676,0,2
114Xi6eQqZBBbEE95Q9r5wN7yAjrrqpV7H,FALSE,0,3867070,3867070,1
114JDNfNgn6Mm8R6LEPqYUHXrKqgRXpCsg,FALSE,0,4238091,4238091,1
11413cHdVGob5jeVDCCK2tN5YmvnmgnnQ5,FALSE,1500000,1500000,0,2
113CPiHP1gzSqdWU28snt2vzdwpesBz3mT,FALSE,0,66500,66500,1
112Wv4UBv5LgDAmATvengUfobEEKwBAjvY,FALSE,0,210353,210353,1
113e3T8SjedNtrkddhxu25pRusZB6ioWi6,FALSE,0,145721,145721,1
1137sFouMgSvJKSghebjF983vZBGdNGV3C,FALSE,0,100000000,100000000,1
113TWDmcjxxts5WKQfAhvX9QLE9Fpd9CP2,FALSE,0,1006350,1006350,1
112XLsCY2WqvB6bGsn3QyeiUoED7N7aSkS,FALSE,0,15588,15588,1
114T2ad5sWvYZHzeteBX45NtuPFbewN3yR,FALSE,0,1489384,1489384,1
113HNePNPBoMgRgstENgQK8NBewtF3a1UF,FALSE,0,12544808,12544808,2
114ECMvkWBQeearXVohzyjLxEsajWqPmnf,FALSE,0,11601,11601,2
113yBPPfuyne9iTokASTonRTvxWzkZ9KCF,FALSE,0,322193,322193,1
114QmVwpw4xT2uGL4DefS72hwFxHH7RBWY,FALSE,0,14158,14158,1
114T7LLz4fsufgqBfEgaGxMJumSe7CmKMd,FALSE,0,152587,152587,1
1144dd9aaBMm7W8BbunUpD86eLrPPQ5GQk,FALSE,7000000,7000000,0,2
1144TPpyuCnTucPnjvA9fzMqR7RJ6vRz6W,FALSE,0,18617,18617,1
112wN9zxcCRg9A5GTxvnwE9hM1tk7riEFA,FALSE,2184,6006,3822,15
1142Kd7SgaqAMTwWxqu6S1YL4EvyPmp8bL,FALSE,179201,179201,0,2
1139S85ex9sLR57qRwpDTWFkU9quEuT3kX,FALSE,0,10839500,10839500,1
11377HWwh4u7Tu5cRvy5T5uyt1iCWgewdf,FALSE,0,11982,11982,1
114EEtZQZ986KCUiJnL2LKxCNuhpLgXDXv,FALSE,0,84000,84000,7
114PN4i58mo11RLMyGB2AtDSEYeV76o1CP,FALSE,0,33590,33590,1
113T1o9Z76J8RMrnVAzhyjYVvqwqAdLigP,FALSE,0,28457,28457,5
1136pMFKHM5eAsRp9RsaNqjLUzhWpG1UjC,FALSE,13000,16000,3000,3
113m88KLMu4HkddyRdfBYsJwm1y7NSRoNF,FALSE,0,290704,290704,1
113mggNZccpu5wj8EwdKN6KGGK7yMEvAhL,FALSE,3135726,3135726,0,4
1139iS18uEosxMyo4B6AYmqU1xYE9S5KMa,FALSE,0,3632000,3632000,1
113sDLUXoy2kNDaetaCz3MgwGHMTVnN9VF,FALSE,0,50000,50000,1
113uBrN5sZKbH1ihzedzMSo8RWZ5wEbmqj,FALSE,0,10000,10000,1
112aZdqngBTQh4iPypyPdJK4oYZGZKH8GP,FALSE,0,1719897,1719897,1
112v5iWH7vMYdExaVz8jtic6oe64vXdYaE,FALSE,20170092,20171092,1000,8
113zfUB4hA5qHmGmPFYLoJnXbwDdDy8uaV,FALSE,546,3546,3000,3
113SbEqz2x4khzxkNK8ZL1mPjzVJBhMWRj,FALSE,808745,808745,0,2
112eMJmi2eaqWx3hvekcCD26zaQC5yEPbA,FALSE,0,521835,521835,1
112uphtWH8aXAmeVtrbNxBqLScQNUF48jX,FALSE,0,1505,1505,1
1142hJvFKU4EDNuf1U1iH1eoTX46FdNrN5,FALSE,61550534730,61550536830,2100,5
113Wn8cAtjREtSQ7v5cEp7RBAML98KLGTB,FALSE,5077300,5077300,0,2
112ihMZSHFMcmMVsYFDmf8YAA9wTzwx7wR,FALSE,0,279540,279540,1
113LNxRvwkGYe39k6g7YWERAfgXiDFGCPE,FALSE,403420000,403420000,0,4
1144FjRj5KYqAWdkGwu8gKU6nLGWaDNaPF,FALSE,0,10750,10750,1
112XMNGwcTEekEmm5Yb1Q692cjycxE2Wgg,FALSE,0,383175,383175,1
112v8bXJyrRDsyR72x3nfx56Whq11jXU8h,FALSE,0,23113294,23113294,1
113zMH3FNUTYktFtpHf24KdPqFWXXj3QST,FALSE,0,49800000,49800000,1
113QTqurcwzBCiJSNRdhthbjG4Ukc8MtSG,FALSE,0,738,738,1
113k8Th2NoVHy2UE4sqmFMYgXruQtgm3LC,FALSE,0,32672,32672,1
113cpqEenJZZ715koYS57hspHmwCsyeHGJ,FALSE,8834,10546,1712,3
112npi94SusKPfmZ1WwgBqakpsK8SnKova,FALSE,0,30000,30000,1
114R9X7HMBWHT4beoWrukHsGhrsZ7Sc3Qq,FALSE,0,80444,80444,1
113YLqFhArRpuwq2ht6z8GdKoZuv92VWBB,FALSE,0,49964,49964,1
113o6gHTQVV91fmUJpELEWaMx7bd82msz2,FALSE,0,693932,693932,1
113nRSznsRb6Qcx1gWoH484eTEYgDQWfKU,FALSE,55436,118905,63469,4
112hnkqtuicN97cHj46XyDNAFkSXiGLQ9a,FALSE,787624,875424,87800,3
11315HSpy5uSqKyon83podq7qoccv1EwQH,FALSE,0,4115,4115,1
113qy5mFCwpPto1Zju2dgN9r9By1wuModc,FALSE,0,427055,427055,1
113J5m5jVCJVWJ7FcvwJayfRp7U1RC6Kwu,FALSE,800000,1682000,882000,6
114MbjkUt4ZQB3984zz5Fvhvtbrs1trunz,FALSE,0,672532,672532,1
113EJbNCzdNTouBKbHAokNo7RdXowvTANR,FALSE,0,26000,26000,1
114TRhQkLhU98Jxa7grBFZwr5F212aiDD7,FALSE,0,115518377,115518377,1
1136c96cEHQrHj3rxoAsk1WQHcxDaH9yZ2,FALSE,0,9354,9354,1
113dMQeejT97EDdFcBZjJT9PKmHf5o9sfm,FALSE,94188362,94188363,1,3
1131i55nwBsyUZmkY5xghFbRG4ummVkZVH,FALSE,0,26713,26713,1
112gPzkSUSm4rP83yaDRZE6ffiY7DWRC7V,FALSE,46189,46189,0,2
113ePnupb7Pj122jbF9gFt9Z7FYzmApmeN,FALSE,0,43446,43446,1
112doDf7sjUQSjWjtcR7U7AYog4w62RGBC,FALSE,0,55000000,55000000,1
112TY1kxaXFVoRNVEdixcEAjJTpjRkdLD5,FALSE,0,1000,1000,1
113WZYyPXbhakqVCSAfJVu7aKgTUsXegZq,FALSE,4671000,4671001,1,5
113GLC1tXeEksar9UbfAxGGMZgPEZLnZxF,FALSE,0,515445,515445,1
113yVhWZqRy7u1NKDKdBE9V889475VJuQ1,FALSE,0,43564,43564,1
1136kGZV5yVx4VVdUbFBgUFqotQijzHKQy,FALSE,0,85049350,85049350,2
114ED7hfnEwAvswCsphaqh7T9xJQCUpYhb,FALSE,0,189179,189179,1
113i9oZds6mZ66Gdmysxm1XcZqvKHxWzyH,FALSE,13673669,14246778,573109,14
112dDkqBBGkczUn1JBSCFCQL8g8e79ACVc,FALSE,0,135704,135704,1
113VA7FhKSeyjDdDBBF1Er8a4eYLacDmKD,FALSE,1248130,2130332,882202,7
113YaU7kNSbnmAvm9hEN4FHgronYoXfiFC,FALSE,0,5790700,5790700,1
114LkQvA6SmcvFWH9T9Yf2e8A8J2mFAsVn,FALSE,0,1127,1127,1
112Zk6ViDeBcYk8moxxhRMc5sjJTXGG5V8,FALSE,0,370035,370035,1
114WRZi7wn9XHiPLTER579cyEsiny6HsoT,FALSE,0,885954592,885954592,27
1144j3Q63ZaMDhAqJGWhjLLhauhUYFMbyP,FALSE,0,295435,295435,1
114K8nZhYcG1rsxcc1YGujFwWj5NLByc5v,FALSE,9617197919,9617203919,6000,53
113TWHtaYtwmd8gZeqmaEovh65SvYrbDkg,FALSE,150077,150077,0,2
114KNUYvDA7BrRhK1aZV23pPsnWSFd8ry4,FALSE,0,1301,1301,1
112cgjd1Qjt1pYurKctCzJ7n1TkTGUBYA2,FALSE,103118,120420,17302,2
1142FnzzLyYBrBqGmKSyvdLboZeLR8jQJN,FALSE,0,13080000,13080000,1
112ci8jGxR44uQ8Rm5LPgbofaMHnV4ZBUy,FALSE,0,546,546,1
113466GadpkdBkSC6XJb1yvbbUV9skvfES,FALSE,0,410936,410936,1
112m3dkPSFK91XTQBX1vY9Q9SkhaZEkiQH,FALSE,39363288,39367204,3916,3
114S8wh4aUpCZQFnbn2WBZChUsdQ6uixps,FALSE,0,36827,36827,2
112ttDrczr5sucYKNEq6CcyichePbovT4t,FALSE,0,5120,5120,1
114KUEqXyBv3MwKk5nMVSRzvAVkRH15Rzw,FALSE,10000,210000,200000,9
114Fd6vPZS6pGWuySYUym1C1933k1CCPMn,FALSE,0,1000000,1000000,1
112vMeE77CB5H45P1Kb59fzZFGUwAFi7a8,FALSE,208140000,208140000,0,2
112p8KakkUKdnY7yr8C2i2V5MR745E4ADM,FALSE,50000000,50047306,47306,3
114Px628mcFbgPzVogvZS5N6e4X4W39Mco,FALSE,0,11000,11000,1
113B6XLoqQXD44AdgafMiQbnfruv4gG2Rd,FALSE,16437,502730,486293,3
1131vj93iKRkRaBHTbXpynvpL3zCktFRx6,FALSE,1398936725,1399381560,444835,28
112fhEu2smRoygzir85h5pa55ZGjyhtSyJ,FALSE,1163927,1163927,0,2
113wGryTEEEJFjmFFLM54Zrd1LAnfLtiU4,FALSE,0,3732000,3732000,1
112abd5JrGFWCdywANVsyag9abAjcUQguD,FALSE,1082599,1712554,629955,7
114LP5Yt5SzijberfXpdMSmFHa7Nf7oNiA,FALSE,0,75800,75800,1
112jjYXfm6rUqRcRvq7zDuwZUWKiVXX6gr,FALSE,0,600,600,1
113E2sM1JvQtrLr74DzG1eowbYDQKC4smn,FALSE,0,30925,30925,1
113QnHzje4RRPW93erddyJ3a5VYRofRVh,FALSE,0,548,548,1
112dkRmS2CtUrqr2o96cYVvjugpH5Q42K3,FALSE,0,8528,8528,1
114F7J2SMtnbNkyWFc3UwmRCQ9oEW3wWJv,FALSE,0,3753,3753,1
114Gny1JHWNeMfxETcHw8Es4Ahx5TQrhKT,FALSE,0,1324410,1324410,1
113ppprexbYe7QDkcs93RhNiVAyeparUd3,FALSE,23591978,23591978,0,2
112TdUvEhcKWs8ZBQoMXuKfoxBWHzAjaHg,FALSE,204296,362899,158603,3
114THRfhLLLGYW23ky1CnoFDJWJn8dtSmu,FALSE,123367,138692,15325,16
113EdgYBjyaSUBcrXEJApPoESU2XFtMp2J,FALSE,0,10000,10000,1
112f7swsb41ZJXWg4A4TxcKqoEvMd1U6qM,FALSE,0,37154571,37154571,1
114SkG34ZkxqYiYYY9NpaoYiYQ3cF23u48,FALSE,0,200943,200943,1
113VdCVKLZ54cC5WvkGyewVgSWv7t6PTUP,FALSE,43439,43439,0,2
112QmdFToJU1mrp2NuM14WGmxy9khPX9Pt,FALSE,0,4606,4606,1
1134SzRQ6b57idBcawERvu1aNNgoKt1bwL,FALSE,0,414960,414960,1
112dpyrNDquptTYpua49bVxKAoSXRupQxe,FALSE,0,4180,4180,1
112psNCspynB6TbwCS6VGLbNyrxCQNz84y,FALSE,0,1052825,1052825,1
112TZb42AKUQidUmiAgoCcUWo5GAPx2MCw,FALSE,0,200000,200000,1
113mfMPGvB7Q6ZtZaBtH1i8n6usfhY9tbm,FALSE,968000,968000,0,2
1149WVNebWP6ycVwg4oL5xdwYZxFd5n7wp,FALSE,0,91694009,91694009,8
113tqUhscJCuewFUKw6FjPogcVqj2pS2Zo,FALSE,0,761761,761761,1
112kyQStVbAsfcJHGDmtm19JhuEoefEyUS,FALSE,0,5500,5500,1
114EhZTsy1THgQcNTdcuBPwLMNWsURkZta,FALSE,0,15242,15242,1
113FTDmmBMZywWMzuUFp9jG8esYKfgyqZp,FALSE,0,969,969,1
112VCromRfqGLsEiwoxyWD59JKWHs9hWLM,FALSE,546,3276,2730,3
1144aQqkbr2VDMSNLkgL7Qit68D3Xhmm3E,FALSE,0,3604895,3604895,1
1148R3HEQViuSScNKPzMuk9oAXbcoKYX2b,FALSE,0,12978801,12978801,1
114FM32FKo65mvitpeY6tudoK6Mci9yPia,FALSE,86831571,86996583,165012,28
113x9tyPzQrkZirjtyver8PqP9BNYfrdSi,FALSE,0,4173,4173,1
112toPGoAPYiN32SdXWa9yPUiFhUb8Qpmk,FALSE,0,1,1,1
112whUbGQeHMAfKpeVmKSM3LmSQRaP5FPW,FALSE,0,5269091,5269091,1
112ZK4uoXk9QWmrzuogxEBFGnGCT2uy6HA,FALSE,0,986020,986020,1
112t8HBKnX24D2d9ZouhXryo59jTvHmv26,FALSE,0,2898730,2898730,1
112jjCfoEjKTxLTS91cX5s5Q57iE68uwxz,FALSE,0,10000,10000,1
113qZ2AyujH892H4yXF9ybJH7aBwwYd4Mi,FALSE,0,2617810,2617810,1
113CKFKbN7vppsSffioyhFZhZJhch2Cj7a,FALSE,546,1092,546,2
1143ymRabjRW9d2EjQeKvxBXGLpZ8SQc6T,FALSE,0,546,546,1
113ZX2VWeS521txiWfX6H8pvANU1N7NJzG,FALSE,0,14379,14379,1
1142S2hVxLDFb72GJaVzHYbvcpzf2U2evW,FALSE,0,5314,5314,1
113KQe78WUe9JHQUa81GFrboVSC5W666sL,FALSE,0,547,547,1
112pXUTaXoJ1tiEH852HaVRWJGqF1fqCj8,FALSE,0,9676,9676,1
112kkupaUjuySh2XDU5ABmLDGWKS2Bpt7d,FALSE,15612,15612,0,2
113iFuya3kqYou1XgVNTa2AkBVHGmnsUDL,FALSE,0,6400387,6400387,1
113MCFkJJMLbzEUSBvFKa5EkZcWkNt13iV,FALSE,0,172269,172269,1
112vWzPxitJCt4EXKSuybb3zoPRvKL5NUY,FALSE,0,219136,219136,1
113fsShJ4spRsaKMM59B1CVY7Bj8a4Lh94,FALSE,0,1000,1000,1
114XqNzUTS6gb1TW78WgaJvu9LEb33Gr63,FALSE,0,5500,5500,1
113T3jUiEV7EEdBc6vw6AiChjpUAPxR2ZY,FALSE,0,102246,102246,1
11323E31gZYWcRfmUYrYwYQnsZDDn2VXqV,FALSE,495629070,495726134,97064,659
11439PxrM69aiDvZZsR6M234iTvANPLtob,FALSE,22471386,23461211,989825,42
113wrzhHhcg6W328HXMqFcHhV1GoW7YLP3,FALSE,95665937,95665937,0,32
113EC1pHerXTksfSupUgYkxA6UNnCn3V6Z,FALSE,22091,22091,0,2
114HhyRxy862QyXCgRwkdYBL7n6zQnvJ6K,FALSE,17341676,17342223,547,3
113bLwLcWrwhsQiEBRbQthJ2frmz3M1BiP,FALSE,0,5480,5480,1
1149eKgm8EEdm2DyZNs1oTHkR8W7QJdY1c,FALSE,0,995491,995491,1
1133kxTa7byfc5sGaKgQzWtKzaFXTZtEW,FALSE,0,100000,100000,1
112oPK4UttiQXmVGTnUREMHapUAdmbpUSP,FALSE,0,52427,52427,1
113G6JBwULtgmLFPejkV6Q9fsq8yMzAdzY,FALSE,0,3592334,3592334,1
114Ji78zrxVeo8ukRanbYBPrp6WBCkrbZn,FALSE,0,58174000,58174000,1
114QNo7UCSP9GbjqCgapMsVcAQLQGQ9fuG,FALSE,0,1590,1590,1
113wvo9LaTfEj4JWowqeYA6KhWj2kG629b,FALSE,0,115553,115553,1
113LTUZrzLjsquiwyVaNhP9ai1JYsaK7EK,FALSE,1437497,1437498,1,3
112SmHzUPDWD3ZUD2uaxYR4NdpCBUM2nJ9,FALSE,0,403948,403948,1
112VvEAavGAkMKCLf89AVTYUByYcH9rSdF,FALSE,283678125,284000000,321875,3
113tKCjJC9wbwXmkqgaphGbPgHBuHySaFg,FALSE,10639,10639,0,2
1147nwycFC5g4cwgKvCvpUBFxkCJTVEdMx,FALSE,0,12000,12000,1
112XnWFWT8PCNo3NGiqD6wSHXpBvzoeuLQ,FALSE,0,31855,31855,1
114SWFDcFxchPExuADp2EvVzEY3fpt5zYf,FALSE,39664712,39664712,0,25
113gu5b13N1rVTWLHLmVPa9FTBdf6owpkR,FALSE,0,356751,356751,1
112vaXCo4TB3q7Kp6R1G58S9kHNoydKxRB,FALSE,19337155,19854419,517264,3
1139CLUcXLSM1JzmsVL3RaJbEDvd4kMJQU,FALSE,403665668,403665668,0,79
113DZ5g4AB1fBhBkHqaxS4t6563h5uvGR2,FALSE,0,7666,7666,1
112X2vDUsyXSEi952EqRL5nsQicQ1tDFCq,FALSE,0,594976,594976,1
113tZe5zXYPgVHrtbvdc34SW5PB2GjcdaA,FALSE,0,65000000,65000000,1
114VwjuweRs5mE6FBhzFigqLujSVNzSMDD,FALSE,0,12332,12332,1
113ZjbzZU3hUEy7CH2WV6Ajwf12CXhqeCr,FALSE,0,483465,483465,1
1141EcixW3Xo2i1gKRuboH9LhvuRScQWhr,FALSE,722200,722200,0,2
112zf1QDy16E3LEPDNP8QD6w2tqaSgMAjG,FALSE,0,1000330,1000330,1
112VgZDv3VbaMcEgfMm4x7FtELQeNBK66y,FALSE,0,18700,18700,1
112x5nErstndgKjRes6sEJUtoc1kQxQZtn,FALSE,0,6528533,6528533,1
11329muPL19wgU8w7U2QppnJwHYzuSMVMC,FALSE,0,8714560,8714560,1
113A7QMmtyvUvhU9FVKrMGSAZcCtZW8LT9,FALSE,900,502730,501830,3
112rVUrmqXdfM1bjsUA4ZVy1NjjX7nV7BU,FALSE,0,155224,155224,1
113Fma58iFkMS9bc2FrtBe2ieHZ1mGuQvA,FALSE,0,12000,12000,1
113ohsLmCvhE4Riv7DRV2Qfebae3J5Zrri,FALSE,0,62,62,1
113cu2GQaZ4xfmDzZ47H4QJvYvAjUSxm2e,FALSE,0,254943,254943,1
113UvCP4qmQUM5ScFJGpWrFSdDwaW9Zfgw,FALSE,0,1000,1000,1
113e6YaLV6x5iuNgzuSsEw4NiiTyoZhZ9S,FALSE,0,925,925,1
11314qHG3RvonBECMcUUHZnceudXDoFFXy,FALSE,0,153818,153818,1
114R3Z3hzRq4VxbnYHommt6JJrf5zerEgw,FALSE,881578,881578,0,2
114HVbxDJQZJ4HhzVBdRPkCUdEYFWuQVS9,FALSE,0,53082,53082,1
113sV6dxDEbX9dpbwQ8R4irfuSZXnUmu74,FALSE,0,11664,11664,1
113suX6pQd6FupKaBjfYwgiDEvKnxEM3ZJ,FALSE,0,21998032,21998032,1
112r3YnaPuPcJzmHXxXdiPRxazJWmqUm2b,FALSE,0,24972453,24972453,1
114H6S23dNMn36DTHnycdHoAbR7U8wzUDP,FALSE,0,580,580,1
113ZabWsu1RR6zduJbmAoonhaCUAcKzTxV,FALSE,0,1,1,1
113nPkUCqyhADMKcdKy5arxY5m7oZv9jTP,FALSE,0,10760,10760,1
112oAnKoogS9QAXMwpwTo1rTw5WVX1o9Zm,FALSE,0,132959,132959,2
113KqbieJE3b2z6fhPTqHtbVwmtvprSPBm,FALSE,0,7070,7070,1
113qgvyrLJ9nUr1n65znDiqCwQyUoVKTFu,FALSE,0,1000,1000,1
113ZNMmu3JRWEQA9hGdBaX5X39ZRLsSGDg,FALSE,341799,341799,0,2
114FefGqfzZebCuTS7GTrC2bwMm6mXFgKz,FALSE,0,32981600,32981600,2
114QvntSRUtA9RqVp3PbTnYtn6C6ZTU7kJ,FALSE,0,7470,7470,1
114MtW1zqmd5TaGByqcanCXp6qFE3xPe5f,FALSE,0,60154,60154,1
113copEvg6YjPhsYCaXG3tiv9zzyqEJQTz,FALSE,0,10000,10000,1
113R5nymj6GbvBzBXwYCCS79y6WJ7QDSRt,FALSE,0,95994,95994,1
113i4ifm9kRmDqitykm7x9pbVCwByBAQZQ,FALSE,0,1717400,1717400,1
112uAvifo9FzVcpsjRpuMUdrhDsfbU33vP,FALSE,0,3000,3000,1
114Y4u37jrVUQLr1giL6vxbEVPovyPuwoe,FALSE,0,17889,17889,1
114Hu2155Up5ix5bG2A4BK5ydfJgA7Eu81,FALSE,0,983818,983818,1
113DADXPknV8zandqyWWqWAm9r1uoKTadp,FALSE,0,1,1,1
113T8A1c651wnffj1LYZv7B5gsWHjJuQw3,FALSE,0,22739,22739,1
112fD1TZpd9seEpMDXnmWyfWbX88oYN5WL,FALSE,74104683,74119733,15050,28
1136nAjbuHZLD9zUXLXjpwZPYxJ8FgQs8e,FALSE,0,95507,95507,1
113g2GthfHeKUN7wbJQj5Hg3CUXPP8sWoH,FALSE,4649807,4649807,0,354
112fZ9sywdecJEVQ256AYcxc8sGSXK9VpT,FALSE,48315275,48315275,0,2
114FBKtDQeSsDGyYsvzkzQQfwP5nWTQKv6,FALSE,0,5500,5500,1
112hdEi6uHBBZb2wcYqCRBUQVxsH54EZvV,FALSE,0,2500,2500,1
112mXDgwft27oL5W3ye6ho4AgNfw1qhwgD,FALSE,89489156,89489157,1,3
114J3hbd3gcfQ9WZvenYC6VKi3EpTtMNVJ,FALSE,0,5500,5500,1
112hdTsskUgNtyikvi4VLfoyHErJrZP5Lg,FALSE,0,15310,15310,1
112edAZF5zirAViXrWUVmjLTnNhFbBkdZQ,FALSE,0,137651,137651,1
113Tn2S7bZi8J2VtG6X1GAhHb3wx1UcPt1,FALSE,80000,81092,1092,6
1142VbEyMTEvWh8Z3KWQVvbQLboHPFJbAP,FALSE,0,5000000547,5000000547,2
1146BbiRczv3ZCN9qLC5d6cAiDHnjZ5BGf,FALSE,0,1000,1000,1
113GyjWzMewbaxqTomY3EGyN2bgKFZv1BJ,FALSE,0,51215,51215,1
112ysctr2djQQxRxfK32tzAvSkBh1QeHus,FALSE,0,1560269,1560269,1
113QKAGgsdFzveAAGVGwBgLkMUU6yAksL9,FALSE,0,50000000,50000000,1
1127JEA848d4Jr7FzZwFLhV2f9PRvFeqhB,FALSE,0,32000000,32000000,1
1134JY5s46Tdt22zA48aPntW3FA3PnFG5J,FALSE,31351489,31430000,78511,5
112KaNCSZ5iwiAvR1YPe6pb6rEwFWGd5py,FALSE,0,289935,289935,1
113GoD1tFgxAFoDFDSjj9cCFHwNHwGKrQS,FALSE,0,142009,142009,1
113SB7PuRLdAiAEh44PxPXSxbBT9oj7taL,FALSE,0,69318,69318,1
113ZVCYM1W4xuaKUB3MspzdcB1MNNojmbB,FALSE,6000,12546,6546,4
112QN39dhevU4NoiLPQaYQbDcgs2VjgBYS,FALSE,0,200000000,200000000,1
1124zzjskvNZ2gZSrUyzCaHNJaAbVkZaTd,FALSE,0,8074,8074,1
112ZdukUcQjjCUcmbvDfSG8zYvKUfMqPxN,FALSE,0,239149,239149,1
113N69VuKRf4KvNaYvoznryssZ4obGb5o5,FALSE,17842,17842,0,2
112g4bmLiSxHH9Fe7orky1sGzhqYW13DhE,FALSE,0,997335,997335,1
1125UNLBJW3Zp1L3xxeJxSUwR9VEhroMeq,FALSE,0,172830,172830,1
112K16UuqS5uao49dvgJexpnSEAw5XAkmL,FALSE,0,1000000,1000000,1
113wB5SrnJRdC5Cg9qtvRSPiNPqhSohBPY,FALSE,0,100059296,100059296,1
112PDoDaLE95QfV3ZggDDZuYrKKbGSXhT,FALSE,2547818,2547818,0,2
113n5d3c3u3qW2mY3wCGJBbmjXGrkQnWRY,FALSE,0,6480,6480,2
113HpTNCAehxRnJcXRpyPxoiRMAfPQMKtg,FALSE,0,244800,244800,1
113UK5Ma8GVZ4VWQ3upBKmrRczG8MAW126,FALSE,1657283,1657283,0,2
113R2WTZNzcjzcWteYHt4VMHmWu3cg8NXd,FALSE,154710000,154800000,90000,3
113p4q8X1Jub9WkVfnnY1NdAjmyr3DvRb,FALSE,6024419,6778587,754168,6
1138ZSiC1txhTojkDUFXwT86xCCCQ4Ty66,FALSE,546,1092,546,3
1123auEpq81aDyhm8nnVbPArikTrR9eRsB,FALSE,115671,115671,0,2
1137CCkimDuhAB4d8QogvqBGqtrotbeGSp,FALSE,0,233000,233000,2
113TDdNN7E1DBQmxhoUasrhboCXAN3sysx,FALSE,1103798,1103799,1,3
113NAtK4B436BVsBu5gUXEHSra4n9a9C5U,FALSE,0,47797,47797,1
112RGedPg3PZRM2Jobk8zpcZBSyhM99dTv,FALSE,0,9929,9929,1
112QSe8P6di77KoBxXKCk2QoTVuAdQzD7d,FALSE,0,1743558,1743558,1
1125bmpB5xJigWz4xJ2eLhtKELbxMmrMqy,FALSE,0,20000,20000,1
112ci3cQ3f7bmvXcuF7DHy26RZ16FFvCbC,FALSE,0,103000,103000,1
1139LEYJtXKb2eDgeDboj5m1MBfMMh9PiZ,FALSE,290171,290171,0,2
113k2VD32aaopJV28ZEWt21Vh2c5gG8fPe,FALSE,120950000,120950003,3,5
112v3ReHJgQGmPDLmYzzwor48Xrebn5buc,FALSE,0,7174,7174,1
1124m17bWN9Uy5hkxdAD3JjdQmz7PEKLzs,FALSE,0,5000,5000,1
112VKjUppw7ZJJGiVCnfrkMjt74USGmN28,FALSE,0,10966974,10966974,1
113L1ym1R5ov63D8A6yDSncZY2Wz6VKmZP,FALSE,0,483661,483661,1
1122zggMRh44J9PjaDGJnn5LpLRk4LavA1,FALSE,0,1092,1092,2
1127Hx4JPJTqMGkDVYX4KrYLLuR9xFZV8m,FALSE,3030000,9268500,6238500,6
112JHCrMPSCN9zBxVPXxQ6aDf8rKu1pHSF,FALSE,257287,257287,0,2
112jYJAKB8W7P1S3HkoJzLqVDBV1aMc1X8,FALSE,0,4900,4900,1
112GQ4Qwg54vnU7bKLUAbwH2iCty9ZdMGE,FALSE,0,10913407,10913407,5
112dyFmj4udtHeJ47Dtt9t5bbLL1LUaP87,FALSE,0,298570,298570,1
11245VG8FFKagj6rZmUV9L7QoaCUSypexE,FALSE,2144690000,2145107470,417470,259
113NjQXvUsvqeUb7WqzSb8y5x1vfGJUTTV,FALSE,0,528640,528640,1
113QRZqRvCduhC5bdqy6gQVrFGgEos6xPM,FALSE,0,5500,5500,1
113LTteN2KPe5TjLXsvVsJUVpZX2Dh1hHq,FALSE,0,15374,15374,2
112yRdW5W7iAF6NQEuZk6JQLkfZWzZEXEh,FALSE,0,48751,48751,1
112gLq5P6ztbwDtQEgMRcguVAfUXaz3zYZ,FALSE,0,72281,72281,1
112v9uQy4x1LEMhP9pXf2pV4YnuhLnBjme,FALSE,0,1587724,1587724,1
113dRgBStrQsLg4wKs72oVhZYwSD3HvAf3,FALSE,0,114843,114843,1
113i59Z7rdzQ8W22cqEYwegKo7NR9FAxo3,FALSE,5264490,5361490,97000,9
113Zbv6t97Xt1yZp3zoZs3hztvQ8mxNbPD,FALSE,0,142374,142374,1
11111111111117ZuVHvWgLqLys4Yf,FALSE,0,2730,2730,1
113j3D7GsbDgxUS16JnXyijQHPnSWgZw5Q,FALSE,843080,843080,0,2
112zQkpwZFGcd79rYrKz75jcQw69g3mGme,FALSE,13193346,13193346,0,51
112KrD5k2A1ZB92MiW1uZzyRh2gU242eUc,FALSE,0,412584,412584,1
113opmwoxT5Xx8gKhMsR649TUczBnYw6H1,FALSE,0,852162,852162,1
112AmM5HnuUFaeAFZfb2wGzHZVDv8qAB8b,FALSE,0,411414,411414,1
112yx8LRddwu4k83g1P6NSYP8i3xFvuuqQ,FALSE,0,22499,22499,1
113uqJ2tPANjTSyHs9yh8TKAqjKPNQxYWD,FALSE,24603429,24603429,0,2
112e45FbbZQqBQULSV892dZ57GGonBm6xG,FALSE,25540389,25540390,1,5
111114ETxEsZHGwy4NSsKBKtgaPWg7hU,FALSE,0,6480,6480,2
113n1H7E9cYfp1KytDp3i4DdH3vvwV4coW,FALSE,0,115570,115570,1
1131TiNvjd3gj362SPKsHFxKCyEHTzmhAw,FALSE,0,1000813,1000813,1
1126FP5CcBu9m34ZnVMKLsHzWFFiQv5KHc,FALSE,1058362,1252348,193986,4
113hQVFeDC9PmjjTXS7Zhoyw2JHCrZid8M,FALSE,0,15179,15179,1
112WcrmB94hFJRUT6F6xEQh59g98yD83vu,FALSE,0,51046,51046,1
111oy1ZZ5Ru6aXrzJcU6zxzc3wAqFAGW3,FALSE,1513397,1513397,0,2
113kjqcn2KQNk1eFEuAb22rHWYoNAkQdKL,FALSE,0,1176633,1176633,1
113yEzHfzMAeM3fGNk9GcxVrAFUzeF3wcN,FALSE,0,1065300,1065300,1
113HRoTvuc28TbmuDngvTv8Dn9WdvhhRw5,FALSE,0,279700,279700,1
112zCF22w5qRvEjU5YzzPzfmcTuFuNJu5J,FALSE,0,9700,9700,1
112Eesf5qqwzQumwLihK8SKBfiRtM1uGPE,FALSE,0,28211,28211,1
113xMGSmc6eh1UedW9fZ6wLZWyQsz24PB7,FALSE,0,659478,659478,1
113fowVd8RtSywvxtVay1rqs961uuV2a4G,FALSE,0,6890,6890,1
112Ay6xcXJYAXCTGMaZzJM3kkzHapEYNnG,FALSE,0,1000,1000,1
113DtSZiQFBGMdHgMeTsG8Hk8BC3qFqsmS,FALSE,0,46866,46866,2
1134sjabpDe3A5nevMec2rjv1Jwa2TUWdb,FALSE,0,130000,130000,1
112mEcJCMk9jysqHe1S7xJJKtZf6q59J6T,FALSE,0,4100000,4100000,1
112BRGfavA3g8arjE3i34sKPqH4yhCfPF3,FALSE,2721340,18982528,16261188,24
1136gRadbtNfWiNyt95EcPUYDMteMSNFDR,FALSE,238475,238475,0,2
113LoVRv1RaXTPWm3YYKKgaWLGWBBkFhA1,FALSE,0,3950000,3950000,1
113cX2cKMmARVLUWoFh2XNErDkCPw2Gjof,FALSE,413096,413096,0,2
112TDug2WBet1y5KnWkNu8R8TbjbacyAza,FALSE,0,2730,2730,1
113GHG7BjfC26VZGmh7U29A4N1YXsARBpM,FALSE,599702104,599702104,0,2
1134pESrS1sJjT7CHSrd8KtX79SzFiWGtH,FALSE,5984200,5987600,3400,4
11112FvYjKGi8vuDEMTvUevvJyTqqxUjj,FALSE,0,548,548,1
113PftFN3URF9BePgADSQYNbQjmN61aw9x,FALSE,0,4012796,4012796,1
113usxfgCTHAkdwRQY9iTtudZAN1x7ehNS,FALSE,0,623000,623000,1
11276TL5zQahSsJHdqkEKLfYDxfMqBQhky,FALSE,304379,304379,0,2
113WeNJHtZMizqMi11BfCpkGzMuiwjDFVX,FALSE,0,6628323,6628323,1
1132UYarBrwUegMFxwBPKx14DS54tWZkMH,FALSE,0,750535,750535,1
1137Uurgs8XHjazkB93s8KYq6HtY8cHdpC,FALSE,0,40000,40000,1
112im3bU6U7Cb44bAGP2mV925Bm43qXC4S,FALSE,12135888,23046867,10910979,5
112X7jtmbn4MVCuHimu46CboBQ1hH1smAz,FALSE,0,9536753,9536753,3
112enW8xGb1Vu6vcVVMpZxcHKLVnaixYdf,FALSE,900000,901000,1000,3
112BjtsMWL31B7CETXtsbq1EarCBQCHWFB,FALSE,0,997869,997869,1
112nkQU85C3JokoKFNt3CUSPWVHzLsqc8v,FALSE,0,492036,492036,1
112cF5PBZBky6kA8XoHyDct4dT9ANNYStz,FALSE,90862269,90862269,0,3
113WQJAVh9Mq62wGM3qYzY82VU3w5eiNg4,FALSE,160066,160066,0,2
113ofyQZaw4eSPYLsDSDcTmVrbnKtwFp9y,FALSE,0,248072,248072,1
111Gk2Yf6SS1NMXMV17MKqsDUxxFD2zX,FALSE,0,5480,5480,1
112x7UwdjJerTSCVJmJhVy36pUp9Meg8GL,FALSE,0,3482860,3482860,1
113hGu82g7KcmmxdKX3oaGGSxPmxyoDZDk,FALSE,258902,258902,0,2
113FSJ5ab8vz1Hqq3xdwP3aZKC83jiKqq4,FALSE,0,705225,705225,1
113NW8kH7L5kibHgftMGFaHduc5iYpoEHp,FALSE,27832965,27932965,100000,7
112GvCrp1YiNaw8i5f1UtUwjZYWUVNCryY,FALSE,770000,770000,0,2
1136qTnsDP2RxnNcRyukA1F5XwMfBhgMwx,FALSE,0,12134,12134,1
113dgstumCCJ8Gmftps9kj1V7p7xhtA6TF,FALSE,810623,817196,6573,18
112LHUdtV2Pi5Vb2SLcrATavQaAGjFK1jC,FALSE,0,37663,37663,1
113JRZgMW485saVMLYKtEok8jYn1mJhgyV,FALSE,2535,2535,0,2
113j8t3rmqip4JYqcANpyUesZmersffqjv,FALSE,0,11155700,11155700,1
112pW9ueMaSZDyh9SqTcuyvMJg2xU9euRi,FALSE,0,268583,268583,1
113uCHG7rskjNsTLFUMuniisNLgNmVedsB,FALSE,0,1000,1000,1
1139zkTaRwsjRN4sT4XuhAgLRXGdXKbBMh,FALSE,0,321049,321049,1
112Xx3L4vEHNKtGbDoxrxTnLPo6khMvLpL,FALSE,0,726767,726767,1
113Uad2R7ko9HB7WcpskT63L9WPF5qpHi,FALSE,0,5480,5480,1
112t7CD3RL2Brh93Fgkvtnn2kd1YwTLmbV,FALSE,968634,1014742,46108,8
1115tMUoemgYxbn5wogxGp6Eq48Z7CcaZ,FALSE,0,11000,11000,2
113V7hY1uBc6ksgWoz8GFZWXDKW18NBdd,FALSE,0,5041,5041,1
113MgKRDfgBmCWoAhBVwCzNKbBPNZpcBo5,FALSE,957375,957375,0,2
113R8Pg87iKryV1a7aeEKGELzp1hE3ktx1,FALSE,0,21446,21446,1
112dJHipekeRZhK4U2WWcUGXUdLspiE2pk,FALSE,0,7812,7812,1
1132YxoVgXMzbA1crTVjtfGWYPwKf8a33w,FALSE,0,830051,830051,1
112Nj78padvAaghAPj18E3BoCBbMYL7tNd,FALSE,0,26251,26251,5
113rYZUcghing3tBGvM3cLt9PzbL5StzQy,FALSE,0,12982,12982,1
113rvYPVfasrqiBaHcCeMGc4waQ4a28uYL,FALSE,0,62700,62700,1
111uRSbK2DzXNdc6yFnNqReAPAXQm3HNq,FALSE,0,66960000,66960000,1
112hoWw3sQSMGbNsmzjWfeM7oDMMPw2FW1,FALSE,0,9000,9000,3
112bxQ3k92cqNmhRgLtrPg2KfnnwPxg8T1,FALSE,464236,464236,0,2
112z8EiKrbZohQes8jpS6Z7aXiU9G9mae5,FALSE,2305,2305,0,2
1131qbvj1xA2B6ceVQb4VjkMtPnLJGmwuV,FALSE,0,674279,674279,1
112dz452ePk2p6VuA7SzWNgUjBppCdpGLH,FALSE,0,6207000,6207000,1
112WciuH9JH5icni455Qypj24ZQQuX83fD,FALSE,6829,10000,3171,2
1134dxhdYxvo42abHXKVTDBuADbtXtqff,FALSE,4262367,4262367,0,2
112n83o85iRdK2URnNRD7cHHno8Rswmij3,FALSE,0,8532,8532,1
1124m18tb3iA31SqSQBs8RNFRwLfNTDutm,FALSE,6370796,6601148,230352,13
112SirT2Sd1uQDUPmbfhzRQpBbqnneThHr,FALSE,0,299780,299780,1
113x5vipCof3uH1nT4hqMT1WWeHHUz1jTB,FALSE,0,1300,1300,1
113pQJxrD5NCCf8Xq86MYTXeDmmg5VhPW7,FALSE,0,60187,60187,1
1136XJMG1rD8dLiefpgqGnNkEuXHYvwQbS,FALSE,0,997316,997316,1
112aY9AjnYBeQboKYMPx4tcSvDHLU7XKzr,FALSE,0,1087833,1087833,1
113y5aeQswfsYW1B1FC4KUZZKnt2DTHgVo,FALSE,0,9500,9500,1
113WEpN6xHcA6voXKSCjmh65xqfDMP9SXo,FALSE,135029391,135254000,224609,4
112RfxbsV4CmrcouJJiwwFaLynmznCLQfd,FALSE,0,1580426,1580426,1
112TQnPKFcGmxnA2Ezo59nDHtpFmCQLgeg,FALSE,3419,3419,0,2
112UDdQrWzeuEyZxiXrF9oGf2ShvideARz,FALSE,0,80000,80000,1
112sWBqSdomiCntUB93RgLfAfQoo7cK1ZL,FALSE,50418871,50427043,8172,5
113nbxpSohvBa18ufbkvdoJ1nVSqhcNZRJ,FALSE,0,262990,262990,1
113EgNngod9SB6vrEdjS4EddCRhT4Mkyo2,FALSE,4347520378,4347520379,1,3
112DSVS23k8hah2nzWC1cH8iowN7yEUkLe,FALSE,0,36045,36045,2
113yoeANgz5Zw2mMfLqXAXr2RFSZYPCp1s,FALSE,0,8032,8032,1
1138RoNe4bVdNPQKLYJVQMbMc81RxJtvhQ,FALSE,546,1092,546,3
113mQuEgddF8spsBRRmg4hFmNCRgRxXwzh,FALSE,1018818,1018818,0,2
113A4FprtEaeYqqtrVcyAk2eMovyoV6NP4,FALSE,0,1169121,1169121,1
113UKv5e8wMgk2kpG42o2qE7XViWrUyFCM,FALSE,297198,351735,54537,3
112gYFdwFQpR5AkEpJLwpKFD9oTb54PjXF,FALSE,210400,210400,0,2
112o2ccZVUVg4RsXHHp6GfhFS4RUE7wP8s,FALSE,11773522,11774069,547,15
111MjsZUw3arJd398JztL71yUsRKEwBSq,FALSE,0,55392,55392,5
113aHNn5sF8tLBrtTxJ2KhEKeV2LtiwBui,FALSE,0,1000,1000,1
112kafaRfr4u5TM4rBCif1odhV6cgDAALd,FALSE,0,782,782,1
113VXwwPCpM8Av94wk8SrtdHTETx1NYj4c,FALSE,543823910,560942757,17118847,317
113Rd7RTSSfdqUn5cPrqwZdbEm6TmhARa9,FALSE,0,752383,752383,1
112VF1s4ZqV21pj2DxkUuYCgdenzcTKyYp,FALSE,0,72880,72880,1
113WmEK89sKAaY5pFS8VeR8rzN8ZkRcLqH,FALSE,0,7323,7323,1
111W6jmHkN2vYaAPyBr7hheSwrvydMb5d,FALSE,0,39580836,39580836,1
112rvcdgNsgYrE8iqZGC8Gc9fqSoYptGTt,FALSE,0,11761,11761,1
112a9xzAaQLT7Pw53zqByutkYrEgyDJNCc,FALSE,0,157635,157635,9
1129mJJoCaEwm9sVQDSarKxbRym7km9Y9s,FALSE,3723307,3723307,0,2
113XSyNCCmFvgTrPXYwFDrFvnuceyQoTuM,FALSE,0,31131,31131,1
112GgBnk8jyFomyHwZqREgZJwoaBfCVFPS,FALSE,27741,27741,0,2
112g8nP9qSonBKiVXgikkJ5LXitGk8NRzr,FALSE,108135,304405,196270,5
112xmMU2xsWrnWL3yqLaR8oGmE75sUELeA,FALSE,0,10000,10000,1
112oKiJPBwEgijkZ8mWaNbRvuLGHHKXkWM,FALSE,758419,758419,0,2
112uUEdrjydopQftTd9325tu4wmgZxhAEg,FALSE,0,650000,650000,1
11112D4cdAw1PJDqDzjwqB37wx9MKFQTM,FALSE,0,5480,5480,1
113MNsNShsuUzrGn8fGfx7nFBFbn8Cj9Lc,FALSE,0,6000,6000,1
1138CqExVrrjGH2tcW7E6opYpKUFxSsizE,FALSE,1005269,1005269,0,2
11286XLa2127gdAmvd8YRiZ45wqz57jDM9,FALSE,1638,3822,2184,7
112y8hjqEVPAisamhWPcPqftmDgcrcpGJy,FALSE,0,10611,10611,1
112rE2WhfrkmahYsW49ptnxAfnXnsGotSt,FALSE,0,17354700,17354700,1
1124JWMKYfMjUzGzQfSmdpFN23dpXuwKhM,FALSE,0,33077,33077,1
112o1QsQWh8d88jZq8mhQvrbRwXbad3dNY,FALSE,0,8830,8830,1
111111S7WU9QLiUDTr2viX9GDEZ3EEXf,FALSE,0,2730,2730,1
113bj3qhwePxXS4koAJaooNrZtyv1L6ovc,FALSE,0,11197536,11197536,2
113fk5rLpzweM2XCfYsfYHni8rReBeWKN,FALSE,0,1306333,1306333,1
111111111v11111111111111XoV17A,FALSE,0,1,1,1
112Y598fesMCQnCziSfQHk63b5GyAgedKV,FALSE,0,15276894,15276894,1
113zsbNBsu3dj4rJn4wmGLturCkA4Bx9iM,FALSE,94426907,94427730,823,19
112BZWaCBZUQQ39f2rB8kwQoHDiZZotHAn,FALSE,0,100000,100000,1
113sWvHaeyoPSroPWuE4yGcxA6FTrtbNNX,FALSE,0,37806,37806,1
113davYG1b4Wk416sWVqCi6eycoUEc8BwB,FALSE,0,650,650,1
113ak9ZukHAq8txQ6ovucj8qmpvhMCCeQN,FALSE,0,7370000,7370000,1
112c8GaWpYLTGQcmT9fQtxAqtpLAHx78yq,FALSE,0,1316352,1316352,1
113XRUvrGVEtkTyaqXBTDWSSdUzBFoUs9x,FALSE,0,269125,269125,1
113ttZgJAp6djTtZG3eDRkXRSoTnqcpTtx,FALSE,0,45410860,45410860,1
113DDakm5ARPMEU5r8vgsRU22Tuh1hobv5,FALSE,23822352,23822352,0,2
113vM4d2LpPnunQvyhNTnoXXmEDPVzLCmB,FALSE,0,559,559,1
112hHrorAFjiEoWrEV36y1A3HpLi5iyNC8,FALSE,0,241000,241000,2
1124hxwtS68rjvETMYTwGikBAutx3uUn4K,FALSE,0,11433889,11433889,1
112xxmJsRQ6ucPUEGGYjWGt1eVvEYr5g6a,FALSE,2498110,2498110,0,2
112eCyajnMH6aAS5gDHaKp4kwU5oWzjFu6,FALSE,0,13365,13365,1
112tnh5SX77oFyz21174tn7H2FELzbyj7C,FALSE,0,5000000547,5000000547,2
113rEGbXuBzxGEpqnZMbHhkDvatTkvwhK4,FALSE,0,1000000,1000000,1
113zDBs4hvJfLwtxv9RMBYm7FoVeRcTgyp,FALSE,47761,47761,0,2
113kTpv8ZmMWZgk4Y7e6qKLz5fPNapbyXd,FALSE,63215,63215,0,2
1131Y1ZFsigDGqg7Yg9VRnnn2o6qDPpHwL,FALSE,50000,3500000,3450000,3
113tPEdPGXu21LrTdBYAaYSPBGog25WVVS,FALSE,7843700,7843700,0,26
1121aGZaLgd3Qk6ecog5Ne2VHX5z1BMPVk,FALSE,15015000,15020000,5000,7
112usSyHgCPRqvdZKu9Rsca8qomhTjEc1n,FALSE,0,1000,1000,1
113rw11uzasAoQWqzJ74UBYRnhaocpVwaA,FALSE,17578343,17578343,0,4
113gYuz9ioCJpvWbkz35W1G9u3mpmD28MG,FALSE,0,193306,193306,1
1125ZtDeCu7qG9ZieuyWfRsWSJVcrbaEmu,FALSE,0,70104,70104,2
112yePar8bsTXo8VbeBLgcmPeu6RfhdQ9H,FALSE,37447,503276,465829,12
113wGtdsYTZTzzPL25GfEnrCo4wjPSpW2G,FALSE,0,3992031,3992031,1
112W1kbfaXjiix28b4dLUdmXb5vKYStKUR,FALSE,0,9647,9647,1
1121VwkoZmHettWYC1Z8tnZDPm1ewvEGS4,FALSE,58283,58283,0,2
113wMsbqb4uUa7kX8QcvFuMwNQBycaAdr6,FALSE,0,1804129,1804129,1
112XpDHrhYJ98pmGJsDk5Kz5AzyfzJdikM,FALSE,0,15460,15460,1
1132UwEWL4keXvZuawwwyegZayFKL9tBhE,FALSE,0,11000,11000,1
113CnwrmBtZoYwTXqhhvKdfbuASKjUpkrH,FALSE,0,16240,16240,3
112GKwRwbeEgfHqN9XfnxX7WANgQegPppH,FALSE,0,1681278,1681278,23
112Qggnafy4imA94TiQ8uGo8sc6C5Xvf7j,FALSE,0,600000000,600000000,1
112LFs6kbt2c6yb1wESkWgVYTQFqVh9kKN,FALSE,0,59647,59647,1
113Vqz1NhwEhwE1R6Y36Xst7FVRKAuF1B6,FALSE,0,16378,16378,1
112djiPdQ4vRsgB4DJQTibUPktyJhNmoGx,FALSE,0,978241,978241,1
111LNgE2MUqvaYoqP38ZiPipJY3gja2f7,FALSE,333755,360842,27087,3
1124V5CPHdL1otJiNCAhRnVH6wZG4xd1AV,FALSE,256695,256695,0,2
112NBPUfMwLJefTw7uaAEG3Ca2YX2cobsL,FALSE,188000,248500,60500,10
1124tJzkBkh8pHyF5EhdNErvteUfUdizeM,FALSE,0,3619,3619,1
113chRiu54pVbwZvLuuYW1U68ddjm1JTz8,FALSE,0,24600,24600,1
112Xnx9TQyocoE4jycJ1FtHf2JMv784A2v,FALSE,0,2237,2237,1
113QWzFKu8Nd8BidAQyhcBJsgbJkno9va4,FALSE,1092,11092,10000,4
112BqknCv6PuKTvGRC7hhUm5399r8j1vDn,FALSE,270000,335000,65000,6
113LkJrJtyUgqkY4b6ZyW3HK7SwstfQQLA,FALSE,10623,101092,90469,4
113ZEQnnoGEVPNn2LkkXjCw9LYNds81YkU,FALSE,0,5000000,5000000,1
112eEXFcNLYXwsexoGkZGv8d1BXLGfhHTU,FALSE,0,100000,100000,1
112odst9txWRD9t2S3wyLfynibRc46Nr3B,FALSE,0,792073,792073,1
1137ZmbUEv7V6ywpJyUvGMHvkEy3aRC6D6,FALSE,2185,3823,1638,11
113Pwy5wwJBnNR5BtMJnnVAymEydEESPQ1,FALSE,0,19233,19233,1
115kih5FsnQLHayjqgfEMtYeiMw2wQXtSz,FALSE,0,111417,111417,1
116cMjJohN6mvbLwDwmex7PNTXXueEYU5,FALSE,2744957,2759491,14534,2
114aL7iauQYxP8TJANQh6QMjw2EmT34RRm,FALSE,0,1000560,1000560,1
115bqzscC58bX5wJHsi1qf1efhUrbWG3BW,FALSE,0,14232073,14232073,1
115FnbmhboaqqFDqwspdcuMWEd3m4AC3sG,FALSE,0,36286,36286,1
1156e2Z11euph5Ze6yLMVhbUcDv5mWwy5c,FALSE,0,567304,567304,1
115BpVDyxXtAtyB1kiEkGKsKLehUySuLu1,FALSE,0,5480,5480,1
115cUXXpGfCqNjWs8SqdRy1uP3Udhi47mi,FALSE,1042823,1042823,0,2
115XkPJGAE9gdFfLiubkVjWLy6SRbyioG4,FALSE,6862000,6862000,0,2
114Z6CVGCtD11nL2ugje5SCXSHTXL2YJGS,FALSE,0,8490,8490,1
114de6N7SCrQdUfa3er6osXPeqDRgKvJxz,FALSE,1282964,1496297,213333,20
114vuh8aa9LnNWHxJSjcJvoig666FkmQzR,FALSE,0,2240,2240,1
1164G6yvo72Q5hbmAcwUWaEGC2JJfvb5vN,FALSE,0,6538,6538,1
114kSEMyXJzDuLmoKzkFUVWtxfVE6T9oJS,FALSE,0,30100,30100,1
11JaAYXpVFx1TGFsT6nowEChysT2sF6mz,FALSE,11734862356,11734874494,12138,170
1163EFKAjsRJZD7tU3qDi2FQq6pt1Gs3Zg,FALSE,294576,294576,0,2
115qiJZsRmXoF7Uhp5P6Txw5kXHtirQmWc,FALSE,0,470120,470120,1
11KtK4PV84n7ePnvzCsJbTyfgo8FDaC1V,FALSE,0,23728,23728,1
11NumberAndTheyAreNotGoingXZS3ysg,FALSE,0,1,1,1
115GRov8d8iZY6ZF6c3dfct5gTbJ3fw1ia,FALSE,0,19806,19806,1
1151bo5VxToydBpidhss8bC9vCfFYAScbY,FALSE,0,5437383,5437383,1
115hSGtoNHykqR9mbB4yKZLH1AsZ7UTyaV,FALSE,0,5927,5927,1
115ng3SoLigXsqcgXYtc3CcJLffBTyWPvg,FALSE,50240,106006,55766,14
115TNGfN8nmHJkRGkoBA2fBvof2253QSpr,FALSE,0,1000,1000,1
114caRpR8f8xDpjWZCgbWJ3G933VontLUK,FALSE,5627547,5656758,29211,11
114yYUw4dAubFKV5HVpKe5MWd6Mt1NnQT5,FALSE,0,14348,14348,1
118L7MV8v4Gy4uS4GdcL43mtoVSDDkAka,FALSE,0,3947,3947,1
11G5xS3rkhXcobe7aEMyLjbuWecwAKbxc,FALSE,500546,505460,4914,23
115F8kTssau4aFjcvxjpHHKJZ1ekqhZ6iY,FALSE,1990221,1990221,0,2
115T5tSpJuNkwEdnaAHns69uAUivCaLe7F,FALSE,0,6436,6436,1
11EoeiizohJsDnvU43h7LGXK1yMmmqUFQ,FALSE,869406,994228,124822,12
119PNNizmqVYdsjHVzxNQHAoSesuZpb12,FALSE,0,5480,5480,1
115rdTWqu4oqtjfoWjzE6mogWEzdfhEko9,FALSE,0,1,1,1
114kNv4YLBKqJwKNp6whBLu2fRSYZqvTw8,FALSE,0,800970,800970,1
119bWdhPq4kpq1ZX7Q6M42UYkpzam1dQz,FALSE,1458963,1458963,0,2
116HPCKUZoytoR7wiWduC5mdJimCHYXhC5,FALSE,0,17407259,17407259,1
114vyLzHPoS6QMXCZGpuDaHsmsMGthkNDA,FALSE,676365303,676365303,0,2
1156Jem7xgiUVqz6g6Rrf6ksUA2Mc1WjDw,FALSE,22701398,22708659,7261,19
115H7hFrReLTwdMkFaxCnL9oPeMUegk7Mu,FALSE,0,8595,8595,1
1161d8fuPfB658M62PdEp57uhTweXNewyS,FALSE,0,43924,43924,1
114mkBmfWLSf1LmvDg6kDMdfJizNC2Hn9Z,FALSE,0,6637,6637,1
115tJbTrkoJ6ij53mET9yysdTdvVxk6Ddk,FALSE,0,3135935,3135935,1
1162CZLmjN4cKZ5GsaoCXVvBJfQTki2vBi,FALSE,0,1000015,1000015,1
11MhFtRzQR3Yx9HeUybBEJ2s4jKsiawHj,FALSE,0,367600,367600,1
114w823HotQqBfTgMYX8BKdActo9Qfu3Tp,FALSE,0,8130,8130,1
115UFD9XfNXP4uTjafH4mMCRt4XVSmDbr8,FALSE,0,43387,43387,2
115bwGr9QXF225qJzAURFDciWifG5DUJaN,FALSE,24699,82145,57446,6
11B6t4xAp3DJKrGgiFWqFXYHpRFouErTH,FALSE,3955277,3959132,3855,14
1151pha7VEZ6xLN2vejcUzDJ3GA2jqZ6fY,FALSE,0,4972,4972,1
114uv2j2zs86qJtG3r1EB2V4yeQejbEwDx,FALSE,9639,9639,0,2
115x5nCFpe963LrxBHCcK9X7stu5n1QNfQ,FALSE,0,3595,3595,1
114reFuADAtTrH2i9odxRuM8q7SeSGhAFD,FALSE,56906,56906,0,2
114wDfRGwwM9bMShkem8xqULscvtwJ7dQm,FALSE,276794,276794,0,2
11Rqnat7Ag8VBh21s2qZToPYJRc8SXzdY,FALSE,0,100000,100000,1
114kZXUa57Ujd6ZZzaZynbEQMe5GryeSxe,FALSE,127868,127868,0,2
114k3BUsyAPQnqvFYaM13j2W17rHgPbDc2,FALSE,0,12726,12726,1
115wr9YFufSLz9nZQFa4ybep287DkZ2avW,FALSE,308576743,308582449,5706,2
114ZwoKwMBFn9Y18YyFssJi1vnk22jm1dc,FALSE,0,10000,10000,1
1167JyVa11gtLn2FgBqvbiNNES1jatCUL9,FALSE,0,688628,688628,3
116HRVWdBD3ANyA9wuocYz46XEDEN4wEwF,FALSE,0,880,880,1
115Faim7qVvcSAwgBi6wDncyWM1Rvxr87R,FALSE,1780624,2349556,568932,67
11C3ZKJtsPjfuoB6LdHPKCPRxVTyTK5uL,FALSE,0,548,548,1
11PwDt7fUQ74RjzbC4Smejv2GX7FJpvAq,FALSE,143269,143269,0,2
11EWJbooSqDd4gDngi5afz4nuCLJ7Cezc,FALSE,0,755690,755690,1
1152PmR2YsiPpspEtiRNNybHtMqBxyz1Du,FALSE,0,5500,5500,1
11RPEaWHJKqDVH9q6zuf4sg12RV8U4m6N,FALSE,159730,169115,9385,2
114o7ygFVc9rPxdyccpJ8sL3sQKam9wJV9,FALSE,55561,149525,93964,8
1169dyw18rwZiAvvJjEUpuvphx8ySvrEuA,FALSE,802494,1022494,220000,11
1155SNxpvHApmFmcghGUfWuXpQpxwiu2yt,FALSE,13000,22000,9000,4
114yWb9zZWpNxivujERN6cmFcgFgKSpdNu,FALSE,0,1557509,1557509,1
1163wgq46myZZmEeCQkgtMdjtaWcFeLQtu,FALSE,0,4859,4859,1
1156zNZi4GWiaKcu8AidUxX9vPUTcEe8Sc,FALSE,0,1357400,1357400,1
114YFSnTn973psJ9CLbc82NboYLgMu5tJh,FALSE,48868,49415,547,3
1153fVAD7UbxWbKzikiS7AyJoPcta3ZvcT,FALSE,508560,508560,0,2
11EJFSibf5t8A8wx9BMkyqhPoRRFUmwE4,FALSE,0,33844,33844,6
115tosBKTiyBSWGxEDmeKQd3W1ipSsSTuN,FALSE,340000000,340000000,0,2
115BD4yKtqVgcUq8eDhpQFE66aEJRSeZDC,FALSE,130000,130001,1,3
119cvnBQUVbPv7VtCcU4ngtVNoZmKKPN3,FALSE,0,5800000,5800000,4
115cM2hHV8gPFZXcF8uf69pPR555X2P473,FALSE,0,240000,240000,1
115fYwGmAe7BpRPDPjqpMHp3sK3WXwXS6Y,FALSE,0,603430,603430,1
115ewvX8MRSeXsmxef2fWGxtHTHNyFJXYp,FALSE,106375274,106433122,57848,9
1156XTwpsUrCchHS6ak3Yh1Mocw5aaMa1N,FALSE,0,8700,8700,1
1168puzvy8MfCdfkLZgv2EWJzwcTER5jXE,FALSE,0,31641668,31641668,1
11HHUSbrsoDQLAejm4Ly7NbV68HbcXSio,FALSE,0,1638,1638,3
115dYX1sUQnQQnQhoBK6C3RVWzUKC9Bw6H,FALSE,0,3147510,3147510,1
115GfA4AjopDc6zkanT59gSFWJtGjdQRdZ,FALSE,0,1011858,1011858,1
115BKM5BXrs9sLS2xhMtk91scdrjiCuT45,FALSE,1832,1832,0,2
114sRtTgCe3agaxzC3uJhRvPrd7arY9Vcu,FALSE,393000,455963,62963,2
1157Z6qKm3ueZz8SWdhwSF1UHkebi4zpbn,FALSE,0,76254,76254,1
1165PUWcw1YbJiixsipCaoeSr1QHZnLobz,FALSE,0,100000,100000,1
115kXi4vCP6qbBBciczBiaAGSJ8Bwh5iit,FALSE,0,149257,149257,10
114rSxWUUm5QQ7rQkc1TcAVtrJtpeMewaG,FALSE,180635507,180694500,58993,165
116EGLKRbgEo7N5VCf5NE68w2jzi3SFngL,FALSE,194269,278001,83732,3
11LNVtJECZSUt48buRiej9K5Gn6LK1URT,FALSE,30000,30546,546,4
115cpFwcFBB4L5LsWUtjMUvdhkw48fBnLU,FALSE,5500,11000,5500,2
11S2B7us5FNPsTU2Fygw4BJBQLZ3s5fK2,FALSE,0,638671,638671,1
119gSeqUffiH9BvsQyusrzDwwuaKSc6f8,FALSE,0,5500,5500,1
114kDayrz89agFrPtCQBSTDT5q41CCydMx,FALSE,34864,97600,62736,6
115DKeB1FAvQZWtbMJhJfjUgsk8jbS3Bdr,FALSE,86190,86190,0,2
1161hS35xYkNZnngSXXZWo94FFQaAkpKfB,FALSE,48203992,48215640,11648,107
115o3fnDTJYFxbuVFPr3MYhV6wNtoYsFNt,FALSE,1937208,1937208,0,2
115XE2FA9XJ5doTqndn7XdbB4BjhkRiYVr,FALSE,0,40000,40000,1
115r6eNh3zb5b9poizNujFdQTzivzmFdRz,FALSE,10448,10448,0,2
114dq7KytNoFoUqhUcJnoDkFSbHpjL9J9s,FALSE,3365800,3696400,330600,7
115xQAkPfkKqwVRhNqazK9CKccpj1bS8ih,FALSE,0,35118,35118,3
11ALiquamEgetBibendumTortorS2Hkcg,FALSE,0,1,1,1
115sLZdrDYb5zT61hhAsSWkXrfFBrTzgFg,FALSE,51380841,51399163,18322,40
118qsdVu5G1B3EuPVnMWFso3ZUV6iXouY,FALSE,1699200,1700000,800,2
116RtUfWp9yK8d8onbZ4hCJm7xXFqxqrB,FALSE,0,82711,82711,1
11P51ZZABAZvPtJrrwvpXFTLBVegVd5oV,FALSE,2047104,2088256,41152,73
11EvJN6PNALrvrfscVo7KnUci6arFMjx2,FALSE,0,1120433,1120433,1
1161UoLMTHNrqh4Me23M9GDZHbycaNqnJ3,FALSE,0,11722,11722,1
114nMerqpQXgqp7Hm9yY3ujJrziyLWuo79,FALSE,24973,31890,6917,5
115KbTDeUi857N7UJ1CFCoSEABnWFZyASk,FALSE,162730,320546,157816,8
114q9LCPRBR113bXiujMyHqqozoef7QASM,FALSE,0,3134,3134,1
114euepkb2BDLvQc8YRsvwXqFKq1sz5zqc,FALSE,65456227,119188227,53732000,5
1159ZgW7NgJbzC9YUzKJSV1sn9ZLjz4mgP,FALSE,0,2640,2640,1
114m8nwst6WQELYRNEpWns2TFXjNa25eq5,FALSE,0,145714,145714,1
115Pq6a99D5Z4ZLEfJVLR7rEBB9pUvWxwF,FALSE,0,1421840,1421840,1
115zXR5Pkh3LcJszAnYhuaW9wK2zBuZJ1n,FALSE,2769000,2779085,10085,5
11NZfPisRBcHXx93fT9rhK365enXcgWfj,FALSE,0,548,548,1
11JSHJXxALNtJ4UePvMBrrwVBa4of5Q3d,FALSE,0,5816,5816,1
114n6nAFwEZWJgNXDzumG4BSNc7RRK4WDf,FALSE,0,6662,6662,1
1163jBwj5D1EL2rdPeXbL41Hrd1KtiV1Bu,FALSE,1335453,1340110,4657,8
114f5RC58BVSJuv4jE8aRKCVXwnwKjaujw,FALSE,70401685,70411685,10000,8
1154nEcFrghK4T9d1PrgmvR4D7AXqVnKJH,FALSE,0,9919,9919,1
114cGMn3Z2jGgAYKwjUsmitiJpegeKMGu9,FALSE,0,1000000,1000000,1
1156QSbE4gKNnabcUGYwMMk5YpyAUCgvJ9,FALSE,0,6000,6000,2
114ic9EwJiVeWcmr8DF2UhYTFFsQZAEdVN,FALSE,0,11630,11630,1
114pWWCw7ENBZ6jJbbENPFMtSpN5dbRhRZ,FALSE,0,15332,15332,1
1165DvTKPneY5FSQrK9WTu3PsTr23xm9oq,FALSE,0,207792,207792,1
114ky8AjnbPUuUhSWv9v3AqQVZZZ9f21WV,FALSE,1625324,1638380,13056,3
114d5sKExSP2sETLcyTsNsUAJibeDcgGer,FALSE,0,1075460,1075460,1
114yygGLc2kWRHksmAKQwopmRbPQeZf8zC,FALSE,0,191984,191984,1
115bvcFKzCVcZn6idWvbdaRnzmQPg5sPKj,FALSE,0,15192,15192,1
116AtUwHnB8jxYxVHcdNbZGtEw1Dv9rbmc,FALSE,0,392823,392823,1
115F4VMa3YLdvAkrJAFP5siUCVHvHGsqJQ,FALSE,0,91973,91973,1
115vqHVZCwFNrCfer4wPD9AHVVE9w7nR4v,FALSE,2184,3822,1638,7
116EEpL4Yg21Bd3f7AZXBLsJN18iRsd9hs,FALSE,752350000,753600000,1250000,6
11K49qWEqkpGxRepFiti3WahgpJqsHaqA,FALSE,0,99322,99322,1
11M4LPWZYw5H2QxdBfgbRhRmpBwhNLtjW,FALSE,0,61106,61106,1
115QnHfTWkGyy7TF5oe3WaJL8jaQUp9Et3,FALSE,0,1161,1161,1
1155ii429k7XjLSZqAkrAAFHkMqL367oKA,FALSE,0,169209,169209,1
116ydR4CnXRuCjr7UTjNXgSfPXsMeoaPQ,FALSE,1746,5076,3330,5
11KRv1wRGAyaFMHJyS1bZg9NgoPMbz1Nk,FALSE,1092,1638,546,3
115upVaZNRciEzmftEfedEvrKz4eodhkzr,FALSE,2612623726,2612633757,10031,315
114u3rT6KMuw6qX6Hohk31BmNjMGQtnTzs,FALSE,1691622267,1691637467,15200,21
11CkBX5nDBzG5Es8QkXSL7PmiRKm5oWYj,FALSE,101047000,101262439,215439,18
115UnP41RyMtPqbGV9SGG3JL96dxL6DETG,FALSE,0,1929,1929,1
115sRR2kqCmFnXigQmv6gPURR7ZVkkaXqn,FALSE,0,634,634,1
1163inbSRgbSnVvfjPFFPnJfd4DXXaEy7j,FALSE,324850,324850,0,6
1162RmrwMNf8iE1mUarQvF8LEVmniaLyPS,FALSE,0,1,1,1
114hwvZabyQhVFNtJQZmGUvPn3GZjoXozX,FALSE,0,14405,14405,1
115ycaZSE6J4sm7DvGabzCWpsyzrqnWbqr,FALSE,0,28878,28878,1
11R5jWVGM9Akgiycd27Co7g4c82LJKY1G,FALSE,0,28513,28513,1
11AdJbpCHN4G8Wq4dN4p6XEBouzgx1XPh,FALSE,0,90349,90349,1
114gmo4oKTx1qXTjTCVGHaZCEVqMeZpAPD,FALSE,477000000,937000000,460000000,10
115D5W49B3a1hjJXcq36fc8XsnTNzuD6bq,FALSE,0,800560,800560,67
11CHA285LRbCaDtSYD2T4ofS4zXKyYfcL,FALSE,0,1224,1224,1
115MzDTbEMgxBx4YfwC2ysasZnpAFY8m6u,FALSE,732727,732727,0,4
1156MXK7PTRvHgDS4VTuz19DqdXvQfW622,FALSE,109075,110186,1111,15
1152Rgot7nVeUS953NytbUs5niWVuXh3P2,FALSE,0,4575,4575,1
115dByuMqtwVTo5jSL2Z83UbbXNhy9tyNP,FALSE,3614463,3615262,799,6
115F77bMTVfkhsJ2mM11NyMMRP7qnVSVQd,FALSE,0,967,967,1
11QvdS8PNHcAKVgu2U5b7qucPJo6e4JQa,FALSE,0,44785,44785,4
115JCrQWrGAF6S16rP5bb5ikEjm8akoatj,FALSE,0,8611700,8611700,2
114umTRueHX42brnNTTGcBD1WrSSUT6Rmw,FALSE,0,131711,131711,1
1158wdw13su8JL3CbghDi9zBvBTuPfxAQM,FALSE,0,171930,171930,12
114ok92e5jMoXN7r7DzPwBDR6k6Cs3MGvR,FALSE,0,1145386,1145386,1
115Ga1kMUfDgTQjsrRirRTPp6eqS8dGCh2,FALSE,0,261010,261010,20
114dJ1Vu9djqbYa27X6ZLo57EHW7Ugyp23,FALSE,0,36805390,36805390,3
115e8MP2KzaAqhJ5X2CWC5zeUtknDCFH7z,FALSE,11302,11302,0,2
115cCcDuzQT5VCGoWV7NC94JJYbGranKH2,FALSE,0,1000,1000,1
114ekbNZGaRMYeCcFKW144YyWExBGm4Xky,FALSE,2646269,2646269,0,2
115jWFTLMpRSTKC5FYJc45oK8Mm8F8WaF6,FALSE,15013333,15013333,0,2
115Y88rP1fQS4BH86UYA5yXs9dxye5uYos,FALSE,24108,501638,477530,6
115twzjaV9qxsYP9oTYL71wAAPYtVZzTkE,FALSE,0,22344,22344,1
114fpSRSaNeqo6P4nLvcb8WfgyNV9F2KrB,FALSE,0,3181,3181,1
115MHPvcGWKgbx3JZQStJgEUZ31vT8PSb3,FALSE,0,1628,1628,1
1166Mo8rNj2z6bsX25cR8QqWh9vs5gsib9,FALSE,0,500000,500000,1
115KqtrvLDhAxP9WTTkSjkNV9NkucCVbZv,FALSE,522153,550283,28130,3
115Quu7fefCTioXP3VHy5F7TypYGT6xZZ6,FALSE,400050000,402901334,2851334,4
115XKa14oERMpm9Jo2au6wKK96axE7uEhM,FALSE,6137,502730,496593,3
1164dv7CzreAAbsVn6cpecMuEWFsckFgDa,FALSE,307177774,933561765,626383991,8
115g13VhNn5HdF2nG6CRFhR8fyGyVYMMjj,FALSE,0,9864,9864,1
115z9ZGU6UEcvGujdaSExrCbaJhRUFHaef,FALSE,40841,99841,59000,4
1163GHTFWVcFKDdmM9cBPiviCiMBWgvA1s,FALSE,0,1000185,1000185,1
114g9FvjaV9xJNuGr1iTFJiy9UFP9d4K6N,FALSE,0,74632,74632,1
115b2JaCfGeZFoXUUuWg5uNHvhXBwixVCB,FALSE,0,238000000,238000000,1
115SyZJ9N7si5CVN2qqURU7n3inkSdV1XZ,FALSE,0,229241,229241,1
115fD7ZQVJh99y96XYL3qRpQ6T6QoyMWxZ,FALSE,169256,169256,0,2
115iYnxzHJN6gwzxtrj995U8kQoWSJ7gCM,FALSE,5255422,5260566,5144,30
115qsjAtjEEFxTTw5X9oTE9mH5DzZUMprG,FALSE,1208000,1209397,1397,2
115B17WYQUbBt2jSr9MKCyswhwFiNFT5LR,FALSE,0,35906,35906,1
115zXproX4ByvX7k5uzr4yWX4L2cuuSytW,FALSE,0,108950,108950,1
1164k6XCtpPfTxLEKs3uuDKgkPrUpNNZ21,FALSE,0,99384,99384,1
115CkkSV1W6vYKS6u64ci6M41pNb5oMRxq,FALSE,0,12000,12000,1
115DejpmVHmQ6ZynE6uFNjtZmUtaq13GJV,FALSE,0,49314,49314,1
115Q5VDrADRTUjdvEYhTwh4BgTGH7tcd2L,FALSE,0,764076,764076,1
114nBu9nHAfFrALhbBVqfonhtNpX39Bnew,FALSE,560007,560007,0,8
11MLHS1khM3vLVVpgUPbrsfS3caFDkrpT,FALSE,0,1,1,1
11AarXpi6Skwiaoz1UkaASaPpwMMDo95w,FALSE,0,11548,11548,3
1156BRUnBWQzifr51VZL25DVupp6cVnehH,FALSE,2593839796,2593840342,546,61
11Forth1ikeScript1sSimp1eXXTV5yjX,FALSE,0,1,1,1
1188bTsUCM3P4rA4irGkM3iab41f96x5K,FALSE,0,1,1,1
11BaYjYX6oh4ynbSUPTN7B43UuUq25okc,FALSE,0,2,2,2
115u7YAkVvbDBuQ4D9FmYkkVNJXFfbzt8i,FALSE,0,87862,87862,1
11693thEMdCyNnQEnfcinaPFX836hwwxAB,FALSE,0,1,1,1
115Q2PY79YWiY3dPApWnXn7bgpg7BQ8ntc,FALSE,0,8835,8835,1
114nvpAnK37rpPiRSyVpUZc9ZnZsZbaa9b,FALSE,404433,404433,0,2
115hXkW5UtanPD1EGHbeCxgkq1Y74aHQNs,FALSE,0,90740,90740,1
11Bz1t5b3SZhe6v4ZgdzrMSsUFq5bTcTk,FALSE,0,6377,6377,1
115KKBfqRQF442ezFzu9jgZAcQtpchadjS,FALSE,99850000,99850000,0,2
115KbNDjtoJNTgqDmL5b796bck86BSqLJo,FALSE,0,667,667,1
115aWTUGy59UFf35PQwRJvQUntqJxdaQYv,FALSE,0,297500,297500,1
1153XVQdvg7DsEynmTFvCfHDnmKFrQiRwk,FALSE,0,624,624,1
11BZXeukE4zjS5GbjL3ChaxWCDAf3dvwv,FALSE,0,657,657,1
11Mzrj8UnafM5WgTA9wCU34CLaieGtTkz,FALSE,198000,198000,0,2
11SAerx1grHqKQkMYwAMN99ZF1PU2Qkii,FALSE,0,3738468,3738468,3
115shXwv8mFKS3rukuG4orS6jjUPEHoczj,FALSE,0,204338,204338,1
11CChEKPAtCjdxuHPn2LuhJbj1mkZaXva,FALSE,4285408,4766641,481233,183
115gWdm2n49MF9ntaHaY2zUsvAqguxQBBj,FALSE,58956777,59601174,644397,13
115XQG48FBzqCBjZw6ihPC2ioFXCacNkBD,FALSE,0,13280,13280,1
11J6Bdv1ENrw79Y2CG9T2799cWVyHF9Et,FALSE,0,15623,15623,1
115DzcKKzS5JcNfxZoiqt1udLSczsB2Qqu,FALSE,0,199720,199720,1
115S24xLssZ5sZ7AwayfxcK4o7ASwiARMt,FALSE,5656074452,5656551424,476972,105
116GibbchEoT8XuwJFaQAofTswYLdiCkrY,FALSE,20000,46886,26886,3
1152qyNhfSe7J9xo69yJRj1D6Lyf72wima,FALSE,0,473406,473406,1
114jzFCuWPcpvfj6SDBGaPiW8kp3nzoS67,FALSE,0,53338,53338,7
11Ew8wVoJ3fyRZnkDTGcEKgx1VyCYiSZs,FALSE,0,189484,189484,1
115gWyHhKGw3TGGSb1gXrdNTYMDfgnxSUs,FALSE,1800,1800,0,2
11EHqje5qKnX58hxeHKFDX5UfWpsKsmPa,FALSE,0,1068994,1068994,1
114Z7ug2ixBJqb86iXB7w8n1hZFphc1Ec7,FALSE,0,988039,988039,1
11Mp9rUagKF63PNiVJmbuibuHV6CbjFz7,FALSE,2184,2730,546,9
1159qT5Y9voEz42eY1YctqpHpaWpz7ngWA,FALSE,0,19247,19247,2
116Dc18XTfXKMD25HpxyaU8Ue3tvFdJEm5,FALSE,5500606,5500606,0,2
11HWd9hh72CqeSP7mAA6v5PXNdwuEPTD9,FALSE,0,10215675,10215675,1
116HAMCPbkHnrHtcFU21qn6F2jMM9bjzUf,FALSE,0,175663,175663,1
114vTDuv4P8sMuNcdokJcuq1T8ejKJzUuA,FALSE,327922444,327922444,0,6
115ba2zQeXqncgYwjPSYeR47YuK3WLiYf2,FALSE,0,5412700,5412700,1
115yQXG2ySNAgcaLN89hmuUYB4mGiSLuci,FALSE,0,6485,6485,1
116GRhwra1bLpcLjgDMQUmJAmfNXADF7Ce,FALSE,0,548,548,1
115FEdksfW1e46QGYaTDa8cFyWd8yaGQr7,FALSE,0,86556,86556,1
115zR5YE4zqb61gWhAQShDscR4MaUUTZoy,FALSE,0,757,757,1
114zXynVvpXhHNmdXvwBp2G8QFYphz8eJ6,FALSE,0,182559,182559,7
115ws2Wk249LrsR7z8aPecGjPwt99CYtFG,FALSE,0,9381,9381,1
114bKipcdwAx3Tp7DaY7uUrLF72aVEUuEX,FALSE,0,46050000,46050000,1
115V7ypCxkhUJDgVCQSkfVkPsLtDPc4V8q,FALSE,0,100000,100000,1
114a9Surmqw7YCu6vm13am5tHCN4qXxopV,FALSE,0,371666,371666,1
115SCCXCrPimdvD9bzFf1dUpUTFZLTc8EK,FALSE,0,129001,129001,1
114tyzaVcE8jU3QeRXNdsew63uk1prMgE3,FALSE,9228736,9228736,0,2
114yu8aoSqQ6nEHJ9xDJqTCLw4nxapktPt,FALSE,0,10736,10736,1
114G6nZsdRL9MYNtssuibp18vWoJ36Bi8t,FALSE,0,1001274,1001274,1
114idkLV1jjuRspxqEcsAjQyMN4C6dRceR,FALSE,0,1931935,1931935,1
115sDPchx7f4JDcadwxAJPp5MEdErqjyv7,FALSE,0,11591,11591,1
115azV2B3xguoiiJCQSisdcTRJDDDqSW8n,FALSE,0,2728,2728,1
115JFLjLMnyJBHQvLS89nmUpY68RcFbuNo,FALSE,0,1122,1122,1
114qLGoBWEELg2ttjUiTWRzxdHjX8ncFso,FALSE,0,991042,991042,1
114iHJ2cyJgjxxk6wmGEfkeRNY75v3s5T5,FALSE,0,4412,4412,1
115J5u6wR3f9t9XmeQ2Vsu1safBuwYAH2Y,FALSE,768966747,768968931,2184,300
114niwphuQJoBpvadNd8JqGRLKqedVsoJG,FALSE,24154346,24158486,4140,24
114PHh7HfzRaYZuhDjMuhHCmL9q1RFYU4F,FALSE,214337,214337,0,2
114cuRm8P8NcwrP7QNEV5iDpPsvvMYb6hz,FALSE,0,1152,1152,1
114zy1dsjAEyDTaFF7FG6ZDEZa7nGxSNJ,FALSE,0,1630,1630,1
114FvHxYnfvKVPxjM8GoeTi8T41R8TEy7e,FALSE,0,137721,137721,1
115wd1oTpTMa9HdHc392X3xtg5bktkz5iM,FALSE,0,1092,1092,2
115fArXsE1Bpg6XaZbj4ua6wfqxUKNK8T4,FALSE,191488,191488,0,2
114wKhoVxqZZe8KXPQCteDVZCn5jQh9Ue8,FALSE,0,558993,558993,1
114iyVjo9TP128VGPdAXMs58F7BDDhLDHH,FALSE,0,20000,20000,1
1152NzGP46fMyfFwZ4GZ2aNDBKoPNSnjki,FALSE,0,10000,10000,1
114tBUQJPdjewoBYvmfJ5PJ93EuT9xVY2y,FALSE,0,13557,13557,1
1167FCY8wYnujJeti8Xa8UuA12p8XXQoed,FALSE,214961350,215000000,38650,2
115dho4TdQuaBVtd2WXXT4LSPGbKj7vNb8,FALSE,0,12786,12786,1
1145LnpathoSKS17Y2u7B81dXQ6uoLkPjV,FALSE,0,173460000,173460000,1
1166vA8Aryp5CFahBet5JtuCD41xQo866W,FALSE,0,5500,5500,1
1148esBQ5CHBXK1dMy88uFFgxGf2qneS45,FALSE,0,286312,286312,1
114XzNcH5sBoUxrzMvHVZoy2p3MHYbze7Y,FALSE,52655,58700,6045,3
115md1GNxTZRC98WFLQwb98qAz6hpt1agm,FALSE,13024500,13024500,0,2
115xX7tfBmaPNds1fRRJomrqNd1RMajJ3a,FALSE,0,1014490,1014490,1
114oECM3hrHGkVpCS8BGQ2tSaEQd9SmSo8,FALSE,0,88983,88983,1
115tQ3EHBFLGawtToUmVR1F9UiS5dQYcJE,FALSE,407559,407559,0,2
114XeJLQUDS1RpoSseRkNBqGTxLtfwSD76,FALSE,0,157313,157313,1
114A5nensehneErxiKRECCAbw8XvjUi5a,FALSE,0,992960,992960,1
114rN4KTezNNNesYTRJ98KfT9NbPeEgRwE,FALSE,0,9860,9860,1
114vF98Y7FNmJ2r1GCNhbmHXWkEMdrzfou,FALSE,0,18252,18252,1
114AxPhxPPci1UzzjyEg5UCtLDccY32hhM,FALSE,0,254985,254985,1
114V93AEziZp2uWSN3BevnpRsN6iWekisE,FALSE,0,5480,5480,1
115gJ6aAAukh3zy3JSUSCa56GtvEMUHf59,FALSE,2503276,2503822,546,17
114bTxSa4yDaKKnZUqRM1Mn24sKYb6zYys,FALSE,3350,7092,3742,4
115TjRPrjRSUMK615bSqqKqR8W8BSBVxWe,FALSE,65262750300,65616393300,353643000,16
115pjX8eEYN6NtCLSxY5NWHJMP9yiMQEnZ,FALSE,0,60092,60092,1
1146QYkWAE9pkoxYSKvkFHSf6rmRS4uMdF,FALSE,325670000,325966000,296000,2
114ku5pRFzrAbfKgeyV8ihAR8hRuvdMZNj,FALSE,0,91026,91026,10
114M9c5PzddWbwihDdUoaPfCpJaXSMQat9,FALSE,0,4387,4387,1
1142uuq149dwC4QWzWJt5LMpAtdJk41csk,FALSE,0,852,852,1
115XtKeeMNVUPdY2zPc2ypEJdYPAeegQri,FALSE,19553000,20165096,612096,4
1154NZueVDSJLcPDDrt4GaBWue41BVmoVu,FALSE,34499,34499,0,2
115QaH8o1krhQNTNG1yrv7mKKMNnahYT8u,FALSE,0,5500,5500,1
1157WV6Hh63429BqQv4MB9TWEy5mAhcznL,FALSE,1638,2184,546,7
1141wMSAeMTJEnfoDTByiHA3aAhxafT67o,FALSE,4371000,4401000,30000,13
1148anBdPvG88zghdhLoPdynmPD9HywFMy,FALSE,0,410382,410382,1
114o8cxhW7vnVh3bUACq92ivKWvPc4621q,FALSE,38945969,38959945,13976,7
115muhEp1uZP3qj8JcHoKPXf9k8pev2dJY,FALSE,15616867,15616867,0,2
115FqhrXWKDiDhSbFumNSQYrKhUuwBbTkd,FALSE,0,548,548,1
115M376ApcunEoK2HZjZof5LVqcgXoavfc,FALSE,270400,270400,0,2
115RWjBVxVTeXmf2rjK7oQJkN6iqEroADm,FALSE,0,38217,38217,1
1147KaJ6tETkuuFcKtHHRhygaWZu5cLPZg,FALSE,360000,460000,100000,8
1159FTMg1FceoV3yUH3dGu4NAbRArzxNEs,FALSE,141204,150000,8796,4
113zzbe2BuWDpLXwsMfeCpQmXWjsrAQzr2,FALSE,496339,496339,0,2
114YRdfFrLn19p3VPKTpStVzQgAQsJQMRE,FALSE,0,20000,20000,1
115ydDramoNwbUHDD7DHXjfogrdac8ZiZP,FALSE,0,2249,2249,1
1158AYuC932EWzRqasRhcjdwDGHfu7JE34,FALSE,48578150,64209517,15631367,99
115nMiKawQHfm2D4fJKM4u5zAZMLq66svn,FALSE,0,55120,55120,1
113zwbF8ci1TxCscquyURVrLRVQRZTJboC,FALSE,81819,81819,0,2
1156us2fEtuqapk7i8bcAXfZAsUBaqG6Jn,FALSE,880571,880571,0,2
115825etpX5wPV5gk18oHz9Yy5a3R1xwGR,FALSE,0,48778,48778,1
114VKpca2PUb7giAoz9dUxGKKWC3fFHtsR,FALSE,0,1056,1056,1
114fNX3BxLCj7to4DfmQssH9mjYEGQQwxZ,FALSE,2483100,2483950,850,2
115ZWCaFDgCpCqu3hFbwT5vbXjxBMaHgEL,FALSE,0,15487,15487,1
115Uo1abyvp8Y1y1vHiyXQS1DDZ3UgZXLJ,FALSE,2045157,2057917,12760,38
114yFcTxsA8APtdKAfq7BvkJDtn726GoHt,FALSE,0,35796,35796,1
114xmBkPn1Ag1Tbge7kyc4AHHD6wUcCxjN,FALSE,0,56287,56287,5
114WK7bDKwh6LkeRgYSYAwZ1oUM7CQi28i,FALSE,0,505623,505623,1
1143sYS7atQUTppXut71CycfMm52h67uwG,FALSE,0,900000,900000,1
114RVvmDiwga3yRFj8XrTPGPs2tZ7Q3n9P,FALSE,0,5310,5310,1
114TAugjWnFpqJCu6nod7N2q3qovniqndi,FALSE,0,893936,893936,1
115JTUUYCT2QzA2S6kQzgegViGj88S3VSU,FALSE,0,34642,34642,1
114jGMaEpX5GKfMSYBgsDF9rUJivPmoo51,FALSE,0,282685,282685,1
115tVinaEnkGGuZrue1fedpZgdJadmGo3R,FALSE,0,998753,998753,1
1144956kQSFYp3Domt4JEmVeGjcgW4nQmp,FALSE,0,5500,5500,1
114FXesmGuX5yCq5v63ujxKE7bbUaxe9SK,FALSE,0,495787,495787,1
115Y4Wa268XhQz1dSBdTyFJ5yPhvSnMadH,FALSE,0,33274,33274,1
115V6kFBFXYZ77jcWKr2RB4PggRTivcQxB,FALSE,0,1016,1016,1
114jc7t8LKPYkUFpBe4hEq46zGzpz1nkJe,FALSE,0,998179,998179,1
115vRghomDkWiBBfyuXw4vtLay6Shf1A6Z,FALSE,856079000,856079003,3,5
114TcqdUASxUjSjwG8uQn9LCQUtZUycudG,FALSE,1500549,1500549,0,41
114eZhjQve6qs7TtTAGtoXnNkQKxYiNqjn,FALSE,0,161700,161700,1
114zcx6Foyz8ZKSrSi6kQ4hmVQUBKWQKX2,FALSE,22000,22546,546,3
115qG1XBx87f4wgd1MMuEufVFs6Dh25w3E,FALSE,0,3000,3000,1
114eWQtfhtkobScQp7yeEu6GFRrx3T9uAc,FALSE,0,64570,64570,1
1163z2j4BhRCRXvJPEPNgYie86uWi3Mwve,FALSE,0,1468193,1468193,1
114M4Nm9bUAzm82xfWkvaUPssE6yce4J1T,FALSE,11912668,12774686,862018,146
114cXgUZ3iiz2ZzHJqBism2nwuNzcVxUw4,FALSE,45405,45405,0,2
115HFkzbwiMQoD9skxy3pKyoix2efVEwUT,FALSE,3338812,3338812,0,2
115aJwHc4WhSdhHjw936NG64L6ExzuPxyu,FALSE,0,1,1,1
115xJnHCE7RqG59Q6rpb2FBoHs7UJdXJJ4,FALSE,0,52755,52755,1
115PNxMpXMoA9AMShE69a6TgqxJMJ4yeAU,FALSE,5396,5396,0,2
115XmSe7W17taqgUrn9kPk9NY8m7khNevA,FALSE,0,11000,11000,1
114qsPNNVqarWM9KnQNrEnHnZv7Zg9EU8h,FALSE,0,9862,9862,1
114sCbomvSgwa8xVkq8XeRtrZ3MzhsWxeW,FALSE,0,21441,21441,1
115a7vfkebzZAAVxq9pcb11Qo1vhDFbmsJ,FALSE,0,1520,1520,1
1162oYbLLgwXerY4SxgCG6Jqg6Muhoc8aw,FALSE,0,20100000,20100000,1
114YLJdd95hGhQU9WJrCMGZgma7FsgYmwy,FALSE,0,3463714,3463714,1
115Dtx5VfoX23mMotp8VUcqxME5GwpN8zH,FALSE,0,7158,7158,1
115eVi1w8CJi6qRyYSWdukh6FmbQXVx9nr,FALSE,7802552,7807368,4816,3
114qPKzD1FSsMiytkzbSmFpe4J7jBqUpgM,FALSE,0,62812,62812,1
115oXfFznbtULkkEf9RS3oeNgc6pdf4cqQ,FALSE,0,428688,428688,1
114d6BiTMgraLXEqibsTfBCxaF9FJVbT5D,FALSE,0,5431,5431,2
115AYreDkoQN35yT6CSEWQ9TusWYwDNwbk,FALSE,0,377150,377150,1
1147L1puUUVuWJTGB4SrizQYW1aL2f3Ptj,FALSE,546,2184,1638,5
114tfGDru2CuF7o7SWAy3jgNrSLVLNeFRG,FALSE,1638,2184,546,7
114UXw95ktpWB27RbFmq935y8SQAdg9r1h,FALSE,46079405,46671069,591664,17
114bZ6P8keK8xbARCFqetcJ9WnzQ36Lya1,FALSE,674667,684901,10234,52
115Vds8kPcNdaaGQxbnh7fGjazuEavsaKy,FALSE,0,809693,809693,1
115t521kJ1PyKL9VBLMRqNnrkNzPMyPz5C,FALSE,0,654,654,1
115Rd7z6qvmUyRL1MdukunLeE6rQc2fYDQ,FALSE,122674728,122674728,0,2
114z7JCuSDXJbNamnDNnqYaLvqmsvYXbe9,FALSE,0,546,546,1
115UBMsTcvJKdAnzhoNh8GQ3eiyZHSTpYb,FALSE,23230,28660,5430,3
1148kXqim6ZpytoK75BHnebGc3WaMt8vLq,FALSE,0,253934,253934,1
114wHdFxkh2Drb22Kkj5V56z918r6AkWus,FALSE,0,6980,6980,1
114CoU3XfPNPwbZS8oBKb9FmEBRQbCd1U8,FALSE,0,87570,87570,1
115Jc7brSQnFqd4Rai7QNRudQ5GEDdbTnP,FALSE,0,2083346,2083346,1
1167mcZTzJKancdwFxKGUoNycnQw43D5ov,FALSE,163872,163872,0,2
115GDySk1Dn87vWGUbcrLeYySucx8Udxzv,FALSE,44772,45318,546,107
114jEerXWhzwn7KMCUsSPMqLhzk17QdW3n,FALSE,0,16300,16300,1
1164bLMYvmQRHjRBnNVGeG86EC2sSWmuvm,FALSE,0,5000,5000,1
114YYH8F9U8TZPRP5m97t9Xw68M7X8tU9s,FALSE,5622626,5622626,0,2
115Qrvs27DZHBoFJmvvJtmYk5onJj5Jgv2,FALSE,0,18318291,18318291,1
114tC5qhikoxJJ5Hs2xp4QNES3rfwXewLE,FALSE,0,233356,233356,1
114EePAV6oVZ6N6WTbqjzTpeJ6VLoevZ6d,FALSE,50000,50546,546,4
1149KqrzmiGRDCAbSzfdwfxWjTBN4ZWsFg,FALSE,0,9322200,9322200,1
114hW2WFUQLkuLoroYDQUFcxRnAXkdWuF8,FALSE,0,131807,131807,1
114SvCiwTUSXEKFBEoSCzQjSR2MXFgzaqd,FALSE,0,1002292,1002292,1
114XPoxdanAsThiDuYkBhG1EuEKTETw5M3,FALSE,0,48073,48073,1
1151tQQBvBFKsh12TmSuu27RLoAQfeYKu5,FALSE,4797892,4797893,1,3
114mdUMwsfMMwRuKT4VE66AB3W2VNYeTZh,FALSE,0,1730000,1730000,1
1146pZwvbKuy9HnmeC1wn66E7RgXko6nJk,FALSE,0,10000,10000,1
1153CyRst4fe1S626fn6pJ3aKhqUcLSmLK,FALSE,24669329,24761366,92037,22
115Vh9GyTd9YKVNa4SsVTQ3dz5iB44sG5D,FALSE,3621,3621,0,2
115SXog228bpdcW6To9B9sYM8QU9uUMKWu,FALSE,0,2447,2447,1
115M9NFENd39WtznW2FKtCmTDxjcSQU8o,FALSE,0,7784,7784,1
114bs9gJgJKovt9hLRGxfcQDkXRh4chTvy,FALSE,0,2730,2730,1
114Pmbk9m6AKWaRh3EivFeeaALC29mihQR,FALSE,0,10000,10000,1
115CxUvZkf3i5PgTNhhuUAELwpea5tvjNG,FALSE,0,2000000,2000000,1
1143LB6zUAqW1FBvner875xgE2QA6JN8Yb,FALSE,0,410000,410000,1
115YRqjqejS6UkLL44kv1TCP6hxvRNCF1e,FALSE,10000,20000,10000,3
114T321ivfStBvgz5MvFQw1D5gjUTrwELi,FALSE,0,14701,14701,1
114KtPD8HBpBrRnixV9657DBZ9v3qHGpoH,FALSE,48026,53491,5465,4
1162M7gj1Ej3N3V724Cdgc5NT1YtGCetAi,FALSE,0,4914,4914,9
11546tPZJtuP9sH7KMjSK11wmkj5EuPgua,FALSE,58079200,58080200,1000,2
11427zRLGgKAFaPwAvjNfjqFLhGAuHVEDM,FALSE,0,10000,10000,1
1147qTykNt39ugUuTDs8MLu1HCE1Hte2YN,FALSE,0,400000,400000,2
115YhmJH1MhZjdikywnnVFnYvHjcivBGo6,FALSE,96797,96797,0,2
115nb6LvmUkYpC6iTfLeu2enFZzLhvzqbL,FALSE,0,861840,861840,1
115PtwitJtTSqJSwmRX7Ger4WPBGsbvaoG,FALSE,0,60233,60233,1
115tpPFaRpHVPiD26MCP6cdmqbeyvLEVZo,FALSE,94592272855,94592350410,77555,219
115Hkt2Z5C9vGkqAuSsMgyNmXFTwfJTvwu,FALSE,0,12760,12760,3
1168FGvxQPJ1zqbhBinLPvnVPrfYuhV2yS,FALSE,0,18408,18408,1
115k2XtgoDa134gJpjDc1jEtwJiHdA53fF,FALSE,546,1092,546,3
115djMiTv219cehcqjfrGrNi4cHxctRn5a,FALSE,1397122,1397668,546,5
115oyLoR4pAwFbrtkgPkT4bEkmLamP9Ro5,FALSE,906944,907847,903,3
114Mv88uV4pPmu3rE3XHBSCY83tZp8ju1a,FALSE,546,1146,600,2
1141ZdYpr3FszfjMwsRvvjkcAzSG3AbWZS,FALSE,0,100000,100000,1
1162EHqnHvNYSG93RCwhV6iU4FZkiG3b69,FALSE,0,3813,3813,1
115pDJz91niEvAaDmHqou5wEjJYPPSsMnR,FALSE,0,1573,1573,1
114CX2Y3JErvk5XQRgHbdq9AxtFqjEVw54,FALSE,0,55120,55120,1
115UdVQK3uEvQYDMVVvQ4YvBrXo7tA6MEB,FALSE,0,865,865,1
115cqNxtz6CAqgTsQS1LbaY7FpKu6q8mm,FALSE,0,546,546,1
114oYPUaFgnLLRKsozuexRMgMaVXWMQCfz,FALSE,409873475,410175363,301888,45
114mZZbBzkjDJyMa9zSnBaguJR1LXxUUBk,FALSE,246960,324049,77089,18
115WsDQtGPT7SDkJk44KTVb3xfzZdRthGu,FALSE,0,1215,1215,1
114v8CKkPckrVgdhk8iWH6wZkwx1u1Nxob,FALSE,663080,663080,0,2
114kDrRzadH7wNN1D1GGkzVgvLudFVpbNu,FALSE,0,247605,247605,28
114HsCgVC9mG7dASXJB3sZe7uc5PbGZHza,FALSE,0,167493,167493,1
1167jUrctNHx2mk3Xq7DgWBZVtEQrWTHm6,FALSE,1046576,1046576,0,2
115awTT7TRq2kX8JtRD6dNUKnVZ465Kk9F,FALSE,24497,500546,476049,3
1141m9YCivYkLBysQaAoAUYQSpw63ZGLf7,FALSE,0,878413,878413,1
114Cd2Ffq8BR6Y3WggH58EDagFwYjjcosy,FALSE,369646,528735,159089,4
114mjJYp6ojvPnB6GUkxYubLMggAXK2aUz,FALSE,26232071,27305588,1073517,41
114CdoYpmiMHq6xaSwty5Ku1bVBPfne4r3,FALSE,0,1734300,1734300,2
115KrK6s8HGe6AZ5MW1b4ejjkMaaNCphuT,FALSE,0,16279,16279,1
114FBUPVnLdtzG7TY8RpiKEaBYuyD1f649,FALSE,40000,60000,20000,3
115BPxvheWFG9UUspGLrLHJ1um3uFA4sfR,FALSE,3241,5546,2305,3
115biEjSCMKKBfTUS2TFM7ZmptTh8tuw5E,FALSE,0,281600,281600,1
115pqMWrc5dVSmXFW8BdrqWZAbN5zJvweV,FALSE,0,15000,15000,1
114HPZqHAa3oA8mUtntjZMRYF1srZYFSeB,FALSE,0,1,1,1
115mPSYM8ijtDcNEoQkrkEqez98yVW3Vqe,FALSE,1481107,1481108,1,3
115kEtquA8fb1QxmWx2GF1unnNkFDoqMeB,FALSE,0,1020734,1020734,1
11419eezPLhJSBKxz2R9XXRjDcVLYxj9Ym,FALSE,0,979430,979430,1
114aNSYnXYSb47ENjUvP6xGc8nPnaPuhL,FALSE,0,145362,145362,1
114jNmVwbh4F1JvCAaumyYQnwhVrpzvkvH,FALSE,6006,6552,546,12
114zE766o5DTxysyhR2LmJ1x3XNouwCmom,FALSE,0,11825,11825,1
115GTkME5RVBqtKDDxvyC2BRD4uXK9NAe3,FALSE,0,7650000,7650000,4
115WYLC8sf5K43NevAv3ZyyhdcULzGC4tm,FALSE,0,53000,53000,1
114iD7rbBLRcCxvoBT2cTYhCmY4WtPhwDg,FALSE,0,2000001,2000001,2
115u2K7JdRZRisBPGaFaPaMTKq5djT8Vqr,FALSE,13961,21092,7131,4
114z73s975VCKNfP9wEEbMRsAX72yT62wN,FALSE,567164,1000000,432836,3
114aFmsMn2FM95d3a2QB1x6mMAJHzQBX4M,FALSE,0,2880,2880,1
115JVwAtJJSbCaLuuFFopmhZSXF1HksN76,FALSE,0,3174800,3174800,1
115bVkz6gHH2gG9qtCnQLwYoJyyDrVbviq,FALSE,71363504,71363504,0,2
115Y2BCTJczc3mSkZDAMaFuN48mAfCKhcq,FALSE,0,5160,5160,1
114875ctCWnSj1WsZZqYymuxvB4NazS9Rr,FALSE,0,100000,100000,1
115F8NKV7HPRQjJtY7FgGi5QVH1FrFu2Vm,FALSE,0,4236,4236,1
114Ka22q1yn6U2pq2DFJLhRK3aqhrbcHNN,FALSE,0,17236,17236,1
1157jbnTAFQxV3UCgg5LYGcb3HfbV97Msr,FALSE,0,200000,200000,1
1148pDwFizm2XJHokzs6XfV28nF6qhb4GM,FALSE,0,1003331,1003331,1
115KrVpbx14XPDMQ7eH4yJu6RV61PAUU5D,FALSE,0,1079720,1079720,1
115CfnVnvhRpiKaNQkSgFz6211UU5GKzHi,FALSE,0,7739,7739,1
115rNjSdywZqhUj2S91EJZYtzTUR38iK6n,FALSE,0,32269739,32269739,1
1159qdX8z9v2Hrt1SPTEUKLyc8EDCXufu6,FALSE,0,132139,132139,1
114iV17f4WdnY59LB6GH3bsHRid9D4JGmR,FALSE,0,997771,997771,1
1163oL1kCZHtNvhPvjJajkEFcf8i44FfW1,FALSE,0,43690,43690,1
114W9GbsNfgesN5orz75Rj2HdwLcrpjJz9,FALSE,0,16491,16491,1
115zLgDZ1UHKEgZJDgM85KLV9N1Y2E1ndB,FALSE,0,161282,161282,1
114kFjLTyeur6zvDeNrXuoEmbWGCuPevrq,FALSE,0,997313,997313,1
115pMwDVQKzY2mG5oLBcZdbWQkarPw35qD,FALSE,0,232260,232260,1
115kb9EZomnfd3RUJ8qhPuq4mGnXQp9eas,FALSE,122120800,138128800,16008000,22
1168Kw7p9bFndRHsLKhj2y6s48VtAMPozn,FALSE,5850969,5850969,0,6
11658z1sMnVPFDStxi5jVBuPTtZ9wzGX7G,FALSE,0,1000000,1000000,1
1168UmZvXxz1Eq5zgPDaSKjMkKySgnSyQW,FALSE,26856,26856,0,2
114NPA2nrLKXbukuobtroEhitShxHNhg3a,FALSE,0,152628,152628,1
115i7wWqLGJ3eLt4s3fZA48yXGn4SPumEC,FALSE,0,11363,11363,1
1143pcZ3wpPQoTjwYRBEUy7cv7BpjU8hwJ,FALSE,0,200000000,200000000,1
115psviH26ZPwW1MbJVshbx8PTRjEyU5Nt,FALSE,3736,223736,220000,4
115f46j2uG96o3wCVV26A5c5dTpyEKtRD7,FALSE,0,10000,10000,1
114HKvjQk1gHvFRKNcQwhQXaHVP2RZk54E,FALSE,14945,14945,0,2
1165D9sQ1qb2pUVDUQvQrnRkopX7wk2ED,FALSE,0,548,548,1
114gBkcf9bXhQaUEpo4WNuZUcQF57sfBG1,FALSE,129303,129303,0,2
114BMg3qeZrX4qGYD6x4YM2xuhXPjonefc,FALSE,0,3310,3310,1
113ZRd6CsYBSfAxykheWTg7f4iWfxBz6RA,FALSE,100000,100000,0,2
114op2ZaU6GAdtEk7huKiBUyYR4Qo6BUU3,FALSE,0,93262,93262,1
114FHYwigmZej4aKDm7NEcgHWUvEdxkEgC,FALSE,0,909580,909580,1
1134KHHYZwmBZ7WESaKXPyG5wEZbDxc9eM,FALSE,5656,8484,2828,8
11525hGQ8mZDhYzRViZxJk1VTzqnmmWi9q,FALSE,0,31147,31147,1
1138bxeofo1BZaTos1dAcojGLHGfX1B6s1,FALSE,0,1670200,1670200,8
11472BLwepUVZVqi56Y2xCzNev2cKh4tLU,FALSE,7126850,7138190,11340,3
113ZsKWdZ6St2G5sdNLvxqgb4SKEKCyoE8,FALSE,0,2316,2316,1
114UXbMoARMcip7K3u45wXaJfsbVbyaLGW,FALSE,0,6068,6068,1
113LACzTZL4xaubJSjYrNask7kXBaFQFgH,FALSE,0,10000,10000,1
113ZYorUZuKSgC3hzYQv9Z8mUqojCwDCJF,FALSE,0,5480,5480,1
114jeA6EPnMdWWozVq2i7q4vqVFCL8v66X,FALSE,0,360000,360000,1
113XYTjAudaHXrafnqovQnPCQqF6utshpX,FALSE,15357280,29168324,13811044,11
113yz3AxUth4xtR9RprSh9qhds3XK9v3gx,FALSE,0,1000,1000,1
114x41omfobWsmW2AX7v4eFkHN9Wp73YCv,FALSE,0,58398,58398,1
113nyP8WBcPHVCrsw2YRvqM7WXCMrycaMS,FALSE,0,779549,779549,1
114Y85W7XrfHnHimtUnFb7g4NSzpes7eJp,FALSE,0,99940884,99940884,1
114JTMmMBc4mxWVk5Wr3NcGiAc3rCFpwMp,FALSE,0,85310,85310,1
114teNHVVnGgCvzMGUx5ievw9X2EF9CxZi,FALSE,5127260,5127260,0,3
114YAhfcdgsR2sd7gJ84k2NPw4nsAy6mtR,FALSE,0,2184504,2184504,1
113XQ27nzbaKBb2Nh1kY4qsHVWH2X69YKJ,FALSE,0,483889,483889,1
114qZr4Dh2BhcJmVyBt7S6z6Gb3Ax2VgEG,FALSE,120548374,121287407,739033,163
114nHqpabe2mBSFYaKUfswR48BR22rp3pA,FALSE,0,1076503,1076503,1
114uQo4x3gSc3NaTK6pkT9AuqwdRPAKCa8,FALSE,0,342809,342809,1
114z62RoGf92KRrcemaY7bvLRhsV8fozy1,FALSE,0,5500,5500,1
113j76wWhE9heUcfi8iFUJGvJme5nGFVEX,FALSE,0,11992534,11992534,1
1152wamVxrQHTqj1Qs49ETgFCsPVTMiZG6,FALSE,0,20016,20016,1
113Vqt1eumhityDqq1z56HFbLEoAygGENL,FALSE,2860453,3928774,1068321,40
113k5pB3gN9LkNDPCjFEL3MXrVFJ8TcpHT,FALSE,0,15221519,15221519,1
114brYmYLfPVoQEGscpoPPJZX87ovAu47S,FALSE,3995239,4103689,108450,25
113Yk5VB3c4zPdNkhsRvxCk9JYHDE7TTC1,FALSE,0,28170,28170,1
113pTkNpVwHLCKaY5DuxT2RJRTc9tWDmMh,FALSE,40673,41243,570,48
11457nvrUL6NUPGAV795q63UJJ5gBNbLzT,FALSE,0,1840,1840,1
113VaJmLJRDmZMUY89ytADesfWfFFLhtKo,FALSE,0,7100,7100,1
114rmSv9RMHLLkdAubUcwb7nmbVbRCQWnu,FALSE,1890212,1890212,0,2
113jTEeG7tcx2Lkngvf4ZoqPGQy7Mae5wf,FALSE,0,604481,604481,5
113RhikzSr5SvNsSVKmjrmFp96wvQsq19C,FALSE,0,7827,7827,1
1142odqU4H2uNpfmALFBovxBo1DwzdHxnM,FALSE,0,564485,564485,1
1136wC94Sx3CxB1oBZqJroxAq1cHtUX99B,FALSE,2167402,2459070,291668,19
113PUSDsALWMvceYnuVL636vaB5nZsxJ5e,FALSE,0,1000960,1000960,1
113ZUqTi9hmMQBDUowQRGHFK8Bfb7xiDy6,FALSE,0,88600,88600,10
1144ExgaKyjznXfeKi5TYiRi9CDPwRudx4,FALSE,14559,502730,488171,10
114vN928gRqbPon2dGF19f65UnF86GEot9,FALSE,0,3703,3703,1
1142nkTxYX1zo678ycd3TvYyhnA3u19PfH,FALSE,0,5180,5180,1
1149FZpk3VLvy1nZw58Y9VoQMHhGHv5iX,FALSE,0,740,740,1
113DEF7WFQ8A8unyCuCvvY9aoXijk7QG8m,FALSE,0,6727,6727,1
114jBD5WcaurafB5YYc8SDbdByFB24AAnm,FALSE,0,6213,6213,1
1145SvFRN7Xqhjt8VSs7mt8B93pEEYENJr,FALSE,0,134524,134524,1
113mLqqQSLz88DDBm4X1AfJeZBNHhkD4cZ,FALSE,0,3830,3830,1
11529nS1T6SrCruyLLFprX1rqcXrviBV81,FALSE,0,5605,5605,1
1141sCxSiWSKHbZUWFMtoxJAiq8byz5HHG,FALSE,0,1040499,1040499,1
113BtocfK2P3RFzB8qVr8byfV4eZcUcJnx,FALSE,481469395,482263524,794129,122
114a3vpzFG2rkbxwtWwxs5KTStGt8iXEsb,FALSE,0,60000,60000,1
113jf6CTrjCpZzz1T2bR1mFWB5MWiroFDF,FALSE,16495,500546,484051,3
11341WBCLeeV6MjtBQW2qL7yagVT1XkU6Q,FALSE,0,154582,154582,1
113p3epcnJLy3BmDNRw5urnnMyWuRHZjJY,FALSE,0,10079998,10079998,1
113FsRRhz83RSw5NsoNAiLaVyzLmH3RQ3u,FALSE,0,248058,248058,1
1132eVDegbtV65YnTYCHsoYzAgXpXY33Fh,FALSE,111353964,111363964,10000,3
114AqFFa74yJyZ7pyrY4vn2FRwriHecRAn,FALSE,9531638,9534368,2730,23
114aXzrszU9Xg2DsKD4gUJzLHHJwMLCN1z,FALSE,0,103002,103002,1
1151SWEFTi8fGmT3LiQLuzWh5nXh6HQEHq,FALSE,7489698,7489698,0,2
1132fshjMrkvvUiYUQVLLKKqaMGuttn1cT,FALSE,0,5480,5480,1
113TnU8cPFaZDaQejpUReha8syCeHtLveG,FALSE,2964538,2964538,0,2
114NBZmbr1G6mLf4XbitgKXSeCLoc3YrYR,FALSE,0,826,826,1
113LZyvNsBGzA6vzxi7wRm3pWZCH9DsUph,FALSE,1890000,1894152,4152,2
1147ZmyCM8PbTGmfBgCgxzEampKphx797c,FALSE,0,980000,980000,1
114tPrRHFEKEiqC4SH2TGXGmGnm1WuyA28,FALSE,0,127230,127230,1
113vRcxFyJVNBRfYNyKbkMqcCSfkdkxsr,FALSE,0,10400,10400,1
113hTgjtqHsD66LtZVcxUX5b8igFmD5FsL,FALSE,0,51500,51500,5
11441UiSKSrUaQQGhah6nAo966bRoK7zUp,FALSE,0,1000090,1000090,1
113Le3zXArhgnH2Ups1HB3EU87PUHbuvt2,FALSE,0,15229,15229,1
113q8k48z7aGQ3wQm4ZeQ6K3JKZ5bfPbob,FALSE,0,5480,5480,1
114pU2SXGDLovicPH6m9gK2Ajb9rF7tSVQ,FALSE,0,598,598,1
113s8pdgSGcepZE6hHbEroVBjnuYjJndE4,FALSE,0,200000,200000,1
113UjevVMjfdHkfQfqdnqbrpRUrry3jHk7,FALSE,1160,23000,21840,2
112wUHHGBZw9veRNcvCZDvg4J5oxhkq8xu,FALSE,0,160000,160000,1
114RbeBoLokneHmAnz799pYydT4LwUpaLn,FALSE,0,260690,260690,1
113HVLt3d8msA9XPEs65iJQ83htNBecTTK,FALSE,0,6000,6000,2
113ZHCYYkpJzxe6yVCVzBdKqaFkSFbxuBx,FALSE,0,2846,2846,1
113HAkh9siq2NFF2Q3yXuJrZ93hJmWb1ui,FALSE,546,1638,1092,4
113uivRgwPE2N31kyq2qyexjwfZU6U5KjF,FALSE,0,6740,6740,1
1144mWHybZ32Zhctz4vsGxzLcSvXyBUt7J,FALSE,0,193545,193545,1
11476tVKSWbQM8MakJW5AUcdXqNkvd2zBe,FALSE,0,999845,999845,1
113BxyS75Z67EHcSw3cEEchauSFb1T865D,FALSE,0,740002,740002,7
113W6kkLy1mQsDYEoEHpH28rSfDqJW2zZv,FALSE,0,12643,12643,1
114L9yCpqMbroRvJLc6gbSevvK5zBTV8Ea,FALSE,0,1233,1233,1
114XLrXSkcLrGvDNWvAacm5zNd1u9CL4q,FALSE,103354,103354,0,2
114ZQ3UXf4rzsPM3BrznXXJzjb2EyfJYoA,FALSE,0,1156,1156,1
1146e5B9viAnuM4F7ETVKjcaaBkUZ2YjA,FALSE,0,12026,12026,1
114ukwziMtoVHsmnC3XGyzxZGoL3uK6XH8,FALSE,2896894,2898870,1976,2
1136gnTCUnC6cZNkMscxkN9PZqBoYgVxMy,FALSE,0,4000,4000,1
113Wg2RfjajKjvUPm1Aiojt2mLJSeYZhMw,FALSE,0,19000,19000,1
113KZnistmjKtdqqhGLC5Udt7qZ9r7t4uW,FALSE,0,9873,9873,1
113whgGbJjQKenWsdM5iuDB4XvvS5wUckW,FALSE,0,7360,7360,1
113zo5Esj5ohSPfev1RoE3rp68eGHXWYvi,FALSE,0,570012,570012,1
114jHfKaQmpF9DscCFj47UAuNDGoaEMXtP,FALSE,0,1444,1444,1
114t8t8h18X7EamTk33kcyvbgdZoqhuWkQ,FALSE,91823,118625,26802,14
1149CBGSzt83aFB2iqqQbR6vAZCXArP4hv,FALSE,0,55644,55644,1
114ZmCYJvLaNy9uFVrRm43rAjpvvaWVwnU,FALSE,100540,121140,20600,2
1137M3Hm7KomKC2iSUhsRpPZVMnX5Z5EL3,FALSE,0,816923,816923,1
113CVpHAFdQbXXsjbuSuCtQof4EUu3RRBr,FALSE,0,4077,4077,1
113XYFxTNjTTdEC3Un2q1K3rPJS8xyCeTZ,FALSE,1092,2730,1638,5
113ZghhgiiP5o21ymXgQnEzRx9uM1GMu3A,FALSE,0,1000,1000,1
112yeojG6JkGXQrGFpgMmPZNt9EB2zAiWB,FALSE,0,11303,11303,1
113KR8cmHJUev6zjfFvAL6GZdxZAuQBNgy,FALSE,0,34933,34933,4
113NyVqNwW2MppBaytAp9vk3fJz524VQkG,FALSE,0,19052,19052,1
113zk11dFNNcAceTuc6rixgpMN33Sp3zs6,FALSE,0,533754,533754,96
1139CnXXDTJCfDehLgAXxBFC9MYXVkaS4X,FALSE,0,6613,6613,1
113nPxxA3wTx6jK86CWSE2P1EfWYS4CTsq,FALSE,0,1003629,1003629,1
114zcvT3GSksTgFYkmzZms8geYUBLdLGUz,FALSE,20465,20465,0,2
114dQxYwSHjD4cBKYQwzjMgvSMPYVPuSHu,FALSE,0,14470,14470,1
11431ioUx6Nbhs7YF8aXnCgjbS3kxPfyZw,FALSE,0,96768,96768,1
113QEyyUkbyfGAnJEaiQ9pyk3vNLf4eJVx,FALSE,1460,1000546,999086,4
11486Z1tY3sA4ca6pf3mFHaXHsMqzA9MBD,FALSE,0,979430,979430,1
114BP3A4escogRAC7vZatZbVyqm7qYnqcY,FALSE,0,4536,4536,1
113aXmJBBmKhUE3STbptxjR2qzpHUUE6b6,FALSE,0,192376,192376,1
113o6RkhVCvZGTuHBVEKYv5sUaVsbEiWYE,FALSE,0,82146,82146,1
114U781sd9TCPbgxSLGdyiG1xiy75f6Gvx,FALSE,0,3000,3000,1
114vBRStmDmnSn4KMb9cXXFdqtbt9hVKr9,FALSE,0,100000,100000,1
113Xc5VAVZxLWnvuZqHjiiAErsN2XDoJDB,FALSE,0,1000000,1000000,1
114mFt3Xs4B3umdgBeD2owdjbTd3hauUKr,FALSE,0,6000,6000,1
114xiWwegsiKHa8Q52yfKWiGD4ULCvpDRH,FALSE,546,9828,9282,19
113YjPsHKhWoTccp7KbQWGsY1Y33Q4GEQN,FALSE,1080285772,1082499678,2213906,65
113cXAGYdJyHDp3sr3MhRF13A7pm5T96Ya,FALSE,9019891,9021313,1422,37
114Eyudv95ZbRE2pc53n7qFzohnh6UyLcq,FALSE,0,573283,573283,1
113Jj5sTuoYzs49yH7GquRL3ahZW4twSxB,FALSE,100546,103276,2730,3
1153TEPhHuvviFRJGbdPHttMhXSdSZGueh,FALSE,0,1170093,1170093,1
113YtjXVBW1uEvgGTqyzm6FmnMcZxTVq1y,FALSE,6231,6231,0,2
114UeTqYzRB914955UmqKEc6BuGPHxoEXx,FALSE,0,21367,21367,1
113rRApuqSMoFsyDuuj7dLMXVGzJJpK6oM,FALSE,0,1000,1000,1
1153WtyRqWqyDM4ZjaQNWVzbXL5QeqFY5B,FALSE,0,1272789,1272789,1
114EQYwwpLXaEzqSYAJ2MFa8CZs4sHwawF,FALSE,0,5480,5480,1
113GgVpUvQv9kani4ffq7QMojQpC8eSBZP,FALSE,0,10000,10000,1
114mnmw9C9ZXevgsNWVjEYPjcRwtgoYKvs,FALSE,0,5000000,5000000,1
1136UY2Vrt6tcipgPCFzeQe7ZhL78mciQ8,FALSE,285896,285896,0,2
113NPzobQ1TyK5VtqT9Z6QyVKoVdPq2utX,FALSE,0,58310,58310,1
113FgtgRAVmiuogULAZKdeLrzQ9cn7Z22b,FALSE,0,8030,8030,1
113zGPQGiGZ8NqEJFh7vcE1JBE3uTipChY,FALSE,0,53574,53574,1
114eT9byb6rFVp3ZpfLLvtNXLk7u5pGSW4,FALSE,0,9990000,9990000,1
114h6zS7m3LzZTiUVpHDtNrtmXoUH2cg1D,FALSE,0,21448,21448,1
114m3Px5P41vJTmu1GUVSbD4jKouBZ18zd,FALSE,0,122133,122133,1
114PrcsteVPMmvuwJEQW6h4LVitUb5gTix,FALSE,6830003,6846742,16739,3
113dVXMne4SEaDav9idCukGbdsriYWENLJ,FALSE,0,362508,362508,1
1148em1JXvoD9Z4aXSwKbeLgEEwoBDYNY4,FALSE,0,31456,31456,1
113iAAM5z6LtkSJbG1rLJYMYYDdudCkift,FALSE,0,1473572,1473572,1
114ivbj7hcrvnQMAD3Gg8v6NER7J9M5jND,FALSE,0,238500,238500,2
113g43wRdMBvfNnMJ2zg1zakLpQBM6CnRG,FALSE,0,77000,77000,1
113berjGNuXg9KWANsiHssoRETmuCioZCg,FALSE,0,5128,5128,1
114W6kUSXCC5qGEVfvpmqVb1PYdJxJ68W9,FALSE,0,265166,265166,1
113MussKzD6cpiE56hEZLxSjqAMn8YKw1r,FALSE,4176544,4176544,0,2
1144cqBHXRFpgaLy6orgHdeEnULE96ip88,FALSE,0,53735227,53735227,1
114SF4JbqnTpvyijTw3XyVF1MGCsL8EQrk,FALSE,17251038,17251038,0,2
113mikkV3jum36MCTHwiCV5KVTv5FLbPKq,FALSE,0,548,548,1
113KoF3MR67t3JR8Fj29JYv1FM3eAkqgd7,FALSE,0,21678,21678,1
114Yoc72L23vnwmJKZW4wjU7tjQuFjnN88,FALSE,0,500000,500000,1
113h4WK9BJJkdRURr4BHNgDeVvrwkq9PF7,FALSE,0,5500,5500,1
114rZBUnAziaixsj6vajimSUhJ7LCaFJLR,FALSE,0,1202534,1202534,1
113WFysER2o9w7i6juDRtauRuVrUSfy3iw,FALSE,11095,11095,0,2
114kGYQQ7dz617oZGcT362rPaR8NigYGR3,FALSE,0,5430,5430,1
113khGFpGNxzt9TrTgLsbiNjXWaYFpV4yv,FALSE,0,14085,14085,1
1133JuzLs8Wk9CNrPYqRxv9t64Q6a1CH8T,FALSE,144463,144463,0,2
113C4bmUBBi2onMTBvyDGzaw3sp63VcGfv,FALSE,0,550,550,1
1133EKTacDqu6g3sn6oe3tawjh2hBWShYt,FALSE,1376758834,1376794831,35997,151
114PcrDV4RyC7iH6cJwNn9N5m8Tkd7o3Vx,FALSE,0,94564,94564,1
114qoVQkAp2AeCL6hDCC1Y1zW1RrpHMtBy,FALSE,1051597,1051597,0,2
114HSSkgBp19EZUusRzjDA3Gy4HcwbBbiX,FALSE,0,250000,250000,1
114Rx9bd6Gpt4p4SPEgv7oBid8tYqek5Af,FALSE,0,200000,200000,1
113xDAsSTzkkGYwthiAVwESGCzKCY22mSf,FALSE,0,16853,16853,1
113a27FVbnBgw3QLWB8LgcVAvJJtqzYGH3,FALSE,1055046,1055047,1,3
114pm6NFsPwCFRC5R7N4JJNpjGXF6SAUno,FALSE,103915,103915,0,2
113igP2DpHFXDk9j1PoaHN7JhqjFwR3yNN,FALSE,0,1000,1000,1
114iPWBjy6ATQ7XeJ616LHw8XTEB116JwB,FALSE,0,436282,436282,1
1131L2vgr3BYKYDSkDG7BbLyCRBs8QFRaB,FALSE,0,7500,7500,1
114pkh43PnEzCsX8RuZQ1vSKU83ztdur4v,FALSE,0,10000,10000,1
114XXRfeVYNscfJom1FThN33oxmP9ZBBZs,FALSE,0,1242853,1242853,1
113VAvfNDjBRtwC4hpEKHZucJqevLRoLjQ,FALSE,0,115669,115669,1
114MT1uoFo55HypV9bJwJ5kY99xHK5F5P,FALSE,4465439,4465439,0,2
113nY3qp3MnYA24RPUrpfvcLy1jCNWsRhe,FALSE,0,5500,5500,1
113fAwmHptqevoK3zzCYBrN3aDRJMKCdxN,FALSE,500000,500546,546,3
113FjoXxXpDt7eCXu8qUJhGAfAMG4fCum3,FALSE,12215469,23816473,11601004,3
113w8S3JNo32J8m8mREbQLjx1mfdnTSicM,FALSE,0,100000000,100000000,1
114P8Smr815r59ijNhurQpTpMqc6JELo9j,FALSE,0,36058000,36058000,1
114JgDop3X2QbFQTCTc2dMfaZp2bEViFK4,FALSE,0,131218,131218,1
113cFdrcoFf21udRGSuzzWontSqnd7AYrS,FALSE,0,14574,14574,1
114qbK6dwfafAj2yiFK3uW7ehttFSoUGTb,FALSE,0,2418,2418,1
114a3KRGrULg1MEn8LCQpLmtxJff3UTKdU,FALSE,588041,596545,8504,3
114QGXHsxN9Ccx7PkEwi8aHLu6dFsE1gqd,FALSE,0,189101,189101,1
113QUJZAbHq31Q8GTUcQejZoGGdSAqx7vG,FALSE,7996,7996,0,2
113h5dfaraZY8GetUqUcp2PkKrNp8qTpQe,FALSE,0,35006,35006,2
113PmbY3fLjDMWBsrwD3KmunDBBMbAedC7,FALSE,0,10560,10560,1
113UGsosTyxyS8M5PaEPve5yCoK1NzSBS5,FALSE,0,1044,1044,1
114ksjEWi4n993d9DsLtR3tDBnu7uFjwZF,FALSE,0,11147,11147,1
114cYhu8o6DFrAeeCqpFoCYQ26akiNZyeT,FALSE,0,255500,255500,1
1155CocTFNpDbwEmwe1yv47FyR8ZDQxmML,FALSE,2529000,2529000,0,2
113XdtcSHj62dy71TLvq4oL24UWXcnEoBf,FALSE,0,26875751,26875751,7
113cDPB4V98AGdXcvfSJrpipupt95aUpu1,FALSE,0,22306,22306,1
114N3Z4gwNCEcnQGjQS3FduUK67PXjsmtn,FALSE,0,10000,10000,1
114NZAJMuRJkn9e2pYbSpnHGEJw94Xoc7N,FALSE,124158367,124210410,52043,438
113sTTEYZi2Tr9Bx2CTLAbJcKZFzrRCYLw,FALSE,0,24353,24353,1
113SkwYf2bWGtJTzTcNeiLUvBuBwFjcsqz,FALSE,321190,321190,0,2
114Vw7cUBDnyEmznzoNSDJ7EXoUoMQgrZC,FALSE,0,5500,5500,1
114aJ4jTcqJCXyRv6RFWn4Dz5CPvvt62UV,FALSE,262087,1163087,901000,3
112yxUuLtPN1Ty3WvqGUBWp8duuZJ43Boy,FALSE,0,4000000,4000000,1
114ykm7SUiv9kWYS83zNVCMasuneQ8vHYp,FALSE,0,1000351,1000351,1
1137YERkg3w6XPPwqGPPzz2imTd4i46wpn,FALSE,0,30174798,30174798,7
113J4JD444VYhuvbjD7whoTQfTqhim4Z1A,FALSE,2666664,4526498,1859834,11
113VKdhieANtzHLC2ChWLTik4EvzCTnaKv,FALSE,0,300000,300000,1
113kLx44dXXzySM4Qjwq96gj9F2UUNKmiq,FALSE,191361,191361,0,2
114guRaZs3ZnxsgAfWQpiMf3EgMrDieiMu,FALSE,0,550,550,1
113ymA8P1QzyeN4Pio8pPWh3DsoPXBTcvw,FALSE,0,8880000,8880000,1
114HtbstiXRe1Ntdh7YfgVEXBZs4w5gQ7q,FALSE,0,548,548,1
114tovyHL8bq1R1onLEBpq82WyD9xKzr2d,FALSE,0,516000,516000,1
114r7er8cTeRfXZjKM4tmMRvV6iQ2WphPY,FALSE,0,3411,3411,1
112xLHxVhMTg3rannCn2HomksK5bwoei9E,FALSE,31230000,31240000,10000,2
113ZJuBCbLTbdGuB1ik9bRYBQutGm4X7za,FALSE,0,10000,10000,1
1138eJQM1wvKNRA6iV2EBZb7a7CgHrXgHj,FALSE,72737758,72737759,1,3
113dVtgSbjwF5bkdB2T9izRtF6hH3E7Ag5,FALSE,0,20914,20914,1
113d6PDtzhernWXDpysNWmDtNEPd3aCMd4,FALSE,501638,509110,7472,11
113UAywgku675djBXX3x9HW2Fa7x3sdq9G,FALSE,0,30405110,30405110,1
114xDh848ZMEEE4JRLhMMz6Kp3R5ZE3XsN,FALSE,14603178,14743778,140600,13
113zVVZRNsvHCphrpKMbrZf7VsJBNgmpj4,FALSE,53722602,87122602,33400000,9
113J6iGNEoeVzJcYfhWtprJXwFD7xMsW4L,FALSE,137303,265826,128523,6
113h37Z3PFMHe53a7UCT1k76uSQvZABLeR,FALSE,76645,76645,0,2
1142tmZEKAuUgD8Cn9YcamLh6ZQF4swsdR,FALSE,24990000,24996582,6582,2
114qnR39N7ovjyAWqM3NbEKFQK8St9SJ5s,FALSE,0,1720,1720,1
112wWVGNiNgpG8gJD9iPPx38VB5Yw5htGm,FALSE,0,5500,5500,1
114pm6AWZAjUWnqtJhgTdx14AEtYoNjViC,FALSE,6545248,6545248,0,2
114W9ynWaUXjoTsmWvW95DFpgKTXUeEiFw,FALSE,494834,494834,0,2
113ugH8WAYqHkBKmc6VBh2wWxecBbus4hx,FALSE,3501,3501,0,2
113gTypQTm7VN5TM1LASNVZ4Z3fvjMjLfe,FALSE,795782,1012546,216764,23
113wPFekoBAspWhK63X3WqKfRyeaKiKGGC,FALSE,0,1000,1000,1
112dYeZN7EkZ6mXr3T5HjpdqCxUsgLrXtU,FALSE,0,2674,2674,1
114Dvj6zfDcTSJfKvXhU9aGCDj3A1AKAXj,FALSE,0,1000000,1000000,1
113LpKekkLTBhnWWGAWdCQd2padPqzYAV3,FALSE,2006,2006,0,2
113uGnDoRWQMABDcEvHEHYEDfSNdYmtU45,FALSE,9466,9466,0,2
112cLkXi7PA263uKUvjkLyA2DQzJTYS7dD,FALSE,0,6473,6473,1
113E6jZLdiYuMJNkWi7TdVyyv1fnZxarm5,FALSE,0,4860,4860,1
114Y3GhyMhzXJ4Qz6Rnvwz1oJBJ5rMjvxM,FALSE,2677325197,2677330889,5692,725
113xTyBGtzU1SoGeit6iiu9S7neGpAawMw,FALSE,0,59632,59632,1
114B9K3BoZMWyEx2ATpvXpGjHCzxRjXgjZ,FALSE,19964254,19964254,0,2
114KdZZPidJGWXTnxttJkbuZU7Bv5SFxAb,FALSE,0,1000,1000,1
112oaJLopQKyrKzorK1DXHErJ4VaMr6s69,FALSE,0,5480,5480,1
114Ui9TAx3dwtXpJwxrEWVz5Bb6Yn8p59b,FALSE,0,1000,1000,1
113WQqTfc686TmcNESSTSN38pKzNgVCWmS,FALSE,0,6391,6391,1
1145xrdRtxXhLpMHTpkmYSkDaANhxHU3J6,FALSE,0,200000000,200000000,1
1139bYJWFkJqmUM1MbXmPDwRdVbhmWYqHu,FALSE,0,5480,5480,1
113fU1B3YDJkPB9sxVXw5jjFE5Mb1RDCjm,FALSE,0,12041180,12041180,1
1143HvqDWgc6uSpobJx3ys5rhrD66mk4YJ,FALSE,0,100,100,1
112RECTR8vRNXdLCG8SXyAj1syjyFqTYed,FALSE,0,359686,359686,1
112Wrpnr2VtBW6n1f3VbxJkZvS9k64iK9t,FALSE,0,17877,17877,1
1135xhayGqQQ2hYdagXFbqJeMMoqit46G7,FALSE,0,23053,23053,1
114DhhP5muf5ggSoJbDwSuwjGuiJSj8uE5,FALSE,0,11400,11400,1
112ou8vr7837j8wN47h9y3nTHVS9wQvfxz,FALSE,0,156390,156390,1
113ebFVrbDfqtvcrwJt9BxUiZLxr9BWVy4,FALSE,0,857,857,1
112fyYxDYgB2tc4fZTSN3qZbRfbxBYHdj1,FALSE,5910000,6000000,90000,2
114LwNAVBzmdSzrJAa9FWr6PNJQuekkuBQ,FALSE,0,545469,545469,1
113zywPXwgiYvcTbeRp7tZhjEqZbSyHUfs,FALSE,529050000,529050001,1,3
113jPM2DYxzkwfbmrn6mNmM4WmURqzUjkm,FALSE,0,835800,835800,1
113pfbTmRpL2TD6DFD8WhKMfhNBaNzKtNE,FALSE,0,100290,100290,1
11497V2Hpae1EEXtLd1JY1aNue8XRKmjKF,FALSE,0,786376,786376,1
112ocpv1YJx3rtRjui5Yge4bAqbN4g2iKZ,FALSE,0,5000000,5000000,1
113nAPcprSbonMoFB633fXbrDwP6j54GkS,FALSE,0,700000,700000,1
1134KG2MHzsb8Npq754qQB8dQMyuyyzePg,FALSE,0,42787,42787,1
114HfEihpwLUSdmAG6sPS2eaVx42izvAeE,FALSE,110941,110941,0,2
114Ny78cujd4XefbY24eNxwSvdsdPDNxMQ,FALSE,0,919,919,1
113C7QPk26yRdo9iqtaoSXrCoHDsPQ9JGY,FALSE,0,3000,3000,1
113RYcef6kwH8QYQLnjeNoVExwSnZ4EpEd,FALSE,0,1000000,1000000,1
114GGcQsmNk4Ln8t1VyjsPmUvrp3WUrfPR,FALSE,14287,28521,14234,3
114GSCGCGHWCpnWr6HCpHPbP3PJUw2SGkW,FALSE,0,1049061,1049061,1
112TYHqPHvHSmv63SnJoeYdXUfRURodSbA,FALSE,0,4300000,4300000,1
113THM9D5zEa65GvUkGJSZNA1xmu3bTJkB,FALSE,238527021,238527022,1,3
113WKdgh6o2hgifbG9AQGF3mMVSCpEQu3o,FALSE,800000,800000,0,2
112x3Ku8CVyXS4Uy2KR3mXF6kbHK9ofm58,FALSE,0,1000003,1000003,1
1135x6zcD5FPYYCTiEEaxyTayCRovjF9Sa,FALSE,0,362000,362000,1
113WoXLJwdMZt9Kk1E1VL6AnRicsHKGTvt,FALSE,0,57600,57600,1
112V7fBtv8ooeScqxCqGeTosu92ZkMALa4,FALSE,0,1992763,1992763,1
1144LxS9E4CTfxRJu1SE2Kw3g1m7oKzsR8,FALSE,0,11395,11395,1
1144AeUsvFD5YmNzMsieJQUALbQqbHwnzN,FALSE,502730,1003149,500419,3
112q9s6eS4J7BCdqRvaUt7fhEftWrDq92k,FALSE,0,72880,72880,1
114XZUerkHn8x4C1bUjCfw2m2j8RczyAHV,FALSE,1283414042,1283414042,0,245
114FEKiQmPhhGKajiUFoxzw1wxi6kVzxhF,FALSE,0,1140000,1140000,1
113wqLfnVC1UNv9VaLZr1W8mywk74Fhiej,FALSE,0,893,893,1
113LbsjLAQyuSd4zCZbTsKYnXVwX9W5CKj,FALSE,0,140000,140000,1
113DAgrdfXkeCMRH23WURU6uJqs61aST7V,FALSE,5748549,5748549,0,2
113nHkL4CJbyvRd4E6Qct8omXbQf69tWTR,FALSE,0,25093683,25093683,1
113Cg31UiRRzYVysLkeVNGTZ7bLQjkPWSH,FALSE,1000,1000,0,2
112gDNgPmntRPp6mYZsEHRZWyTfr9EWqBK,FALSE,15700,30017,14317,3
1132Xj18dyFUNW4DKJi8qUrLpMZBbuCSyg,FALSE,16498,500546,484048,3
112hEXv97BWvGhkpNexgweyYXwEnihoCYK,FALSE,0,5500,5500,1
114PT6xoJcRPzZBycQNu7cQDGFnvv5QqWt,FALSE,0,5480,5480,1
1131mqjExYV4VAgqbqNzCUbNHM1W4k2JeX,FALSE,0,174560,174560,1
112Zvkvow9kLWTuhBtdevJf4yS3zB9cnm7,FALSE,146755,176955,30200,12
112VfB42K3Tsw166XqLgcFzmPQmJGiZbR4,FALSE,0,603406,603406,1
113BhgVKqzyAYUniRQXtcLAwSpGNWRFpNm,FALSE,2397064,2639850,242786,35
112f6D1QMV7RgrfkcEef55fZQTPxm7WFL7,FALSE,0,91655,91655,1
114HRFzyJ1EUABW5jaBYotgD47oQmoqtFP,FALSE,0,5500,5500,1
113HuQHq447UcHMbtU7miBTm3jUxSuJuMM,FALSE,0,200000,200000,1
1131MwWaoVUE1dSTiRLopQoQcoxRyEMFaA,FALSE,37937000,37953000,16000,12
113n1hqXcSw2nsZQmTqhmzfodsyjCVGqVF,FALSE,147876,156793,8917,3
1136j1nUZZWFm8d3GsUYs7wDVBUSnsNgys,FALSE,1162313,1162313,0,2
113hWkFjVCYpjmjsvQXRJubBhW5G78MRjb,FALSE,187486901,192878081,5391180,17
114RntYVLtX3Lus1UPiV1L4VpUKEXByPJo,FALSE,3300000,3960000,660000,5
113d4LtCAqnoNUXoWhTM9dStBwwQ9CH7oD,FALSE,0,6000,6000,2
114Pctu37P1R1KPnuzdrz2qs93Nm3xuayr,FALSE,0,2789,2789,1
112qmB7JfG58ASCVYao9PPFSZpkfMZj4FS,FALSE,0,1246,1246,1
113AmBXCdYdg9Ca34FfQfhvEcaEZxhE9Bk,FALSE,15132,15132,0,2
1132cgB1GaLPjiYPP69k61MuhZdcVCRGuo,FALSE,7900000,8550000,650000,3
112haZCW9F3Sk6AgQPinJKkx3GA9wRBfsx,FALSE,80000,81092,1092,6
1136Nkh5F8EuRsPwVzVyRuZ5cY4x2PAAcB,FALSE,86732,86732,0,2
112funNbFCe1mMh67N9UBvQoF9ZNZwBncr,FALSE,11807,60000,48193,2
114CV4eismLBc188mxcSz9SJs3m9qWAQab,FALSE,158832704,159816688,983984,13
113ANgGf8CJpdq3K2Anec5yE7ZBuHZkEt2,FALSE,182481,182481,0,2
112uwKg9iWF3RcUCopXzaPR6idDswzX74A,FALSE,1000000,1000546,546,4
1135ZRu3onFvgNBVkibWJDoWBRuYzJufJ9,FALSE,7638,20730,13092,7
114QaLvrvx1JXofquJiPBmZbTqg4hEfwaF,FALSE,4773215,4773215,0,2
114ATbJFQHh4rFejCYVQGEjWKkuwnq6qB3,FALSE,317986200,317986200,0,3
1144t2qyM7EczXG5qoFdyCixhe8EzAmU1Q,FALSE,318592,318592,0,2
114Vbjftug1gLQQ6kwTcWPxHVAS2kvsPUX,FALSE,0,5480,5480,1
112eJqdfBFyAsGBG3a91R8pp9Z4V2Lzvtv,FALSE,108199112,108250498,51386,104
114WkkacYUiLLqyUg8Ae6yq3q4oPAUaQSE,FALSE,0,10000000,10000000,2
113xnCyj1S3LM8iEyeinjLX2CJLjC771ow,FALSE,0,344000,344000,1
113ghuQz9j2LdrC8BXa9a2c4qKjMErM3Ry,FALSE,0,336100,336100,1
112X3ewyjFVY7Y7hSzX3BNKoUdP7wzEgJi,FALSE,260000,260000,0,2
113LYXKP5RYL8TQWBGodSEu5BXgrURVRLi,FALSE,246175501,246175502,1,3
113U5NEyjqWh1cYdAKjB7Wc5kpx8mJDudt,FALSE,0,834,834,1
112y2AqrUG5ugTXvVUZMctrsFYeUk6sYTb,FALSE,6328692,6328692,0,13
113pbdixt8ArNh5dtpjGcKHjmZnfgEFQUM,FALSE,0,206343,206343,1
113rJSigNHCZBGt4YxJa6xq8oeiKpCMwHp,FALSE,0,10686,10686,1
113snnjqwWuEyfMcXmA8eHs6J9cX7KVcT9,FALSE,4180,4180,0,2
113KxjzyRVDh6PxuTF7dqt8r1bxRpZeqW8,FALSE,0,42975,42975,1
113vqqqnHRfc1BwyH9tqwQ5epD1jgUbRED,FALSE,7254464,7853699,599235,227
113tJ3N6FywEypZckLuffiNiHphX31Gm38,FALSE,0,4480046,4480046,1
112bn7MN7CshVJvhKkx7reYprR1zhNB8Yf,FALSE,0,10000,10000,1
112tcun1jbYfiz4nBZxeGnS3Ei1nhMD2Px,FALSE,0,94762,94762,1
112dnYyP8Y1ktvWQfECYRqZqQgnhRL9tkg,FALSE,0,6701,6701,1
113sFi3UW3wTAmsGidHSCUFB27ftjh8uxj,FALSE,0,78900,78900,1
1134MuCq9A6CG3UH5ogCy9TZZTE9dCZDDc,FALSE,44150828,44151374,546,18
113Hw4k4sBGhGDGp6JLkz7iogSLGWE9RUW,FALSE,0,1822633,1822633,1
112eD3tSPpqXZi9AKHPytirjWaRNPRAY1Y,FALSE,75900,75900,0,2
112hekmfL4ayqnm6T2WSSayY7qEGXiB1Ma,FALSE,0,1002466,1002466,1
1147wZ72tEGKBWbiKX3oY7fYgJ1ZWL7kbN,FALSE,0,6778,6778,1
113Det87DgPYddXau82PVoKDuUiabAQ3jn,FALSE,0,509793,509793,1
114Pwn9Tg9BDMjzvemAcWrNF43PvSPPKLx,FALSE,41957200,42857200,900000,47
114KaArcUhLPAJBVMGQM11fg2t8Qz2X1a6,FALSE,0,10000000,10000000,1
113yaVNbaR5NyX4FYMrrsCicmDHjZrLyt8,FALSE,0,853,853,1
113SMf2bF8gAPQGFGnvmxhBaqY9iD7ToHM,FALSE,0,1412773,1412773,1
113kvXmPDt7EQvMi7KxQBkaBVmFZa5Hc8T,FALSE,0,205878,205878,1
114PZrqn8y1pPcLJZPVebntV2cAJpVYRoa,FALSE,0,47400,47400,1
113TfS7S2JsbjYfdhukjdMjQ4pZMCuTsDo,FALSE,0,2914,2914,1
11389MTFFHCcRG2wNhNWLYshtbFV6DVypP,FALSE,5244,5244,0,2
11357rSZ7XQ1SxSTWVE7Gweq11yNKhWwnX,FALSE,0,100000,100000,1
114Dn7vZT3EkHEZwQymZi8DP7h72CazE4w,FALSE,0,64383,64383,1
113JSuJiH9CxJoNzspn2XCmmrVZe9zSn3d,FALSE,0,36748,36748,1
113rnYDfwsqp3MhR5BevCdPQHEcGt9vKbh,FALSE,0,4152656,4152656,1
114Xkyse4gozcLYHXPHNn1QVD7Xf2gNXeT,FALSE,0,342058,342058,1
113PrUTdhNvPo7H3wsqo21pDxebwgQtDjt,FALSE,1792337,1792337,0,2
113fGxuXT15tUjxrG7mGtjbYRcqCque1vL,FALSE,0,184893,184893,1
112TQw7yDhHmW4CRSNgVFios6HpzKPfqyu,FALSE,17859,502184,484325,9
114RLhJU9xsYyNRUrTExuTdSyqkb3CoZ4y,FALSE,1117743,1117743,0,2
113Y2884JTtwHDAHttCXJtrSBiManHuX7k,FALSE,0,6184,6184,1
112dKjYUtZqUyfJNg8C4n6JA9CWUYoVSGp,FALSE,0,69748,69748,1
1136okUYyJyLufa3WT5N5iMyYpPNT1UFV4,FALSE,0,11420,11420,1
1148HaDyzZoWcQuZmbuXWt2nt5UGP8AVqD,FALSE,0,29216,29216,1
1146mwijGpeMChw3xcNfHyAfvmP4H5VwWt,FALSE,85048068,85074247,26179,54
113i18Ld2VFr5PfuJaSWQoQ5352cGb81NY,FALSE,0,10000,10000,1
113Uad2R7ko3QqiK6xi4c5YKMzaoy1wAn,FALSE,0,548,548,1
113RRMpra6tu3SrmVeDBmh88Jysj4LRgtC,FALSE,0,9600,9600,1
113TSoCWt6aFjsRgPAQRJw1pnK6LLT5M82,FALSE,0,1959263,1959263,1
113s9YAjtkEFQ7LiVSe63vhQ8ELZyZCywj,FALSE,6000,12546,6546,4
112sYQSUBLzaG9vUP1egcKJbF9hRrQfCPC,FALSE,0,3648,3648,1
114Joup56SgPdDHTWN6osxV5E7xvPhJakq,FALSE,0,20600,20600,1
114VFG41AHftar7fxrbZiCNCW8bciueyFB,FALSE,886213,918432,32219,9
113aAWa2ay1Zd7UnbNQ9NWU4DmMD7ZUc63,FALSE,0,9813240,9813240,1
112csNesxLdTSi3GhsczCLAwYiiE8bwZs5,FALSE,0,5000000547,5000000547,2
114LuijhW1Z1psFW6ErcCyWLGAyAzqLRk4,FALSE,0,3156,3156,1
112f68iF8dtzR1YghuJwcegau2C7rMR4ko,FALSE,0,1879990,1879990,1
113Qcq7F6CVwzAEa3Ed5tZ41K2xmREiFbx,FALSE,0,65531,65531,1
112uJUt3t32xZUNiomLNe4otQxH4jH8KBY,FALSE,0,63838548,63838548,2
113kzeQrFD1qAQMbh3uLK8h4wzA3Bz8VMs,FALSE,246284,296084,49800,14
113cWT98kj4AYpirzqSs3wNU9z7UAV9F6i,FALSE,454301026,454482311,181285,22
1138iKB23BRk49oyxMGimMXHdkDXspHb3m,FALSE,0,1000000,1000000,1
113uFJWtGD5XvXGu4sW4UGETrUx97yCJKy,FALSE,0,6440,6440,1
112cMcxXJqxNpc3x4EZLHrNLU3k4oQXzk2,FALSE,0,50000,50000,1
112XQPpCotS57u84F18EHQnEd6Ja3FVcRK,FALSE,19300,20938,1638,9
114DSiLYtHZ9amiXz7oLm3ieXN6nKcKBBb,FALSE,0,3519,3519,1
113ExfztA3DJJSAZhcd3z8E9a97rDitkpo,FALSE,0,199951700,199951700,1
112UJMfsvDR89aYhb6DJU2gUYX4opKwnMn,FALSE,150015,290030,140015,3
112egasShu9MpLyUuiB3uN5xiG4LYFF5FD,FALSE,0,10000,10000,1
113HXrZg9kD4G2fv1q5Tb2DdBP1BYwoprj,FALSE,194874,194874,0,2
112s1MPeBrVSZNUxWAm8oGB6EffrMENjTC,FALSE,29898,502184,472286,9
112TqwvAuHDDKJzeaws6j9hfTGViS1YqKo,FALSE,5797369,5799829,2460,38
1137hW6vfW1JRtEc36Y5VtpNQVDzP1vsQn,FALSE,0,727,727,1
11482SF5PMLWzEEhVwdz3FxmkDVxTkypMf,FALSE,0,8840,8840,1
113349RoME85NeYiUfGJWBdyKy6uSwkNcJ,FALSE,0,631966,631966,1
114B3zeDpocMfvGMh74gs7XpdY5Cpuizm1,FALSE,0,37000,37000,2
1148JCKYUDTEgmRG8BQbgNqErnZ7T2ReJf,FALSE,0,2357,2357,1
113X8DCGeJ7cPuJheei5G7HxKfhnxkPbf1,FALSE,0,546,546,1
113yEERNT4afXcx32xN7W3jeiDQXXehx22,FALSE,0,700491,700491,1
1148AQThAbKhLqSs5RTm1SBDqqSFXn8yMS,FALSE,0,355486,355486,1
112zgpJoZxgktEjCgojN9x1881M2iZpKgH,FALSE,0,844669,844669,13
113egEARKfk8YKXq7gnwSUyVRzn2T3EXn7,FALSE,0,9600,9600,1
112rpnh9FMtk2E7LriM6si4sPiJnHxetSg,FALSE,0,25747,25747,1
1139uGuhLvspPzgjeer3bQaCtqW5BhVFPp,FALSE,0,848000,848000,1
112xZHtbRkHC54mX3yNKd6m6bDYSJR6aNe,FALSE,0,650004,650004,7
112dQ2GsR9vSp8QKHsGyFhFesvMAeJpdif,FALSE,0,16167,16167,2
1145yS8w2atWoaqDk3YjH657qWm4cmkhrr,FALSE,0,20613,20613,1
113TwvVzs4ncAMniER4cs9La78aWAXmGcz,FALSE,0,550,550,1
112zKnU1Fz84Z4HoDHAkYnZR9jtwK2EC9n,FALSE,0,22370,22370,1
113s2BJZZVtu554snQf8CjsSbauHnLWhvf,FALSE,0,400989,400989,1
113WbBCuZrqYBCa8BmjTdWRMTLMciSbXmP,FALSE,0,299999,299999,1
113jmLVQhQbhjRSjXXhfdn35E3rgb297M7,FALSE,25546,60545,34999,4
112T5qCDJRuW9iJN9aWM6aNsfzyCuXFctR,FALSE,0,5352,5352,1
1132TBzReTqVuwBJoeJ4EaNmFe9buDiM7s,FALSE,4373052520,4386642520,13590000,16
113NUPopr822Yg6W2SG8hWDXXDuYgrdrQ,FALSE,0,3579200,3579200,1
112txdpunRdoDKdh1oUCznhrpwjwkCW4Cs,FALSE,0,371910,371910,1
113uiSjQ2bRDPMbortWtZPBMGDDuiZiPPH,FALSE,0,51215255,51215255,1
1138Kc9zmNfwWmS8A9SPt9Dbr9oL3tCSNd,FALSE,0,5347,5347,1
113LVGPXdt8JzTF94djQp3sxAKh7dEphaA,FALSE,18355,18355,0,2
114DQPCB9KkNcpYM1SNf5CKViJueuUCir2,FALSE,2959,2959,0,2
113MxDzdXKWFDd3G9k2oiJrRMDnoribh3Z,FALSE,2819360,2819360,0,2
11434hQpaHSTtgv1bKHqbvqqrRp4wxPXJd,FALSE,0,1268,1268,1
112VdBw5ZbSRcu4T3ANTiw65gAgkUed5FN,FALSE,0,5480,5480,1
1142Fx3i3Snx7YHH9ijD4dkzoKxXMjNvjd,FALSE,0,5000,5000,1
113sgWfr6VSkpiKyVDzLWpPdoBM7z1TYYy,FALSE,0,16960,16960,2
113PQLE8W8WSRLKib5f7qxgDjr4UhmNEKe,FALSE,0,13782,13782,2
113ZDtTyfevpUVvRFWJDSKbduzqE2kzXnk,FALSE,99900,4571081,4471181,8
1148T8Hw3gJCq6AbMzHfCozehudMkWvac5,FALSE,0,943,943,1
114NBQTF4WXeKP5DB5UYaehLZPNT6hvWCc,FALSE,0,2610972,2610972,1
113jZ348tJHDummuSmrwgVe8BvADWRPmyH,FALSE,0,5698,5698,1
113GKVPt4i8nqXsfH5vHwUwQm5RG8w22CS,FALSE,14046,14592,546,3
11429b4WZ5YMiD3mCFs6WfnuDzUNwbMbee,FALSE,0,999604,999604,1
112xiuj8eomkkrxwMqzNNPyPPyXr7ctEZa,FALSE,0,1083282,1083282,1
112vNyYw5VRdvUMV6rmum4a3WuYBDvkbeD,FALSE,0,100000000,100000000,1
112nPSkn2jnHmv4TStFLenQnwgJkXbEXpv,FALSE,494487,494487,0,2
112iAMrQv1m9jH7qxYETfKGb82p4M5WiKb,FALSE,0,1000311,1000311,1
112wZhwqAsJ44mSgbA1vPgeFhuer66MX6r,FALSE,0,19845,19845,1
112dfvAcxQjHS1gkvqgkqDyrNC87wFDuJ7,FALSE,0,10000,10000,1
112bggV7gqaWNHU8S47KZ8eEkdbXA38x8b,FALSE,0,974,974,1
113S1ZyziZJiDn5NGf1oqUkAU2HYZNb9zW,FALSE,0,365419,365419,1
113p5gHJtdp9MDdiNnVXFHX1J6ALkioQSG,FALSE,0,50000000,50000000,1
1126pu8LkACAEW4L9eTkDrXAU6YGcgCBxg,FALSE,0,19100,19100,1
112nJdpKgeHDZQrXanKnrdhmNE4fEdUjyY,FALSE,3951,3951,0,2
112YQgqxRs1WxjiGBpNn5KCsjCzuZiSr2p,FALSE,0,14664,14664,1
112MHc9tFiDU6fSrTHFiq3VzKxS4fkwvY7,FALSE,0,400000,400000,1
113DT7pMuB9ArJtoe5179DJsteLNAAHaHk,FALSE,1092,1638,546,5
112ds9coopuae9auD5YWhdgPNQxi9PWK52,FALSE,9097875,9098690,815,8
112Jta7ebYTSoyQCYkYA8qkPLAp4A1CdiC,FALSE,0,99996115,99996115,1
113jkaveijrFGkdzBdrLaP3z83YiEtQnnW,FALSE,0,44898,44898,1
111111111111AigGKc9wNNin1zAeD,FALSE,0,546,546,1
112SErQGp6cq95T8v22uMzJZrNizhmSbmG,FALSE,6038083,6038083,0,2
113GnS3L5PH4YyCF5aMBJoDBbKEcPc9Cnr,FALSE,0,241762,241762,1
113n96KocQLBdxcHjn3hAF3zWFz314f6C6,FALSE,0,1438948,1438948,2
1123X5yNGV9rovrWLZeLWtcjyNxHs3HUyv,FALSE,4726761,4726761,0,11
112AsQBSCfyt2M2cyFS6TpGKTJLJmLeXhw,FALSE,0,5480,5480,1
11343PrKDJePFwMQ5NesGVLSdqqG6b6mwy,FALSE,557602,607714,50112,13
113hgGJRveyVEsW78cA318615HMUKttmhZ,FALSE,0,130571,130571,1
112L9k3YMnptwiWX4vrKZ4LtABgE8NBazQ,FALSE,0,953,953,1
112cKr88wPQN7NtmS9jBK3C2CeknqMEfAT,FALSE,22846,23392,546,3
1121bxQKiVdMcyisT6x31Wy6gkdAR2Lday,FALSE,0,224854,224854,1
112HG9xH6V9xmCpDnYsR9zUDsJZfwgmzvB,FALSE,0,110212,110212,1
113YJUjkmXTafVbstjP5Y25v4UoVhPtsub,FALSE,0,148695,148695,1
112VvHzoxTzAxQGdusLRiDWnWt2rfWPXQo,FALSE,0,2000000,2000000,1
113uVrDTAS5tUtv5BjgKAUjiAj1wK6dmht,FALSE,0,5201,5201,1
113k9caEuYcjpAr4S9sdbcuGDbthNTH8i3,FALSE,108752666,108752667,1,3
112nD9aceWpvqj7iDB6J7fNB4S852SvaRv,FALSE,0,908557,908557,59
112owpKuyLBFf5nnB3DvbX31p5EpYv2MaM,FALSE,0,1001666,1001666,1
113WMkhtHRFDziid3Hcs2emxZxzscoYmiT,FALSE,1867739,1867739,0,2
1131WhWXQrRk4SmUtsmXhygKprj3U25Y2H,FALSE,0,344088,344088,1
113JTED1ZbaGbZ9UhTxDGbsrkM4imP2LMb,FALSE,160235198,162548765,2313567,44
112xsh8zqLWU4kPVNaK9fVTXTEKXocTXLh,FALSE,21931,21931,0,2
113pL6MgLJDwjN7d9Gh6zsQwxVsBksByZF,FALSE,3176008,3176008,0,2
113sGS6V2prXNsi38CdvGwqmg3pGNvnVcJ,FALSE,47201765,47249520,47755,31
1127ea2Tv8vKp9a1wwRoDCd8dPaFC3UTJq,FALSE,0,8637000,8637000,1
112FgUMZmjWQDCbF1WFSdWvZTubohAgiKt,FALSE,902040638,902081223,40585,13
112rnFJKb4Jgk5p2itSNuTNYur2doRzBH,FALSE,20350,20897,547,3
113czEs8pR694QULPPoWq8o26zpBmn1Hxs,FALSE,0,1450,1450,1
112E2ZewSFFyYzz8F36SbjU8wch4ZHP8C3,FALSE,85288,138170,52882,4
1111113LRP8f1u85xHYjiksNM81u2p8j,FALSE,0,674,674,1
113Sc19v4nvjQiZ2UkzWEnGdZ5CMQ6X3rE,FALSE,0,290407,290407,1
112QHWzJsd9iehtvHZmBnipJ5eKzt49wVs,FALSE,6778695,6778695,0,5
113HNqpzPFN3VRvgqxmuNV1TziQAT4XALJ,FALSE,137160,141701,4541,8
111111c9gMj749sSVwjwuce7VSXTuZkj,FALSE,0,5480,5480,1
1139ijTWicdDXSehN6DVDc8DJU3PdjKgJf,FALSE,0,38838,38838,1
112h25svauc3reNJ1YdNJE6cpnh74dm9Az,FALSE,0,121832,121832,1
113C3BSJY2HszdaSC1h7bJ7MTHHuWBLU34,FALSE,30694840,30784423,89583,34
112Z2YZ68Ndpr6uduugSjvCoPjymYGk4JC,FALSE,0,22000000,22000000,1
113zV1GFb8Kvm4RwucUEkk2ekHwPAoLPez,FALSE,19836000,19846190,10190,3
11111111112J7CHvNXZaUpkd3LKFbyE,FALSE,0,5500,5500,1
113bwFpJMGgG1K4T1LqEcZRtohMoHcU1bq,FALSE,0,559781,559781,1
112WzxZK88Doc53zAJmFxgvvPtErVWbCFw,FALSE,0,30918,30918,1
113dx4YLCSjhayJuGEje3DZiV5RNiZZDS4,FALSE,804740102,823085297,18345195,10
113DhTSTCikUhfrTB4u69L5ZRwv7HWvKN1,FALSE,0,17782,17782,1
113t8naTyK8uhReKDLodBwMVbah2N1zrvb,FALSE,0,41586,41586,1
112YSS96zapEG7xxvjRxJUfJmUoLQuNR48,FALSE,972954,1070001,97047,11
113heFvxkfmCk2jcryxwzJHbU7cbt132zu,FALSE,0,1000000,1000000,1
112WMBUeyen7bUxxUqvhfhj6zSa9htYQ1Y,FALSE,102730,108190,5460,4
112DRRq3a792aoQsgReC8vPzxFkZjvjrSv,FALSE,0,1000971,1000971,1
112DrwLbhRM9CDU8SAmKbWgC2VdzLbvbry,FALSE,0,1000420,1000420,1
112F6iMsgJqe5p49wWQbLfYNfjGvMErjRS,FALSE,0,111863,111863,1
112fQCaEjKXRdemZQSe7pN5udq2DEFx6Ju,FALSE,0,3000,3000,1
112x8KYTVzwzH4HoNtitd9ZiaWYsJ9gr26,FALSE,20730,24552,3822,11
112nQB33VD6e4Kd5JcM97rK2QeoB1QbN8f,FALSE,0,995953,995953,1
112AVQ97snm3rboN79drqByHf6wJA8kifF,FALSE,0,30000,30000,1
112gyFncaEraXRUNSyzMX4TLf8BTV5CqYG,FALSE,0,170963,170963,1
113ZZqobsQ9VuwvdQmoBVuhdhu3bKU2Gwi,FALSE,0,10840051,10840051,1
111UFRVKM5mUEhSzXzQSRoj3bxcowzFwt,FALSE,0,5480,5480,1
113pfFN2d5Nuq6SST79REjNE16MUbtVMmc,FALSE,0,33660,33660,1
112qBehCpumUG2mhRXv9DWX2g2t6ZpvZYu,FALSE,0,1056,1056,1
112wG9XGfjwQ734j7ivPS1bcdV26kVTp3X,FALSE,0,1092,1092,2
112ZVPcRu4UMxQgyEK2XEu6prvpU8V3End,FALSE,218309584,218314584,5000,3
1139cwKyyGULGDLxAiiJzmvpsYgMi7o24E,FALSE,0,120676451,120676451,3
1125zF1RcatUg77pmLvCZzeLXRYg6JbWdY,FALSE,0,20184486,20184486,1
112EmKNaxrtdgwEmD5J4egTk9xtd7pEEs7,FALSE,0,307002,307002,1
113LW8sysSyDSt4bsUHzVn4gF38ZAXDNQ5,FALSE,30900,40546,9646,3
112eM6ELN3JvWvPPXLbBSCGbRfSJTMw865,FALSE,0,370973,370973,1
112qD5uqrs3xJR8hsrLiBZuBAUqfSfwAXq,FALSE,4047833,4198182,150349,38
112rtgFAAfwYq4M6X6pdERCryw1YkiiNWy,FALSE,0,79796,79796,1
1123vDAfP1cDXTAaznqDJxV97M1Yx7Q45d,FALSE,0,14344924,14344924,1
113BmSQNhn4c5AvrufcwmjakzdM33qgZ4v,FALSE,0,274090,274090,1
112QgWE7WFea4UCb5H4jb9gyCckXMQf41F,FALSE,0,10000,10000,1
113HsrnsZXRoG1uM9goi9cjkh363oSj2b1,FALSE,0,5364,5364,1
112dehcoEJbYYMKRTPypTbEt61tszf1ucW,FALSE,0,100818,100818,1
112X1z9oHuFsmMRSbNinQQfxptJ8sWKiX7,FALSE,0,3455,3455,1
112itDJvFhgtGA6xJVZiRwmku7ekUnZGaZ,FALSE,0,87859,87859,3
1137NuMXNyiuBJyMD3kyevB7i8SyENquKr,FALSE,0,11259710,11259710,1
113ncas7GP1sy2z6qWkhRgzFvP1TpSVvdq,FALSE,0,107030000,107030000,1
113QTs2NaBfyEU4dkKUpzsa56ZKLZbU7ww,FALSE,0,23600,23600,1
112cGsQZ4awx7BFWYCVcFRnyWQ5vbVcfWt,FALSE,0,9102,9102,3
113y81iYwUFv8w6MdLyV6YKNUahyhK9CmK,FALSE,0,583501,583501,1
1122SpXU4cbCySggmBwmrWVP5LrTQndg9i,FALSE,14388822,18985725,4596903,10
112ANNQkU2WfuTmajyT3ETTJZcAhfD4bLj,FALSE,0,2500,2500,1
113P6xLyuEfLYb69gpk7av2eGSL9QmTR8b,FALSE,0,25000,25000,1
112vftwi8nB6SmBHpPSvjpwfjA7W2LVvgx,FALSE,0,612,612,1
113RARZFdSiiyR5GJipSEzqtd9rKzZc7uX,FALSE,0,5480,5480,1
113yLxzn2m7T3kR99pLzt1pX8JR7wB6DuT,FALSE,0,584629,584629,2
1129QaYhcrPnAy87BqtnGGeyPGWat5CUbE,FALSE,377239,377239,0,2
112PQQTvDZHsipNTYdaEGPr5WroQhvGJPW,FALSE,8259,8259,0,2
113sdyNdTj5VTVM2KzdaXtM9zhNkkjGvTL,FALSE,0,700,700,1
112obLgzSFS1yGmmD5UUPLKs3MyxsR6E5B,FALSE,0,4962,4962,1
1131iyAE1QHjs2Lk9o1SXmXJtYn4y4AhD5,FALSE,5275481,5353507,78026,6
112rvP4VdSyntXuvzctW6SkTGVv6KfZ7kY,FALSE,0,1556,1556,1
112iHpbsxAQhuG6i6NzxFVXk5ttsTo8D3K,FALSE,0,97810,97810,1
112dx1JcwkoGUsQDsuR17AWKzsWGkc4hDp,FALSE,0,28000,28000,1
113BNvYqHLAncesNkfJDPskuikz5JyjoFt,FALSE,0,1000,1000,1
113PavWc9mN38W7GijEXehsvE3nxB82hKN,FALSE,60691462,60692462,1000,18
112QHgCGzeeSX7ELWeQuf9AVCMkupADv7i,FALSE,404190,405460,1270,14
113eGTetTQikHtMGRCxfWbZDiRuRXaf1rV,FALSE,0,19017,19017,1
1123xsbSkVYBoXzbVAtpnWwnLfEzYU92or,FALSE,15929009,16051698,122689,6
1126ftbzWE3nkUR3tk3PQcaw61DWbk5wv9,FALSE,0,472800,472800,1
112oWG2TRgt3C2bsWvj5V62K4twMGYJ1jv,FALSE,0,608907,608907,1
113uoY6kcc8eVRF9apKDJj2Pf1wpwnsNH3,FALSE,0,32557,32557,1
112YoiJiVTcX3KSdhJPndJo3nuBYyDoavk,FALSE,0,18856,18856,1
11112bjJFpt2ZHXg5RkkvKcHVNUbbGV3u,FALSE,0,6048,6048,2
112oi34mCqG54S77QYX1WuvwwYDA7WKaXb,FALSE,380447097,380462097,15000,55
112jPMqymLpzTcEio41CwnVipCQrxVNRis,FALSE,24179641,28367339,4187698,5
112c3748X5fG5tR4PpEaRRxQygfTnemwyv,FALSE,13396,51092,37696,4
113X1WZbLM7m47zH5U3TBYGi1ipAw7d3uU,FALSE,0,41855,41855,2
113rwZHhQAj2DPFxN6zDx3hsdVX6j9Rgr2,FALSE,0,5500,5500,1
11284XEyB6sxQc3QgFg37gyyfsm3HQmMvL,FALSE,0,24000000,24000000,1
112pDspKTGweBfX2oCXsxgnbsjHTksy16o,FALSE,0,4011,4011,1
111ncestRapeChi1dSexua1XXXXYKzGT2,FALSE,0,1,1,1
113nou77bDDo2eaaGCLXwLbJtTtmYzcdAx,FALSE,0,200265,200265,1
112JnCLiYoSgVukbF5yjZYX48azux89e7M,FALSE,0,117599,117599,1
112tacCeDsjQiDdytcF48b2FgXM1fQViaa,FALSE,0,64279,64279,1
112dqKVvgXX9obKz17wLgGRFkN87HPXTyt,FALSE,0,420000,420000,2
112QDnrU57STMydXE6eqwZprMWSu9eZvjy,FALSE,546,3276,2730,7
111Top3AX3KEnKZM5BQHWTTHTjNR4Njkq,FALSE,0,1,1,1
11227yZHfokyDW4aoS7k2ifZhMxR5j8XP9,FALSE,82024,86123,4099,3
112KnD5g7mjshDLPVnS8HgQJEjrzjzuNk3,FALSE,0,13042,13042,1
11271JbXvBpikMYy98jGTZVqqB24j9pNne,FALSE,0,75557,75557,1
113Ne67AxAB6YCg3XBzuxhomVdjK1opLhi,FALSE,0,6748000,6748000,1
1121qwAqsdra7MxWYQijN2Ur6eCpd7etUc,FALSE,0,2000,2000,2
1129DXnz88DftyMocmzWWgCizjxeUjXXic,FALSE,0,723259,723259,6
113qgQyLby6teGWy1Dra3bngN3Dk4W19WV,FALSE,21500,27000,5500,4
113E5iwqEwrVZ56kXnAYANSwtB2JjkJKaB,FALSE,0,36240,36240,1
113UVCNebmQkNd7Cmc7QjcWaxp4gcX5AjS,FALSE,0,15034068,15034068,2
113YhtdzrVykY6KLf42mhp87JtfuMdh5Jh,FALSE,13974,24510,10536,69
113YjyGWEwr5xMqRfz4wEuVWgG5k7m6GbX,FALSE,272160,272160,0,2
1139AXRB8ChTfhpDxKQmNNege2d65McNuq,FALSE,0,2119632,2119632,1
112nMTsdRMRFTPzfwzknS2XB5bk873wfP6,FALSE,0,5669890,5669890,1
113JZtvgyN3tRYdLhY86e4w3Ykx9zTNKRr,FALSE,84014,84014,0,2
112NTnF4mSBoGEEVN2KcCfgLF2yXYugCvH,FALSE,0,7700000,7700000,1
113F8DkcgaKPCKNyueR7EzbdPF7FgKqdo5,FALSE,5713031,5713031,0,2
112D2aa95RjcnihH1Cc6zhWe8fkmN3KBe,FALSE,0,5500,5500,1
112NMMtcTaEEuvqi55mq6Xcy7U8HW9LWXP,FALSE,0,5500,5500,1
113Dgpk3jzWHYUNZ9HtxyqgXWywcXm1yrM,FALSE,0,2560,2560,1
113UzE5XgnZbikvCHZWie72xpafGeyxQwb,FALSE,0,83369,83369,1
113GkieqFFvzXN87cjgVzccwYgLdSvgJFs,FALSE,117610000,117740275,130275,2
113eTBRwDULGfRWm4uoqeir3Eob4WEexor,FALSE,0,4379075,4379075,1
112uatNq46vMhBokkkEbKrX4gd1ySJFCjb,FALSE,2555647,2555647,0,2
113JjcgfAMpcruLK2G725JWW9r4pKuzCs5,FALSE,0,3319558,3319558,1
113Mk92A1YW1seJvozDCT2iqjtadUcPCKo,FALSE,0,9880348,9880348,114
113tUG3iaZ4vaU7iDbDvjaUKZUrgRyjkmr,FALSE,0,11383,11383,1
112gVEMBbLsxa3iKtr5Kin82rPjP1VEZz7,FALSE,0,1000005,1000005,1
113sh1VpGyVdUqjZu44YRueXRGrTfcDpJG,FALSE,0,126932,126932,1
112UtE25QVDj7qtWxtYCQHHFYc5wsydWaa,FALSE,0,9528,9528,1
112ZozW3YE1pvEoaiMRNvJ8vZ88DQCjTsM,FALSE,112000,112546,546,5
1128XCEFhKdUp8Qbz1dVhKiHMSdfWUMAd4,FALSE,0,1,1,1
112aqAY4PMrgWjQFZJxSMn9v4VnQfXpxLb,FALSE,0,5590,5590,1
11111111111115fAY1WwJHrueCauoj,FALSE,0,5480,5480,1
113nzKszY4hZTjeU9BR9vf6cMtGuuP1ft4,FALSE,0,30386111,30386111,1
112jfCMqJRfHNXy4CqLGDuGZ9bDvXTzQ6o,FALSE,384434,1433217,1048783,6
112o6qAJb6Yu7TUJBao3PQPLPPpQ8i7PhW,FALSE,26019697,26019697,0,2
1131pWd5rKBJABXhadEFXo3FRz88Qg5Boc,FALSE,175070,175070,0,2
113ZNsTaztCAzNhqBhY81r7dutydJid2c8,FALSE,48400,48400,0,2
112L4vG9SxPMKRF1FMpFekHtqvHBLgnVSV,FALSE,0,1305938,1305938,1
112bL35cmqaK6KCe9syGErSXogAjM9saUN,FALSE,0,546,546,1
112MxrbfBEtDtGB8E71u7F6FCj7W45X6Q5,FALSE,8000,11000,3000,2
1122HPaxeBffS9pPzMzngP5FuqSfHNkkFW,FALSE,418842,418842,0,2
112bVK1L7ki2FvD9n613MCMfDxJKDtrVaY,FALSE,0,20765,20765,1
113r4z9UcW9TTazwdSbLHfNXaSXLj98CoP,FALSE,0,546,546,1
113snMeuWx7n3uS3JE58sh7tw1sCkTvwCR,FALSE,0,91206,91206,11
112TYxG4XbM7jsTYVbeWoveaRreXHHTX3g,FALSE,0,10789,10789,1
112fRrPPrVE6vxhXrHBedKdvUpeCYLwkp8,FALSE,163934,164480,546,3
113525iLLfKSMQJHw8kcUpu2ztq8xGxoow,FALSE,0,774,774,1
112NRBGBfRzGkv1H6wBKLn8dhsxLCNS3Hv,FALSE,0,19308,19308,1
112aF3ajb29xTsGz5eSEfp1UxsxbfMpMYe,FALSE,0,3117223,3117223,1
113c9EgKKBpSRfCyUqM49R6cSP4fkDyp7w,FALSE,0,2729,2729,1
113Wr5kjNr43vmEYeGGwHfmNKmLJryknnN,FALSE,133780262,133803355,23093,51
112P9ADnGvBQqbpxQBDt3upbm2otrMEWVa,FALSE,0,121707,121707,1
112wFZsPR2dwsEwDNdDAWotU6zR6RYMk1j,FALSE,3126200,3126200,0,2
1131hq8vZnHudSKGn3SvWdYTzBwZvXcvMG,FALSE,109630,109630,0,2
113s2oyn8bWJ22eY8CwnuejekcTbHWZAU7,FALSE,8000,8000,0,2
112VjdvTAGGEWFWDHqQjMaNfbKdThqKrmb,FALSE,0,3314,3314,1
112CMu6449LUh82iQxz1b72UkEUbtwZjoc,FALSE,0,3895,3895,1
112S1moHYNceR4rZMXnurde6jTu4LxzjbY,FALSE,0,10000,10000,1
113qDYhjXpK5VmoBaHcPg6tPnJAivV4PgT,FALSE,5000,11000,6000,2
112hsDysJHZaowxsBkEsYJGxpNRwWcJLHr,FALSE,0,1089180,1089180,1
1137SXNap5fUqt2X86AM83Kq6AVtzCrULT,FALSE,256980,290540,33560,41
112Dfden7GMseo9uurAuX16SNHV7acz7zk,FALSE,0,297,297,2
113qQn4FMVN1zKm2rDJN8cCK7dwiH8VU1z,FALSE,0,250000,250000,1
113Pz6EUJBRaTZZ2btX5Bf4isXZ71Kd2Wk,FALSE,0,2344260,2344260,1
11211o4VzbigFADwazGQs1kMcb9djxzpTL,FALSE,4731,7092,2361,4
112rBUD3NTXM469GEVFai9W46qhZNug4kN,FALSE,0,319659,319659,1
112aNUQRSXa9KEaS2p6SehNc8TfN8jpCeW,FALSE,0,116820,116820,1
112aWn92QW1T6khW7e5XPABcynssLsYa2b,FALSE,0,2712996,2712996,1
112GA2otf5mt3TfXdrbiq8hR8kLSnh6GqS,FALSE,0,182224,182224,11
1129pVHuJ8acm3mUVVqmAGP2hXTAVcJBXH,FALSE,76840103,183540103,106700000,25
11116S6fm4cKgigRJrbu5Sz8E8CotpaLf,FALSE,0,12000,12000,3
1129jTRgkFFrSorAysRHSauaCdWC42KnMU,FALSE,12012635394,12012635941,547,684
112jDaKoafCnYfwPkGX1JenBZkb8JVQZGd,FALSE,1110374,1150778,40404,27
113b9itACJ5tKx2pioKCESxSySsPK1wkvk,FALSE,44166692,44166692,0,3
112qQpKcwKEtLRxs7e3LiXjUdwhNy9Eyjc,FALSE,0,572,572,1
1129EK5HpSSr1SB2NsxkGqWWb7x9PyzppE,FALSE,0,546,546,1
1126FWNHd15Gn1399P54qt7skprWH2bVMb,FALSE,0,51956,51956,1
113Ck8yB7LpALHgdBU8Q2VfFX9eMvJAH7G,FALSE,0,724,724,1
112d9HtP8QmMFyrpumtvyQ6zTuSMJnqQKP,FALSE,730766,959966,229200,3
113yUGTkLrTDJ9c3Q2uYCrEgUjXGZNMrqk,FALSE,0,3425,3425,1
111111111111111EsKuxinh45xAay,FALSE,0,1096,1096,2
112zVPuJEFeqM5kzEzaVnrSdam1L6nSp4d,FALSE,0,116137,116137,1
112SzdqWjGPVnhyKXL5Dtac6NmQbHG8XXX,FALSE,1130535,1818059,687524,26
112LW43NL8ptvW6SCQhmQLfPB7jT3v7QLe,FALSE,0,5416948,5416948,1
1125dWHNZQPHqJWZ8pe3Pkzq3D8F7tXfgj,FALSE,0,370000,370000,1
112RY61ehicwpobu3VvgqTw6AL7HyQzUXH,FALSE,500000,528571,28571,4
112sZjerGdrEFqC2sNMJwB8PZKYvJLCgY,FALSE,0,33448,33448,7
1125vQ3SFXhWhCt7LgjG131g48dCVzDhxp,FALSE,0,246253,246253,1
1136juNU7JJAnRqYk9FQ9vP3qZsrM3RcWT,FALSE,0,546,546,1
112za8qv7c2zrjc9fSPCzfU2y1gTpfzhtx,FALSE,0,1461900,1461900,1
113xuvqvXuYhnqZVwHiLTq4KD1QWAhytUH,FALSE,0,404175,404175,1
112L8VAfzBa3NCHdCJQF4nf9xkPDywNRkL,FALSE,0,5480,5480,1
112G2B8j9yUzWHokqPVk6bmEZriFN41gFX,FALSE,0,998103,998103,1
113gjRbRTZFpPjr39FC8cY5dUHfG2cvGXa,FALSE,1873272,1873273,1,3
112CUyPHQgBLyiP9mPeVvbZMihfoZnPXZ,FALSE,0,548,548,1
113u64mNctiVZfoSz2GjtSMeREyjUgKkh4,FALSE,5127003,5127003,0,2
1128iyA477JYtRpmhkcHUpXaavdhdSswks,FALSE,0,20000,20000,1
113DTTQx83r6HmwKKtZctJixZE2B8uJ2R,FALSE,0,6642,6642,1
11354YZrucn9gRa1t3Qm7gsT3q1QTUqLy6,FALSE,0,943890,943890,1
112WtgWfaYoQJTDDofX85TNz3xXqHkYvCX,FALSE,0,28796,28796,1
113xLNLKaUfazhnjDd9rocquEqs5jQEMca,FALSE,53219474,53219474,0,2
112dFaK7WJ6pPRfguhAneQF1FDBvPJPo8r,FALSE,0,32714,32714,1
113TKQh5NuGYjhyTeYAXKmh1bdrTEL2QbR,FALSE,0,15333000,15333000,1
112DJCaPNDmPfCTwFj2u1r1zkQ44rbQBH,FALSE,0,5500,5500,1
112PoZMgdvYH2YxUshNBjNtTP8sUq31PSg,FALSE,0,7418,7418,1
112i4U6VfNTAP4tysFg5Q1t9JT9k4YaC1D,FALSE,7628108,7628108,0,2
113kADhXu6WHsQEqe5pk6hYgGvJNRqZkdC,FALSE,0,42509750,42509750,1
1128Dn5rVwYz5DDnc8JNx2BhBi26DzJ6AA,FALSE,0,30000,30000,1
113bq74FwfFRLA1AgwSbg9sSTNb9UY453c,FALSE,0,6908,6908,1
1128ECttCaJf3aFUGitLq8xrmnAqkoohxa,FALSE,0,2462,2462,2
113Zp3EP5TKedkzwxCBiSN6Dv4RDV2K3sH,FALSE,429880000,437672039,7792039,68
114JG3ZnyeVqSKkySWU8eMaG3s61JBQG4L,FALSE,0,10291,10291,1
113v5Vq5b4wifNiM6ykG4kxuhMXHqZMwgL,FALSE,0,11707,11707,1
114wtJsreTF5AAA6FPY3K59VWqdwftmMUu,FALSE,0,10000,10000,1
114mNorCBM23ArBuhxRbejhtmPG37dpcCZ,FALSE,1895864,1895864,0,2
113hGSe8JxBQoHv9MF9donNiAWDmpZ1z6P,FALSE,0,10700,10700,1
113vi4MgEvbRwwLHEJxKMpGx7YKv73sMgn,FALSE,0,1000,1000,1
114EKdJ1zsjMMrK6GXnQmxmmrzeZhh93qj,FALSE,0,4880,4880,1
114Pyi96KuV2u45pMiwKaSCjpcJRugr4nu,FALSE,0,288508,288508,1
114k3Sim2FWPpSsM3pE8WhNuDP5ujfxD4g,FALSE,0,10000,10000,1
11412KrVwXueb2DPLquX7fJS7WoY4iaNkd,FALSE,17035,85535,68500,7
113wN3VQmkcFQKgKAyU2hQ4EBdpg6Lx8ta,FALSE,190995,190995,0,2
114Xb5NicUvWvBjJNV3hNKU2dfGHojfsSs,FALSE,0,3330,3330,1
114fygJRe4YgY68unorDSLUXhq1KGcsDKC,FALSE,0,550,550,1
115BDPJikmQv6941hcMJDC3hztVPTdVksp,FALSE,0,803399,803399,1
115LK3vpExaEiF7gTb1LvzUv57EcNQWRjK,FALSE,20000000,20000000,0,2
114uWh7YgTpcKZXCS41UmBFfksz7yz2kXT,FALSE,0,3073,3073,1
114xkaqGb6j5auVnwB537wrywCPPGtukG1,FALSE,0,2672471,2672471,1
115DNhSQxAx4y3WbWYvcjAHbV7PSgZPfEq,FALSE,30000,30000,0,2
113oeN49q2SKNzoZPUTRyb4Fy4oPmHgoj5,FALSE,0,1529,1529,1
114YXGruL2aVdVPRPi2ZNQbzAyZhjweycP,FALSE,0,60750,60750,1
115SF27YWPmzxcUHWeC3FKz9do3ssBHYGZ,FALSE,10660000,12890000,2230000,5
114e39u814APinQ4C4n1nvRoCwxUxGxUkZ,FALSE,52436,52436,0,2
115UrREWSs44xNKFHVJa1qs2GZc1fvBTBX,FALSE,0,1882224,1882224,1
114s1CoNWWbA2Vnp5xixPjwoiLdtKwErM5,FALSE,11399,11399,0,2
115ZaGP1U15X5o8hEo3bCD9CvZzcns7gBt,FALSE,6839432,6855470,16038,6
113Wa6qeHYAmQPhWHQs56sezZGQDpwvZeX,FALSE,0,12761,12761,1
114tMpLu7xyuir34Tn1tvGSSEy2MqR5aFF,FALSE,200000,210860,10860,4
114oRBVH4irskkVDh2TbZTf1Fyt4pKFtSD,FALSE,13621,13621,0,2
114vqJJqPHhdcjJUBvxQJDUq1GQmJy9CW5,FALSE,0,546,546,1
115F29TKELBNvemrJB67cpQ6WDc1rtDgCT,FALSE,7000000,7079800,79800,3
115ZoSdZ3mneibrKA7kCYYPp9DguAmyqJD,FALSE,0,40000,40000,1
1157BrouMpHpukezvPSdws2uoCffzpqowA,FALSE,0,400000,400000,1
115WAsQ9m2GjRujgR7Zp6TaYJC9j3Ez3LH,FALSE,0,10867353,10867353,1
115NxACwp18vZzfqYX2YStyAMspZyaGHVP,FALSE,0,765310,765310,1
115B4SYVybfj86oRddtk1vdg4FzvHHq2E1,FALSE,0,9552,9552,1
114kv1ZcZmSBnhMo8qLa9JpzLLV1CDnTgJ,FALSE,41905644,42551717,646073,3
113pXz95DKZi7uz3XcbsiEDSsUVC4rNWT8,FALSE,0,1811775,1811775,1
114vMnQkgumHyPAkCmMtJDkBSpeXpudFJZ,FALSE,0,970,970,1
1142VxsM4mudXqiEbVCe242vVEHa79dtqc,FALSE,980828860,980834800,5940,94
1144zagxoZDuTzEhTTecuVXUt9apjHS5i9,FALSE,0,548,548,1
114d1bSRQwVA4Hui1MaJSig9JaXgDVfP8v,FALSE,0,50000,50000,1
115PUuFUeoVxQ5ywYXLzXBSs9Lfu6EPwBu,FALSE,0,80467,80467,1
113aDb9wcLxmksxwUkgvE3oYeN7fn8CeND,FALSE,0,8923,8923,1
113xoso3SLPfHd2CX76yokncRxxztNBvCQ,FALSE,29435,500546,471111,3
113pcQz8GcLvpiqrxnhudtbNJ7g17VG3jD,FALSE,0,56826,56826,1
114FXzgCwcsjGPEUhhY2YiJfNXjiAvY7Ba,FALSE,0,13249797,13249797,1
115QrcddTTNKCbUnZ8rQ2mnzRXp73BeA4h,FALSE,1198603,1274657,76054,81
115JkWitbNSJGxYXh3YYFtY7rMDTidW3Ja,FALSE,0,162719,162719,1
115bd9xo3ujLZnZ6sFqSd7tYCogyFvjcxq,FALSE,2439,2439,0,2
114mgwCvzJTpewbkzcPNcF6aJtFoZPp278,FALSE,0,199996916,199996916,1
114jXM1851aEAueF9g85fLNbsjnJk4aDF1,FALSE,0,100000,100000,1
115FMRD9zQdx5UwhqNEc783fg9yok6W6a3,FALSE,125400,125946,546,4
114LXouvzjokgks9J5mXQYzq1EZiNoSf9m,FALSE,0,1632,1632,1
114GzBVU22UDNvHPM2JrB6Fz3uFckUhtB1,FALSE,77299318,77299318,0,260
114eHGsKHqiGxR2RiDt4QW8Y6MHyJ5YxPx,FALSE,1092,3276,2184,8
114vcFmtJhqrmJeStn64SDic37aQ6jQXfN,FALSE,0,3066,3066,1
115PkjpwmpC3BLqVdXZnB5SAQmYmTx3suQ,FALSE,0,88110,88110,1
113i7vsfGL3w2z5sRQepPuUhXZEdcBBf5U,FALSE,0,19238389,19238389,1
114zkbtqtujXmxB7CiiZeAsJFvXne9HrwD,FALSE,0,5500,5500,1
114e3qhCT8UeEFFFJ71Qx6i953fyjFppZ9,FALSE,0,1000,1000,1
115GTBTfn2NyjvkJPSYpXP8vxLh87rykrm,FALSE,158378,158378,0,2
114pUb4YBU47fjafzpkX3h7rw1RQmyy3Pg,FALSE,0,1001292,1001292,1
114Fe6gQGZAdQ2rgfnjBF211RMz66mpGKk,FALSE,2652616,2671187,18571,38
113Uwv9iZPhZwkn2M9eC4pCtAHxkPpMqHi,FALSE,14320474,14320474,0,2
114fJ8bMGh3Yindtd2vNRykPYBtDWMkkJg,FALSE,0,5753,5753,1
113W6ET8Pu7m854iJAjBF6CKcs6N83xuHt,FALSE,0,178982,178982,1
113a8PMg1kv7oG8jXfMD6GJYug9vZDc1eF,FALSE,0,200,200,1
113jLXWBHRUZwtbzwecertSTqmVyMp98ct,FALSE,0,9129,9129,1
115Fr1oMHq6nhqkC8zeg6srqCAvQpiKJ6V,FALSE,41244399,41247400,3001,6
115YTtfnPqRFiWgVvbsZm2TdiQZpxPvAw8,FALSE,3180414,3180414,0,3
113vBGHR96wDQRiSSjaJjLY7A4DkKmUJFj,FALSE,0,1000000,1000000,1
115Kuqjm5egdszfeGe2D7hPeYAb9sGyoWT,FALSE,0,10000000,10000000,1
114qxwXys52xQdRrK5fpnEWWR76Djvcfo,FALSE,0,7617,7617,1
115GYPXzSM3ANPVqUaBguuvRNwzToWqwGf,FALSE,2000000,2000000,0,2
115VerJ3iYZeheqbEL7JCc3SWwdDoyMQXi,FALSE,50000,50546,546,4
113joWuPSKjsfv9H5DCgHTP2kFxeaQM4CU,FALSE,0,257022,257022,1
115621Lt3RaFoEn8cj1T5MWiX3vW8iHini,FALSE,0,690,690,1
114pU2pGVqmUKa6DFjavgiudHNdHeH7KFe,FALSE,0,697914,697914,1
114xGLDQD4fVME8pwTajKx8yoF21HSbGC7,FALSE,0,14945,14945,1
113rnEXKQyfNLCkLRFLHestB5UAhsVzWDt,FALSE,0,357601,357601,1
115Vh6W8oMNwaBMard2s7wxki2u2wg7EpD,FALSE,60659656,60838010,178354,20
114D6bi6Ywyc9BZ3pviDBEqwevbefrXmcG,FALSE,0,91040,91040,1
114wHw8fGpWCV1yQemPqX4nXHv4apbrRx6,FALSE,2243868239,2244372992,504753,50
1148rfEh29BfeGYbFsr7esUCe3M1DZPupX,FALSE,4000000,4000000,0,2
114VumrDswnzMTpTnCnYZRT23uYDUPruYy,FALSE,0,8855,8855,1
113aSZFP4mxLoKXHK9jDpwsEa9aZhiW1SJ,FALSE,0,1500313,1500313,1
113gZq6ZzXvD8zGT6ucdkKfywQfrP7cRcF,FALSE,0,5100015,5100015,1
115U6HFwR4MaL6fLbQtSW3k3bcHWoDmPAr,FALSE,0,90000,90000,1
113uYRYY2f9XC4JmTDYrnWQiypRFEr7zcW,FALSE,0,94010,94010,1
114RwSabg7JrBvyzbgNUuoFqixF6jtXuk5,FALSE,0,531630,531630,1
113kU9QUCfdvVp4FcybJWSShS2vPip9jEk,FALSE,0,1009101,1009101,1
114tciRwWTpf2Mg4N1jurAtVdhW7GPHPqi,FALSE,0,103503,103503,4
114tyeza9Vy5RQb2VTCFPRPPXu6yuzf1iL,FALSE,0,5000000,5000000,1
115JappRFp5yo9753wNdx6zPY8QC7tKq4j,FALSE,0,1000,1000,1
1147fahcJofDznMuUpbcLyf7cjGEuUs4k6,FALSE,0,8303,8303,1
115DyGTudkM5n5CCHqhBMmrJpv7nbdFqrE,FALSE,0,313188,313188,1
113yt3SEPkkt23nxsHTvAQvwvDKqQ7Cizy,FALSE,0,534555,534555,1
114KnKKKapbMDxnEXUhQBa4o6yXEGZUW2N,FALSE,256516,257984,1468,3
1156YZrNCtMRaybKoMKPq2h8mWdhnLeH6E,FALSE,0,192586,192586,1
1142GgeyzZ65XMVVRq1r1EuCLtL4xpmBXT,FALSE,0,11880,11880,1
114D8xvdovYVgJHP2VRJPeKureSmvJM8Mm,FALSE,0,783,783,1
114xnHy8ndBJUsgYSHBiaNtwxTmNGcZum5,FALSE,5915392,5915393,1,3
115ULd8Mvusb77oor2qbc5vsH1GAJGmqu,FALSE,25406381728,25406381729,1,5
1143QtSK8zMH8ygD3aFkAeBUGMVmpezmix,FALSE,0,94415,94415,1
113q6viGb5k3zwq9bANShWXJRWvJp42pDy,FALSE,0,25535,25535,2
113o4puicZNUZE1nCUyuNp5bdJQsJSY3fU,FALSE,0,1819629,1819629,2
114Esx8VXAXwupmYdSQeu41u4V2dRBQTw5,FALSE,911496637,911526732,30095,606
115VA6f8ZfDBKZ3EhdTb2CcZ7pF9ZyLvWx,FALSE,0,8700,8700,1
115YmELfMaFe32mw5WwrisZr2aHeGHC5jf,FALSE,0,69737925,69737925,1
113a3cA5Lq66H9VYQwJqoVDFkwNLwhpHvU,FALSE,0,1000665,1000665,1
113qeT7QydFkGhBtNjxGVG5X9ct5egQNGi,FALSE,0,832122,832122,1
115Tf7J8R8vEmNtrJYxbYYhZmZ1zpoJ86o,FALSE,0,308836,308836,1
113uw6pcmqa3swsQRNQ8Z66angYTVucKDQ,FALSE,78073,78073,0,2
115AfrNBpP6DRMYLoBRgJHMhXjqZeJNGd7,FALSE,0,31211,31211,3
113pDM9TzsDkBjGmhsm8sSL2N6BDBcazgu,FALSE,0,649141,649141,2
113xU3kqpcCrMxy6dbcpKvnDJhankCk1Ay,FALSE,0,1660,1660,1
115RVqgXBDLMCm7C1vPZziRGRgvW2H74qf,FALSE,0,542400,542400,1
114ZpUgYrv7cewMpnGBAPw1WywZ2ohdHD9,FALSE,0,125880,125880,1
115HcLNtPoXeRWWvVVz5KE5bAtZM7iaHnH,FALSE,0,3040,3040,1
114dtJmaSCjyTgEHMgQGSpjZMe3uosRwgj,FALSE,861706,861706,0,2
114MfBqNqLK1k7ceeAFmbuLZaEyNQNVuEq,FALSE,44755044,45137129,382085,213
113j4paX9Q3EpuRJY8yzndkRc2ko7mudHa,FALSE,58870,501092,442222,5
114pPZtFexcJRFaV9RbZNGTW7J3NDLz562,FALSE,11000,16500,5500,3
114JvGRpSjWYVpDyjKFoeAu7J4dNm1q3wh,FALSE,0,9525,9525,1
1149dMSy7DP22AK3o3WPzAzbs7V4LKJYzT,FALSE,0,12859,12859,1
113VNqsRkMxb3cWtgUs1eSDfWXYTHqnrgS,FALSE,0,3580000,3580000,1
113xizoTAPwuJxBseesL6W59b3kwKWDNtp,FALSE,0,351308,351308,1
113q8CEpbKWkjhdqh3g6jnvipjxaKjGDzS,FALSE,0,282005,282005,1
114wSdwcG4aHUAdcST8qLyJF5YkQy5xRsV,FALSE,0,865,865,1
113nT3jckJci7KpRZjJQFAT5XZvJJdJWp6,FALSE,0,2500,2500,1
113b1jpbGCL7CovX26heWUg1iDwB5CBQ8s,FALSE,0,1533,1533,1
114zE6DNLhqLtns2i2uuNQ62U46cQpBrVC,FALSE,0,550017,550017,1
113gATYsNDpMfymJ2XU8UkvD2uq5qciwQn,FALSE,0,970000,970000,1
115FbtAvxDJHnzmLGyeAujBte4w62Js76P,FALSE,20000,30000,10000,4
113h8EpfMSuqCrDJthWw4ECkGBYgEocyMd,FALSE,0,1000,1000,1
114yMK7oGK4PNBKi5j4x3ALNdyAuTwrmMm,FALSE,0,930,930,1
114CjsT9EU5hcJ8DbRaCVGtjh89RKLC7DT,FALSE,0,1000000,1000000,1
113U2B9UiuMG2qrTnWPtmobFcb7JLsUaFJ,FALSE,0,15419,15419,1
1156uLJo8yVqDrbAsLweYt7dvZTxpvQyH5,FALSE,0,5100,5100,1
114FVzuwpixW1CJ4BvJpc63sTwRVZ58NQZ,FALSE,11732978,11732979,1,11
115KY1jzZHdPjeZJiVdL9dvJdj1WtAQJqr,FALSE,0,449821,449821,1
114EGZKpwFMAbK9Ry89McUUvNMdGwBQAwB,FALSE,0,7058966,7058966,1
1141ypwe4Kc18dUSHQFnzLCEmGwLuAeCXo,FALSE,14711,14711,0,2
114rFH3cNnS1ybExU2PNZxtBLrQd5q9FdG,FALSE,0,284820,284820,1
114KLRPimuiqk6KS3wdFY8UB4PmCVaDrFt,FALSE,1121363822,1121364914,1092,28
115TCqWqpcmUKVyaKaXFGuWxtZdgj99wLg,FALSE,2048186,3626799,1578613,116
115Tk91AsjuQvtAr6JdU9EbmLSA5DiiQ9w,FALSE,0,12213,12213,1
114hnMYFVoXHEBCNrgmUF7AGun1dDJR88o,FALSE,0,51409,51409,1
114aAEmiUQHy2RUfaRgD8YxMveQbcCmdPt,FALSE,881192,934386,53194,9
114zZSwYnXCqkVgCDoaogCuS16FvYLva7U,FALSE,145811,160673,14862,7
1148veD54JaMXz5zkqFVBuoZQ5vjP44E6w,FALSE,31030,37127,6097,2
113wJHs1dyRhtjD1uKMA8PLHeNmhXzy53G,FALSE,63887200,63887200,0,93
113syDh31Kosk7VLnsPqEpU2nwL9VnobeF,FALSE,944183,1302602,358419,5
113wbb1DdA6so4iF3db9UEtx9ZtULCr8Fb,FALSE,0,2570,2570,1
1153XSmMeKNgdaWNr7ffPKYuRQCw8XY9Fn,FALSE,0,2195,2195,1
115Fzk4QcN1QSDPrq5LMxh554ac353n1A4,FALSE,0,1000000,1000000,1
114B7aYqsGFqr6WfQMk5335GVptnBCEdc5,FALSE,359734,359734,0,2
1159d5RdecQSLFGbSgRYDbUuJNf6uKXvqo,FALSE,0,1217364,1217364,1
114pJjAF59NwJa5VPQTT8kLZV7QmSJoGvE,FALSE,0,423064,423064,1
1158dwq9Ln1HaedDE98HsadmoxLQPFzx25,FALSE,10397,10397,0,2
115Qp6WG86oqrWu6hgwp2Ps3aPJomLVJqV,FALSE,0,2730,2730,1
114Sd58U2mfiC79Pu1hpn1iPB3qH57SeAJ,FALSE,0,2730,2730,1
114HZzkbGEZ5veWnAFhPdgq6B3svf5P2qZ,FALSE,59575631,59664746,89115,4
11547bU3ijDs4U4vsmhLkXZ3HZYfto6pib,FALSE,0,1331,1331,1
115D3x6u73k66o25CbFG6PQoEoN5DoKSaj,FALSE,0,900,900,1
113k4buSd9xE4NvxKa8cLpsCJyfPoF4srZ,FALSE,0,85310,85310,1
114eM7xNxmAwfUhJdRFgtvzGwc4LBogTXK,FALSE,546,1692,1146,3
115Y2QtKB51WoCi1z9QTMFkGuNfzeRit4N,FALSE,4715832,4715832,0,2
115J6ETRj1JahntepPrKBZMWE6LTkMvQy8,FALSE,0,11624,11624,2
113zH8f1sXzQYvSdLQk2KDJDyTXefZpnn,FALSE,0,176360,176360,1
114wXcT1SuNUaMrGSEPxYVroH1GHqNhQzX,FALSE,0,4081,4081,1
115VgU4tPj27o1Zu5oM5YJPquzENT1KaqE,FALSE,0,101639267,101639267,1
1157gRu4dXoEMRoE9PRM79JZXPr18afaDf,FALSE,0,1987894,1987894,1
115Tdotkircq1hCoRTBH2ZRmDh2yhuaDhS,FALSE,3048637,3460649,412012,11
114NV42TycehHSUMEzpCY9GXYu7DJJsvrn,FALSE,0,141800,141800,1
115FLhLeHKGzn1rU8j91RjF9iwkfhWRgXS,FALSE,1039585,1039585,0,2
115C8ZPF6jcffb4wyrH96AV1KTaMVqNCtf,FALSE,0,1974,1974,1
113gDc4g5BAN1uC1Y7WmnhdcCedMsXCYL4,FALSE,0,7000,7000,1
115BHdLZzsD9BfpwrFGZnPu6875LPnnSCf,FALSE,0,107338675,107338675,2
113UGSGW7ZP4u9qqxbLXxfhFau1ND71w8u,FALSE,4323,501638,497315,7
113qHqAWSMm11uF2Vq8EGfQQ9wHFG5LAVp,FALSE,0,177761,177761,1
113u3yavNdPhZeRZ7WqJVb9J6KB3zYx7xX,FALSE,0,6212834,6212834,1
115SVhZPGZXSrUngVnYHqeEDxdLqj8pYy1,FALSE,0,237183,237183,1
114eAtU9JJm3rcjTdW7mKNzC1wdqpeMBFE,FALSE,0,1000,1000,1
115GREJPaiHWe4zDdkxmtGPu7DeqXcNPE3,FALSE,0,1517,1517,1
114qazVdJghw9UmwUKQBqB5eg2u6F7ww4J,FALSE,0,8037,8037,1
114Lq3teHRWsDpDtfbXdwCfXki5qxxEjPx,FALSE,694998,694998,0,3
115X925KaVsQvyB8Rq9U3nFPxTpJQJJF5T,FALSE,390597,391144,547,3
113aV8JfsdRaoLS2cwRhrdrQ7JVewBNZJh,FALSE,0,2000000,2000000,1
115ZsZBAGMFpbap42J11SmkD7EeTEBVWyq,FALSE,0,33253,33253,1
115DVeRMLxYPTcVmchbePdxks8M5TuTK3U,FALSE,15300000000,15300000547,547,3
113wudzbRKsAW6KraR3pNPr8GZjweucJEP,FALSE,0,613,613,1
114yKK5h1Fbv772wKhSHHnNGA6bkKfw2YE,FALSE,344138525,346648111,2509586,7
114ww9S4iEeq7bU797qtouZgQH8eiJr4y8,FALSE,0,5500,5500,1
1151DdLsuCSyFEwGomneFTzpQH27GtFWhA,FALSE,0,14998,14998,1
115ALvZ41M9MZVkcxT6adUm47o1zC7am7u,FALSE,0,20000000,20000000,1
113Xe2iesUwcYxqoXoq4gjsEbETF8YSB2e,FALSE,183189079,183239079,50000,3
114cZKmY5wHB5mn9x7X8W1Z9raJnRvme85,FALSE,35457,35457,0,2
115ZsV2yujTNspg6qpfUCWSC2gt35VTQWG,FALSE,0,33396,33396,1
113xJpW17tX7Sx9vZbJLc5C1GRPKkuLdRm,FALSE,0,175670,175670,1
114bXbT74qmjHj24CreKWbejKPgKUGJQi1,FALSE,0,11257,11257,1
114iRXMhb2TcZEoxtPpFBHEejvw1iV3SZg,FALSE,1302392450,1302490755,98305,9
114DY6frxM1ZHZtgtvczuJhc8ECvMemFaF,FALSE,0,300000,300000,1
114QUbjB5BMCmDYXDDsRiAh6LYUbymTwsx,FALSE,0,1822600,1822600,1
113ZgoU9VuV4HyyNZvpMmycdKLPpEGRPRB,FALSE,546,1092,546,2
113mxS9apbtdt8t3pV4B66o2dRYSkW6Njb,FALSE,826500546,826501092,546,7
114kgnY2qWYFmiVSz2PNaMZwPBJdPSQx54,FALSE,0,4240080,4240080,1
1149EGhUKV7zqHAGuVBoeZ4Kq79xtYPgZX,FALSE,413906,413906,0,2
113mzcEQDoVJskEs36YE1euqAPde3nWRKJ,FALSE,0,648247,648247,1
113uWSnPyju1mPRvbVeEkfUegnkEuD3Q2K,FALSE,0,14122,14122,1
115bQ3FPtUJkTHTG6t8YhbAk5sWpGmix6E,FALSE,0,8565,8565,1
114XMMdLXvmwxxtGDhBGh3YASocBkAt1qn,FALSE,0,14788300,14788300,1
114yY8kuseBihUwfVXN9JjGNpcFqPvxQSY,FALSE,0,557717,557717,1
114uvp2jyxBakaTNUX9g8dZXi57PZiboKc,FALSE,0,50000,50000,1
115CaoupCxgE1GfadMMuD6RvTQo3YdKzvZ,FALSE,0,4880,4880,1
114ErQs73YU7uZRxJ5SN9hqTWod7HaRxnE,FALSE,0,11500,11500,1
114WCczNZQ6FXMPE4HqXLwyAqaXidoAUAG,FALSE,11593600,11593600,0,2
114HWBspxBwBHq8rWqZGhaGme36Wz2QLPD,FALSE,0,10000000,10000000,1
1157bqsZY8P6huRyXuo4zmRRnas2u3Z1jy,FALSE,0,10000000,10000000,1
115brGuC979YnxiVVvujZG7uWHawrXVeKq,FALSE,0,101972,101972,10
114ssEo4sTxNmK2sLvKstDSzQgvv5TMZ46,FALSE,0,3128290,3128290,1
113c9mxntDSHPa423YdZRposyt9UHgtHRj,FALSE,3898,3898,0,2
115NqHvxanhaUqKXiLESXXqzcNrrCDW63h,FALSE,0,1930,1930,1
115DABkfYLBwKbnicrTA7pmqBwVx6xFR7k,FALSE,0,1000,1000,1
114cxfeJoiXrcABiDhMq4ojACky9RcXZJx,FALSE,4010,150546,146536,3
114FUZmFCNKtk7WTeDnJyJtxHGcv8r48oc,FALSE,0,1093,1093,1
113WkghQzZVYs7QDZSR48uB7tiUW8R9NA7,FALSE,0,977,977,1
113qXwkLDsgAHMynaLcEdqYTJ1yqyvgSbB,FALSE,0,363860,363860,1
114eQa2T1yhoskdH47ZLBmPs8QHRzy3tKV,FALSE,0,97613,97613,1
114j2JG4RFK8zVT3cvz4xzj38KZFGitnNm,FALSE,0,5912,5912,1
113Xfo2r7UoNk91MmUJEvkTxg9bSwDrahr,FALSE,0,37570,37570,1
114grjp3zw6hhdsRFNYWh7L7WZhdM1h88Q,FALSE,0,79278,79278,1
113X6uE3u6d9TB8uicr1td1HhQ92rVw5Ta,FALSE,0,548,548,1
114c3TJ2PRaRmuJKnzjqXyjHYpWBabMn9m,FALSE,0,95222,95222,1
11459Nan5ZLgsTeyq9xCLUfKFztJEkHsJr,FALSE,267475173,267475173,0,33
113ywPtUCrrSKjs3Axox5vrFMWmK8rTQXT,FALSE,0,226151,226151,1
114DiWwnhRy9PaVWymX9g3QgD68uK9mHs7,FALSE,74911,449469,374558,3
115JpsGT7YyEbhS8TefMjQu1SHpbqsLfaV,FALSE,0,116134,116134,1
113yKBQ33hUDpWESgLnBECq3a5F9KqrtBC,FALSE,0,2200000,2200000,1
113xTcyyoRyoAd6N3GdWx9wBDpyJnDDSan,FALSE,0,429954,429954,1
114FU7GbngCBSUybHRwGfgf1p2kP2BLK2b,FALSE,0,6839,6839,1
113wLF4uPJfsYefeV15WDW2FdSXJfiV9b8,FALSE,0,9715,9715,1
1158GvgqUE1UHNAnfHG4GN8KwFfokvcJZe,FALSE,0,3221,3221,1
114sDamG2uqx8pCVYQtVmAnPy6uKicxEUj,FALSE,0,14064,14064,1
11413HUEbWEBoJjM9UEvG7yGewjn1Pofjx,FALSE,0,12429,12429,1
114vdFktezA3htYjxowPpg3sDbF21rtZmk,FALSE,0,1753,1753,1
115VXXYQrWvuvCic5QNMw1tjvt3BbJc5J4,FALSE,0,1000,1000,1
115G5U1h3wnCr19RvvY1anL6uxnTCsd9bN,FALSE,2990000,15990000,13000000,3
115Y8CjnJsNC2xYQA4rUpfGRtiNWsL2SxE,FALSE,0,1000002,1000002,1
114FaZQFHK1wS5p7iPdqCuQcyJrRkaTJ6H,FALSE,0,589442,589442,1
114XAYaMabTG2a92nyEhq16UGDrezAYXXN,FALSE,0,2225543,2225543,1
113tCKqgKGdkupVGdVjaV6Gqa45gbjJsJy,FALSE,8935640,8935640,0,2
115FxDxRZ6GnbQWXgQRbzPZZRVgWC16DxX,FALSE,0,384519,384519,1
114GaSe3jopGNrXGXCofLfH4h6J8yZEUZi,FALSE,0,13220,13220,1
115HLFNoY6HAr2dZP4z7w6QsdrBTVbHRh7,FALSE,0,13132,13132,1
114ZqqNPgSJRrpw6Snq3VWBM14byentnHD,FALSE,132316960,132316960,0,2
1146LiasB7x6E5znVPAYGtRAS7EwpZxeKd,FALSE,0,57273,57273,1
113k2s4ntY6HqoktCuqVsd4UxfRVsfK5gM,FALSE,5396398,5396398,0,24
115Qfmmh1hzzDazTXMXSC25gZFowaHrAik,FALSE,0,3626,3626,1
114nbg7LdTpjaRGdbk8RZNQxRLaW8FP9cn,FALSE,0,1577,1577,1
114cQoFcjiCRFwZM1djmpfUbtGME5mWaxa,FALSE,698662,698662,0,2
115DJZfqjjmHfGYfeFTi9qKEcYWGvbtQee,FALSE,0,1010000,1010000,1
114HmuXp6r7mADSEHiHdhaTnwkFxEaaeiT,FALSE,0,15860,15860,1
113ZovwJNZogWxoz6c53CGSV9nmPiMayHu,FALSE,0,2889,2889,1
115CEyB5dhUxra6NgNgdshZWek7JZGYHhP,FALSE,306643,306643,0,2
114NupaDbJymWv8yEEXWMWdi4UPYzSf8vo,FALSE,0,1000044,1000044,1
1141a3bgUSfoyMyc9JVWvfkw9z9tm7cgNP,FALSE,0,52718,52718,6
114Z6C2vuv4Tykd29qwfod5gUJKeL3V7HP,FALSE,103500000,104500000,1000000,3
115TrtS92pfZa1YY8U4goK3jRK7g1DLabj,FALSE,0,6417735,6417735,1
115UEaizH7PR5SRFVDM1RXRxUorjcYPRQd,FALSE,0,820000,820000,2
1145VW7Jo6hefvhSBnX47Z7CWZG2kA4Ybd,FALSE,2793104,2793104,0,2
115fnp8coMNsc2nGWXedqD1QDdgyVWr4UN,FALSE,0,1004531,1004531,1
114E6ugnGgUuPf579uMR8VzyHkGp4Vjcnx,FALSE,147013,160000,12987,2
115cM64KffTnseQPBkGtCb8RqCpfvtdQ4V,FALSE,30989459,39350868,8361409,995
115UhhxcW6hJhsUhUN84SUrPXxjB6ookhM,FALSE,0,33782,33782,1
114C1vnvmrMDeQWeoGcHm6gx5ybRV7PLjE,FALSE,0,13859,13859,1
115ER2KXx6UCB4qftX3LFrFBSnUpZBgpdV,FALSE,0,45517,45517,4
115EM8GTMHqsbej5YoUK6MZj4BvFnr1egG,FALSE,0,173598,173598,1
114fnNNHtd7pHrJg15usLynJSDAjxTv4yz,FALSE,4015,10546,6531,3
114AQCRQEMQo5FQXLH1NPayFu7Q4oc3BXm,FALSE,0,7266,7266,1
114DMk3WrYoWkZTqnJNibbvzgxZTRxk6VW,FALSE,164720907,164720908,1,5
1142mvM4ZgUB4a1a7MErRqKRADdKCiQz3g,FALSE,0,216275,216275,1
114KQ1EqPwQdjunNxT9JeHkDASR9SnGSgs,FALSE,0,11841693,11841693,1
1147Pf1LvwGvnnzJQdhfhoRgYA2rrjWS2p,FALSE,0,500000,500000,1
11415Tuo4yednH9jNN5HWBq3zNLxxsmxtM,FALSE,0,6590254,6590254,5
114yNVAkxHxngbP5djRUcUB99NhYGQpBMR,FALSE,0,7344278,7344278,1
115LHgZQcChVoWpK4i1L4ZF6gX4pvVbAFF,FALSE,82381643,82413492,31849,31
1142YwsGz94rNccySvu3WsCUbz4AVwhUzN,FALSE,0,55000,55000,1
115ejM4mEBma7Qiw2KD5G1quCSFAZEWXDL,FALSE,0,14419,14419,1
114uxCEn6ZP2TiGjJUU6ppSJGZhg8JjqMi,FALSE,0,63503,63503,1
115eErPQVHnWxVYDXXsBFb7TmAnY5SwpYa,FALSE,0,621,621,1
114rubo2N5iSHVSwmMqs2uhCoC42MtV2Wf,FALSE,141184,141184,0,2
115LS4sNCE1tnuAWyPtLkiXAHwAyn36yt1,FALSE,1092,1638,546,5
11676zBTvZiVnDxzWRQSCG19Bw8EetK8Ji,FALSE,0,181600,181600,1
114XWGN1BAMfEVHDdEo8zNxjSP2UmxpNCb,FALSE,0,2000000,2000000,1
11553yzA9tAuX7TCg2bGovP22Sv5rtoL4J,FALSE,0,31959,31959,1
115EuS6FNQ2nAuTE7FWEBMHjQ4CsuwfhPd,FALSE,0,1704,1704,1
114cNbca2y2c1yQrUcLzEqCPg4S45Yib8L,FALSE,124758,124758,0,2
115W6ipGJWHYW1Uzc8fPSdz3cCrzk9eGU6,FALSE,420000,424914,4914,27
114VUcqQmbQHzRB7nzZMHLAA5aE2rMo75E,FALSE,1092,2730,1638,7
115s29kJFzV6A5W4ZfHJwzFs8bRYwoENbY,FALSE,0,71175,71175,1
114BK51JhvyAPMA8rqNRNreq9UW6nxi5AH,FALSE,0,11234,11234,1
115GYT7P4QNXLxkVk1gqqfuhirDtUxmAS6,FALSE,0,310000,310000,1
115DmXwYSbP5DApayHp2LzxKmizXJbcUiS,FALSE,0,5570,5570,1
114hTHwRfgWcRQrKc2amfHSs1m4eLCjiX9,FALSE,0,10000,10000,1
115aEL5dU4iJ7UkCWpbXoWiUnJEpft3pWL,FALSE,0,48252,48252,1
115iYt69ukWsZG4dJRiQbSssAra697ZCo7,FALSE,0,8800,8800,1
114MHQ8jpNR3pqmYRsumwAsCGmcviskZge,FALSE,0,1007085,1007085,1
114MqJYtmyp5o7rh7apmRb8DbJYTztXqiR,FALSE,0,76416,76416,1
114kM3vtipZdYZ9YMrMiTKcJcFKQBcFhYq,FALSE,0,402197,402197,1
115fxXAXu3mUgzXoDkxqmnAXyQH7z5X4nU,FALSE,7267653,7267653,0,2
114BHEaCVxzLjRd5GBHgkippSwHHebNGTy,FALSE,0,24107,24107,1
115dA6Zi8xCcuqo6ehYuDjYCYYygpsB4RL,FALSE,0,1455107,1455107,1
115nNY8ecE9rLcZuX1S9WxpKMJi7aJm8vN,FALSE,3220241,8373179,5152938,21
114MN8PkjVRSSkcMkFjYvxrUHtKuKKrmis,FALSE,0,5720,5720,1
114bjQgmidFbFpHCud8gWiHUBwCswRYrE6,FALSE,0,20350,20350,2
114hrSawBW6fBJNCpn1iEe4XLBNSHBxmvF,FALSE,0,6024,6024,1
115pR7kSs8zkemNZt1dYdtN31ka2XpFhMF,FALSE,0,10000,10000,1
114EiP5tB39WK53MUwhmD2c9euXfP3vQBt,FALSE,0,29092,29092,1
1146yYHaDUfwvWN5nGe3L2ScdL4EQbSwPm,FALSE,0,17106,17106,1
11446eYatNqPUM3uJwAp3LNsyQ86nDgRNj,FALSE,0,870,870,1
114fCs8xacFzzcYx9favnSCq4sWcbzsN1,FALSE,0,1004250,1004250,1
115mDav3hHYA263ZULfFYsp61fTaGJtuZH,FALSE,0,2230315,2230315,1
115c9uDR83u26ynTqLAbKtfXrRj9wYZEe1,FALSE,0,17400,17400,1
114DnYon6b8aV5GTyRk4Xk37EXjyjUgU9v,FALSE,0,2500,2500,1
1153m8QNtZWdhM9r66dVekGNfxSww9RA4Q,FALSE,0,1203,1203,1
115FJvifeLEp2nSU4zxQGcFZeDBo9k9KPW,FALSE,2184,2730,546,9
115ZKFCVWqiNYWcTcZG371sJnJKJQG6gi5,FALSE,0,83633,83633,5
114Ejw4u55nyLRUzMdaShuAKGGfkhZcMut,FALSE,0,546,546,1
115tKz2axYanAsHUoB6thWhx27grBLgMt1,FALSE,0,2108413,2108413,1
114YzVBcopEZmmPnb9oCMTsP21KRb4Ls8b,FALSE,7431962,7431962,0,2
1158wkN3ubS6sFKjQjoftKWW8TEVCn524a,FALSE,0,1,1,1
114Wq1kBWAyBLaZmUf5KHKSr7KDwcqbpY1,FALSE,6522000,6522547,547,19
115NLsjWtV4kKeiwjfYKJ4SygRcWaKXtBT,FALSE,0,49940,49940,1
114Hn8mmAwwBtUELvSEm5e9zXhkoNQTxT,FALSE,0,69369,69369,1
115vHd8SxtaTZchx89uAxaRjqXyywHsEQu,FALSE,798000,798000,0,2
114UbAEPAYJxkDGAPJ4pZzrKu4dBETZ3Bx,FALSE,0,28912,28912,1
114b4G38Pfw2rNU6aAzAS55UB5r3sixhra,FALSE,0,27764,27764,1
115maJJrJu3UN7ESz2ufDmcUcuWtSDQyoi,FALSE,4951006,5102806,151800,11
115AvoR3xcZdak9HoosUUTh9JQhsgKqzgD,FALSE,0,408560,408560,1
114MtxLxzoTAX2TGhaauz1KymmnFHFw5yi,FALSE,546,1092,546,3
115rvzAtPVZ3FwNcwpJRSth9aM2WSBx26u,FALSE,0,74334,74334,1
115cBwGTFXfgpGJq2aYaowrzH88gkR111n,FALSE,30900,40546,9646,3
114MefH5JJM7vWKwKXaySfhBG6PZgXPnD8,FALSE,0,1378,1378,1
115cAnTnzNgppuvXc2M7PDcJv8q5QmRVtk,FALSE,1677800,1677800,0,2
114ZB12GWqn8gk73bFgiHAouzYZkt1xro8,FALSE,1569,500546,498977,3
115YEBgLTxwtQzNfx3La9TU2Nk3zYdJsRC,FALSE,0,105083819,105083819,1
115BteAjZJLTVgCtDNPkzFjhL6XqWYQXvt,FALSE,0,2660000,2660000,1
114F37TdnxA7bWi3MYd6fXi6PPS3HXbAAV,FALSE,1057613,1083873,26260,47
115DcW7QkDp2KF7HGhB1Bhf59GAP4UMm1n,FALSE,0,3115,3115,1
114YtSrU5Ws6zJqJQJ7BYtRxyhy3R9gLGW,FALSE,0,1000224,1000224,1
115tjNgtF2oNpjPnSi4wgRcJK6QC83PA4S,FALSE,10000,1000546,990546,3
115B8yBcmxmj8EqQ33Z9sLofDozE3eszgF,FALSE,0,810,810,1
1164wWHMFVGj8dZSRFkH3zaDJMKEj5JbLA,FALSE,0,556815,556815,1
114Q9gR47Bn4udVTZ8uR5BDYeKZkK88h5i,FALSE,6071,8730,2659,10
114MK3Sd4Ah1kwD2AinVvbec87ztfdMheV,FALSE,0,308951,308951,1
114Z4wNJcYXTF6No9muD9Yp77j7TYxL7q9,FALSE,0,5430,5430,1
114nXDfZi7xESC74oxxGQEHZHPtS88w1Dj,FALSE,0,11000,11000,2
114iRtZQPeNnoxij6K7w8KdC3qD77sMK8y,FALSE,0,32942,32942,1
114SJXQao1AYYePGrgh69DkUxVjWzEXFDy,FALSE,0,92706,92706,1
115NtvaqvsikwRYyXQnPb26EVwAdG6SyTJ,FALSE,0,65223,65223,2
115R5piY7p1sbVvgfMA3Zr5BApNb2S9oqJ,FALSE,0,3000,3000,1
114FZZSaxxrYLZodcrsZMPELjpFyNxPshR,FALSE,0,253629,253629,1
115etXYUqq7SPeBkvYYSSoRt78tZGjFfQN,FALSE,0,42267,42267,1
115jvD9XHUPoCedoQvwbJnYmLEhp2Gh94o,FALSE,0,17382,17382,1
1149o2SgdtQnkAkZnoHbY66hCY3j22Sx9G,FALSE,5000000,5000000,0,2
114Yi3Fek9hhsDDL9PHJJS7RSTAjFgGCBB,FALSE,0,14485000,14485000,3
115Py4ppqeRNXnqxwVM1S6VkgXaqEBeioi,FALSE,0,109600,109600,1
115T2BeS7596LV7f81HdytJBdw4tuZLJSh,FALSE,0,154259,154259,1
11539js68Z1xuvsCH8meCCYML24LXQMTN2,FALSE,2585581,2587827,2246,4
1165ScB3gDxHov6CTD1EV2y1ZdyBb7Fn6q,FALSE,71640,71640,0,4
115CyYmwUTnp9uY1cNmpoWkGpoPpuC7zr1,FALSE,0,3143,3143,1
115DUAcW3tj8GTgMwByFVqX8MWV9WEpgi7,FALSE,0,2750,2750,1
115BR1Mh91tTdxNNyEaoZ9n5Ebi3dC5gCm,FALSE,0,74802,74802,1
114qzYQE6jBYhSdJjdafxTzgx6nhWW9Wy2,FALSE,0,548,548,1
114RRWvQaqvN48bsx5bchAxHwKobEjSMKg,FALSE,0,5480,5480,1
115Yv7KpCY8kAHtfshxquieZK4WLKPgvWK,FALSE,162648,162648,0,2
115roXtvSzBnQSEg3kKoKrcsU85f26VsLM,FALSE,772893,796007,23114,3
114Sbxupa8wAiChhJpMaCQ3Ym4gQSTFbyJ,FALSE,1451684,1873371,421687,15
114k4wWXsAM9eHtrQ6rUb53KU576XbrtiE,FALSE,1005,1005,0,2
114C9mhc9ismJkVcAuxj9thsPQ5XzGEnx6,FALSE,0,1135,1135,1
114p112FuKZ64dbscP9S8dLMPZok5FdE7U,FALSE,0,5760,5760,1
115tbW7BKQ98GzVJZUnZz6jsgcWJaGLBjq,FALSE,0,659864,659864,1
114E4oum34RjnBoRZ4e8BXCWtNjE1maH8R,FALSE,0,46711,46711,1
114RLjen2D1vDB49VhLVPVN37Tg9oRvrAt,FALSE,0,22631551,22631551,3
1158wA7srBuv91K7A3TaV3R1U73gMzU2iL,FALSE,0,6770,6770,1
1143nWWGRwM9S2Yo1kHgQS5avkzPKiSr5d,FALSE,112053118,112186194,133076,4
115Kho6CwZr9cFMuXjDLhja1h8Gi16zyJj,FALSE,0,43291,43291,1
114QhR21cMKSsNSBxzCWr7VDE7rLCVCcQS,FALSE,0,4024122,4024122,1
115zcWxFwKDVPp5Luwupk2akHzGQP2BVLw,FALSE,0,7573398,7573398,1
115DqFPKonim3jCPQhb49dkze32RdP5fLt,FALSE,0,3098,3098,1
115iGe2VNBe5b62gKSE5LmStrGTR98RDZz,FALSE,0,60000,60000,1
115DuqPimD9AtJQRymnLsrXbAPZj4iYfNZ,FALSE,6000,6546,546,3
114mkYm4qpeqEAZEGBRvnVkcjfiBjV6JBL,FALSE,546,1092,546,3
1146DbBc1PS7WECqEiFaG4BskXtaTaNsnY,FALSE,1575,500546,498971,3
114G5WPyn7NuAPdfVEmqj5BHQpinLAaMsx,FALSE,0,17533,17533,1
115VWVrdDddtAijXJYTrxJ1HuzxW4Rj77k,FALSE,1427592,1427592,0,2
115dDswwHmUvChJVg2KUDbXkrwgJ79LeFY,FALSE,38184,45276,7092,20
115Sf62V1tHtzNxL2qa6yB8CGxuX7JXjvT,FALSE,545544,545544,0,2
115nEDeemC2dxfNhg5X2EGnix7vEUT8Jrs,FALSE,0,11448,11448,1
114EYAgay2PdNcqLiz9FrJotujhJq8yoD9,FALSE,0,404,404,2
115E5HfgrTo2rYCjFrJjDE1GttYVZ9kvar,FALSE,0,245150,245150,1
114VNSnh2yRPpK9XhP7ugyutSpnS963wkN,FALSE,298920000,300010000,1090000,3
115RwXkX22U8f46zcnaUCvd26h3Pg6AyUZ,FALSE,0,3833398,3833398,1
114wehybdspM6CztRbi3G3khgEYHBfrTjn,FALSE,0,665099,665099,1
115xaneBsYrJxQE5vnaMqRXVkJvwumjaUr,FALSE,0,15455,15455,1
114JqnqW81Y8YZJ6pbca7fBVEbmz2TZFoy,FALSE,0,11876248,11876248,1
114gKqZ5DPJNEkMASPwYM7xG8kWxMYA3fq,FALSE,0,28178,28178,4
114AKLUJLmahtsQ1WKXFLsHgRyPZLabVxL,FALSE,0,3050,3050,1
115uSV7e26LV5jRGeQjGbMhu7i9RLPEBeR,FALSE,150076,150076,0,2
1151qvvTdg2SyyEEcVyW6XuihpksfExQRA,FALSE,0,4150,4150,1
1164FEdmzxfAeSFo4ZjXRLCxgaFEYyB45h,FALSE,0,3450,3450,1
114YLtfiXJxfPEZP7FuDXoevPNY2rTpMbZ,FALSE,75119652,75891889,772237,300
1156qyKQ6W1N7RtVZpWoNN9XsU9djTqZui,FALSE,1678000,2721464,1043464,3
115B4maeAHebwJ31e1ziZFBQf5NBng3fTL,FALSE,0,10043,10043,1
115iSZTEmKFyjUzvBc9nay9Y4FDNjKdA3r,FALSE,0,2870,2870,1
115wqBZaCD8XLxaGTWF7R4UVqT6emUKZrp,FALSE,0,6266265,6266265,1
115co1ypqbe9VBkGYGQ3DvEoBdhoAs8AVi,FALSE,0,129114,129114,1
1142PNv9vHD9pCbs7fExDWC5UmvkGVNU9n,FALSE,0,66075,66075,1
1143atNTboZC38puJaBuWwZLmutZWrrgTC,FALSE,23231,23231,0,2
115UaGBaaqTk3KwLMX8RishxMCd5ffwquQ,FALSE,620000,822558,202558,15
11631JHo1TUnLzgwzHYscJe3Kt5jxPzgKr,FALSE,0,5500,5500,1
114gGtEMjYoG9vP5xHYCqFAKiQfhhKpVpM,FALSE,0,5059122,5059122,1
114NJGbvrCYnP53cM5J3c2DqeMeSg4sRBY,FALSE,0,312310,312310,1
1155xPqPx66BvjimK2w7AUuik1LfGEZG4q,FALSE,0,7458,7458,1
114gnze9G8ZEMbERsrgSWqLgjv5mTsZTFB,FALSE,105033,110540,5507,3
1143phSvqMuc2YeAejspLvqef514vVt9ux,FALSE,15504200,15504200,0,14
114TBb1M6Fi43jWeFxhSUGh6SxezTLaurh,FALSE,41547090,41547091,1,3
1155a93wJaSpSj5rQTdgpgbR3kk4ZUkdti,FALSE,0,353456,353456,1
115Jakm3Tv8uLD1i6EPwhxUFzTg8buvmJ9,FALSE,0,1000,1000,1
115PxmbS4jpDXcdoqgajsd1DAHdEGTLqqi,FALSE,6031000,6043500,12500,8
115UzSAQQkCWshL3jpcEQufdRNBfFrePEN,FALSE,100546,103276,2730,3
114a3f5jvYsL47kL4RCJoCVfJoWjYMG7r,FALSE,0,225459,225459,1
114iC7yU7fKAXxLxE3TbFB6Y2QCXEwa3mD,FALSE,3022812,6022812,3000000,3
115AGD1nNmzaZRX3ESgwkLthsjuHZgugX,FALSE,0,100000,100000,1
115zcaWk8JoS89ZUSvzBzNMQv7wJvT4cHB,FALSE,0,2500,2500,1
115HLAg9aA6eqvSrNVgJ4KAeqFsyj5CXmX,FALSE,0,1907400,1907400,1
11431fVoaS7xkie8cEEdymhrh2MS8BY3df,FALSE,0,573885,573885,1
114dgQg3ofTYa9FaP4QeLkQ5z9dAgGPFAT,FALSE,0,1002515,1002515,1
115N9eNR4PLkYS6gLRVR39gEkTWUcZFXWP,FALSE,0,633345,633345,3
11581Ye6vjkgdNamw85E2xDq4mtH47mJ63,FALSE,0,5370,5370,4
114kS4oCWDypSahXViqbyJysj2ETjtp118,FALSE,39096,50546,11450,3
114jLHq2rNX2eYt3eFrgjkAhtw4zyBc5oD,FALSE,0,775,775,1
114pSC7kx14pcUpMvMqF71CnBFBAicw4Fn,FALSE,0,10000,10000,1
114GoEBFRpdfkit1MZ4o6PSvP1khaQSkjH,FALSE,0,998477,998477,1
114YKbxYKX57w75HG3hzkDbLabmVuHnhVX,FALSE,95000120,95000121,1,3
114EZfGdZm5wE8Yw739f3iwtLaVDJruhHJ,FALSE,0,110501,110501,1
1149Dt82m5oqvUzRMUgDELJwXLXeRhH8x5,FALSE,0,30984,30984,1
114xyMKHg1qNwoPqswCsuuWN1upq8CwVLn,FALSE,61812,61812,0,2
115JPzSJX4kamubpYvwdvw15GL3uRicgF7,FALSE,0,574200,574200,1
114NdApBb79tyxDQSVEKq1vySn8tnFJhUF,FALSE,0,39595,39595,1
114exU1mTJVLLLRaHkgVQ1GHoHk931nqyn,FALSE,0,3209793,3209793,1
115aTvaA3mnnt6FFkiPBi1XP6qarA9SWx9,FALSE,0,146207,146207,1
114YXjTTr3BmPUzuiHrWCNfJns1xFL5Zco,FALSE,0,2547086,2547086,1
114brQHZjC8LYudYU91n6bHVPQmGrZExeb,FALSE,24063,62463,38400,3
115fhksdeA6ZwjbVmxjSB18XmcQWFmpaom,FALSE,0,8292,8292,1
114ASUCmQZPUDqbhDikXbrQXQcsJLidiXV,FALSE,0,2229893,2229893,1
115EdNhzvtou5tX1VfxwEpXRjiPMevLjp,FALSE,0,548,548,1
115pMjvdpLNaNvPfbxhP4qTGygtCxzmeYb,FALSE,0,6696,6696,1
1155ERTUQSuvCXznRZ5VNXCeBL72aJN3KU,FALSE,107469039,107703728,234689,29
114ZNwE6hiwiWMXfnZcMxyzoP3SJKNxLgX,FALSE,0,35000000,35000000,1
114oHysUzfQm7ug2QT2LxXDHptyZeQMTZA,FALSE,0,1550,1550,1
115MRf5dERhc8sUMdL1BnagFDjmMqbSQbK,FALSE,0,3346717,3346717,1
114nXj46uJZoqN5VeY22ybeCVGbBT19ec1,FALSE,0,14530,14530,1
114zb2Zit1aeBRcztdWkjwQu5P3X7H1RVa,FALSE,0,10080,10080,1
115RADFGVXLJJF2nNtXUBRGrnH1tNncRQs,FALSE,8293707,8293707,0,5
1158sDvxMsidn9VeY5oitWonJB94GdttEM,FALSE,0,5480,5480,1
115CSGfJQMzYVibb1ktpG9S1Sct7jKtnZx,FALSE,0,2500,2500,1
115b3G78LyjoxW9pSg1jHrjXjgg3eB9CPg,FALSE,0,548,548,1
115D1GszF1N54XrZriZKKbSn2BZkanribL,FALSE,0,39170,39170,1
115EULEfPmdnttaGmg5kc7aoxtsoebM87f,FALSE,808964,1691035,882071,5
1159ouYJWUyCoMesf7nFJKca88fjvpp4iH,FALSE,0,202425,202425,1
115LbS2jwpDyNd99rFgKt3b71eCCHdfVHo,FALSE,0,624,624,1
114DkaAsVSTKhr4vUYXZe5SBiE9j8WHhPV,FALSE,0,1581141,1581141,1
1145ZAbRPmQGthYdApqffHyDoRJSPSxfri,FALSE,0,1520414,1520414,1
114jgYtKfBidYzgUxmKf6qnD2VTK9vTqu3,FALSE,19490,19490,0,2
114N1MsmrJkrDBusDGpd6LbYzCrABaQVB1,FALSE,523576,553576,30000,3
1168aWhnedHjK8xSqYhkjxkzgkvCMw47tf,FALSE,0,48852,48852,1
114QDHe7MtEUpCy91hzPTAVEJnmdrDmDsU,FALSE,0,11755,11755,1
1141Z6SgZ7CDLPQXeGy9iZeJ154hqxhRoH,FALSE,0,40314,40314,1
115F1g3Wj3bh86ZKF5bJ7xmtZyVhbr32vz,FALSE,0,74600,74600,1
114ZPrUhmUc2PYwNkH2Szs7qTPNRQ6dJ3E,FALSE,0,100000,100000,1
114txtjkA3TXxTvaGJ23uCxHU4XdJCVkC2,FALSE,247991,247991,0,2
1147ztBawEc4HzXtsH5bgrmS2fBBKYTUD3,FALSE,0,45076,45076,1
114VXRKKhfovpCMwZTFYhpE2ro7tZckg8Z,FALSE,111842,125714,13872,4
114E8gB6Hu1SWvELwB3Mm8gGr6SKX4QNgY,FALSE,30150,84466,54316,3
114yjJCHTMSLmnSyxJt5BbfY7pP1hAHejN,FALSE,0,682314,682314,1
114c6j814QGhk2T6AuWUVzeUZNHwMv558g,FALSE,0,548,548,1
115zaYbGSPnpXRpZh8B2GhyBpgSk7ptarX,FALSE,0,1946,1946,1
1161UW3WteV2aCw8FQWz6iYXmpgjfjo7z1,FALSE,0,880,880,1
1141mwenKCbPJpau3hnNrFrm7UP81AYR4n,FALSE,0,1043,1043,1
115JrtmY7JGsuDtBjoL1Pm8T6ketLCVZtX,FALSE,13960818,14958202,997384,80
1142mbQzbiPrdxJ7yEWjMGykKJUPL6bS1q,FALSE,0,3300,3300,1
1161nMSuDdW9CFEewpjVRiMUMKkamk48tQ,FALSE,0,5678,5678,1
115bpSxDJPAw5kUCSXGTsrMwzZVEwVCYZ2,FALSE,26425,26425,0,2
114WfnTXykXiH1Kz8eGvPed9Q341gAAA6x,FALSE,122920,322920,200000,3
1153SmJFKkiqmCnTpNsWgyqGjtzmpULPHB,FALSE,0,57263,57263,1
115MN1cTneogYLTJfAeNGXb8p7rGHZBwfL,FALSE,2500000,5700000,3200000,2
114qZ9rpyDkwZmzxZbKxKM2PMGbeeq3TM5,FALSE,0,546,546,1
115CD9npHKE976yYXH1t3cqWmpv5eyhddz,FALSE,1000823,1000823,0,2
11421raXKYNQXTHMjGYp6b5JRnCaWvuMb9,FALSE,0,704560,704560,1
114UUVLA6jbpMPAYVTFiZENXffBWcH8W9J,FALSE,0,577,577,1
114zQi5NGchsRLddtqzDLsb3Fs6wKppTnh,FALSE,6688,6688,0,4
114YeQ7bV9M8kihyueu63XUW99BQNaeTrF,FALSE,0,1000882,1000882,1
115GTPmg1ZJbfKv7PbV8MmNUk3Wf2bUuif,FALSE,27247632,28132907,885275,36
1159WtYNQU1uqR4N1sgVKrR5NJZBMcThCh,FALSE,0,5480,5480,1
114qgrP5BxGXMEVtN7Jcv17BUv2fkV447B,FALSE,0,93930,93930,3
114ACYHHMvKNHhjVvNJFyqGNsXuEt6tvvk,FALSE,0,9680,9680,1
114G6wfdroEKKNQYNEg9CLYZAZ6JtoVJpF,FALSE,0,4580,4580,1
115nwDJ9wPcd1L1QBBhpqMwZ6DfT5ay8gT,FALSE,0,371514,371514,1
114X1BCRf2xM9jySwn9AkwHHbitriDDq3a,FALSE,5990988,6963652,972664,34
114oQP7B9sD6WZejwCFj2eCEywqDBUXuj8,FALSE,0,700000,700000,1
115xaW2JycywwPPi4cSXG6Ao2sk9TvHthx,FALSE,546,1092,546,2
115E7sFyDghFzwtmySzMH4ayJLSdecw51z,FALSE,43810000,54730000,10920000,26
115sonAKcEeaikFEswebu6L34Tc35Mt5TV,FALSE,0,1,1,1
115yz5XVSW9FX7ir1httSLif5wiqupsnDp,FALSE,1377000,1428163,51163,16
1143wYX2V36L25gEFigsu6t4AgZdC62dvE,FALSE,0,12649,12649,1
1154rxceacjsdouMMrwdF6amuCpmnkAh43,FALSE,0,706221,706221,21
115FMWRUBY1ugUMXSoJccjPwfTzdY5w8Jq,FALSE,37094173,37099686,5513,3
1155eRi2dzzhMyHsPZhgmoENmcrWW6bUhR,FALSE,0,417997,417997,1
114uD7gR2LBjmWfXQ1qWjppRxadBweAdWR,FALSE,150000,262448,112448,3
115jDaCxwoLVyrzq2Zuf8gDtVHFyo3BPdk,FALSE,1360000,1360000,0,4
115xa845rh1Z3gZBdbqwpxPe8gHbQ1xibb,FALSE,0,1000,1000,119KUcMVmxheEzUfFQ7LUdRos8K8Lmci95E,False,1966000000,1966000000,0,2
18BNfuFLhrEufu43sqFKsUw8eGtfBsc54H,False,1965000000,1965000000,0,2
16qk1V3pU4oNA9ACg2X9yMwQThYXgzL4Rw,False,10491000000,10491000000,0,2
1797aVYAiciSD8cpad4CW2io3zCFZJ3AWm,False,10486000000,10486000000,0,2
1355t5WR9VbP1WHD6y2Jzr1CJ6uRuoE9pg,False,10481000000,10481000000,0,2
196Sn8MoT3AhbHJhK2JKQmo25YW9Pxtifb,False,10476000000,10476000000,0,2
1K5ynuQyEvmP63Sn8rQHgPnhYN2dfWj735,False,79000000,79000000,0,2
15fv2vptyote7jLzQR4zDXFREhXg7piXgX,False,33215000000,33215000000,0,2
1NYHX2NJ99xmBWNRRu9rb7kLTZRuywQAM1,False,10471000000,10471000000,0,2
18tVXtdrHt5h9ew9u5gurYcKkSNmgaHWm5,False,33210000000,33210000000,0,2
1C5GUznarzSkoxr3NWKGtU2TUuHUNWx7Xs,False,10466000000,10466000000,0,2
1PzY95Rex5xsWicQ73XyZAVLDgHV7fUPLL,False,5000000000,5000000000,0,2
1L4FogJCgE9bAxZeCfDmeMrH9UABodF8jb,False,33205000000,33205000000,0,2
1KSFBLFUP8rVeuiehibwBEMaPqeLN5YKfp,False,10461000000,10461000000,0,2
1GY2p3U5XspRTvAMRMq9WTZ5NMhtV5BHwB,False,33200000000,33200000000,0,2
1J4zHghaDB9izmw9VjG4R5UNuydRkpLZH3,False,10456000000,10456000000,0,2
1KH8X261nRxthDo591fZR6kzaHoC6vzUDj,False,10451000000,10451000000,0,2
1siEu5VE9ruSaT5MXa1q3S2JU91T356Rw,False,2015000000,2015000000,0,4
1AF47B72ezwcJrqk6jGuDYAC477ymGnfDS,False,2775000000,2775000000,0,9
182RLMwG9dK88UrhohvEun5RzyFHsBCgsT,False,0,4133000547,4133000547,2
1MfKUySrrMNWhbtSJ4Fun3RYduqGTCMZwH,False,33195000000,33195000000,0,2
1HAXsM16bQCFtUCMY5ggpY3T2eTWrwBbdz,False,2249241703,2670680003,421438300,35
1aYg59MxQ1LLMuV7QB4fyoyasdxZiY14u,False,1049000000,1049000000,0,2
1QAGiWNdGdudGLFL4A2ESx2ebSCU6B9oSV,False,10446000000,10446000000,0,2
1FsivdW1h6a91oQJGWFQT1g5sackwP327W,False,10441000000,10441000000,0,2
15KsTJ9VMwnrFLgfbQP7AvrjZKZFZusHaG,False,3719000000,3719000000,0,2
1BxjmNVWS11pfH9ygVkDmJqDe44prDBYpV,False,33190000000,33190000000,0,2
13Mxcn9MqCtboMmxt3nxw526mYWU73PvCE,False,10436000000,10436000000,0,2
14X4DaykQPxqEWLqyB8RseDYSj9Qy2fujM,False,370000000,370000000,0,20
19WNsDrMrv82Ezbycs3tzEzUeAt61hmWDZ,False,10431000000,10431000000,0,2
1QtbZWKcTBTdr2AEJ7XZQ9FeyFEsQAicG,False,10426000000,10426000000,0,2
16GA9X3TRrg5gtCLaaqQRSwZSArxCAqYHz,False,4874000000,4874000000,0,2
1LQo75MpdbUiW6rwSjjZ4fKTrjsb37mJe9,False,4729000000,4729000000,0,2
1HNmd5JNmjB8MgDKiGz7WBQJxTFZueJzmA,False,4561000000,4561000000,0,2
1EcttSajTMVb15TUmPXUqoRarv9hfcyknq,False,4392000000,4392000000,0,2
1GQk1RQPSqCjS1pZDdg43YF4BejJmVXrp3,False,4175000000,4175000000,0,2
1752n7qrctrYtgbNtckghCoXK2HWiKC53U,False,3740000000,3740000000,0,2
1NQkzExhgXjwL7pJuiQn2HrKkySdSznme5,False,139862363213,139862363213,0,91
1D4xzQVzwzf1hJ1ChaQdfddhtpq1qJEbrJ,False,1191000000,1191000000,0,2
1WbNZ3YcU17HyXchApjFH2fJoaAdUY5BM,False,10421000000,10421000000,0,2
1R4WWabSauR5cCnrRAQrmZdHpqQRrqknq,False,276000000,276000000,0,2
1CBu4i2eN9Dp9jXNwJbvrgt9p32wJvSrS9,False,95000000,95000000,0,2
12bbxwxQSmn3kH8MgnhxpkfgDZ4dU2rjks,False,1090000000,1090000000,0,2
1NGtjVek1YfGDCa2ZDUd8YxiPSkGeBb1NV,False,10416000000,10416000000,0,2
1G5Wttah5JKyBbYnCgBjPm4QDwxHEvuP2U,False,990000000,990000000,0,2
16wVTpUuDp2ov1QLD3z17p1gtL3nWYuMoP,False,157000000,157000000,0,2
1PyCtf2AMaXaoCkuNP2T6Wv8mK1L9dmLd5,False,919000000,919000000,0,2
19B6RDRD8fiYyf9TwxFEMFuxykBsPYmvxx,False,42000000,42000000,0,2
1HM7XUuFcApr7k5r9tdkuLLqDWX8JnCghi,False,879000000,879000000,0,2
153sJ7TAEMPEzHFBXQUFLocE4KKYQpxJAx,False,841000000,841000000,0,2
13PdcgE7FcRgWDfMeU4cA7FVj2iicxz6XS,False,810000000,810000000,0,2
1FcWmyQp1RcqF1YRcDf8dWAwudExDpjapq,False,50000000,50000000,0,2
13abwD8NGW5tSFaR4c9gL4TUFsaTEngJJ6,False,190000000,190000000,0,8
13NTTLSC5hoM5EE19316Q4wB4uNhtaYR23,False,33185000000,33185000000,0,2
1KGYwdCmzhwsiscDeDsMWwbk6yQF5gDrxQ,False,10411000000,10411000000,0,2
12jYXDcTr2S6Jpo76tW1P5RxsAd3zDiSbh,False,779000000,779000000,0,2
18HampkXmpE5R49aURzCDdikSPgp1YvPVF,False,766000000,766000000,0,2
1J3vSTioMUPEwzzCMv6BX369eXXcxgMH7F,False,754000000,754000000,0,2
1JfbYnfyeUmCGw53LiNAwJ1wCyzRiibW9i,False,742000000,742000000,0,2
1Fk9fPHi6JeM89GvJKjEr2g9A2ZEBxNhrM,False,734000000,734000000,0,2
1LP9SHxb2ish4bbfn8EADRbSHNowAsbzHb,False,728000000,728000000,0,2
19C8vVENBgZnEB1B7bXzt6ZawKJ6ZxDV8Q,False,722000000,722000000,0,2
165jGLZUM8swRGSHgzzDDKXU4QExFg9gyz,False,10406000000,10406000000,0,2
1F9FPM7eumTmaQnPsScnrPiRsc9AQ9Z31y,False,33180000000,33180000000,0,2
14t5SuqeACFfNRp7CqWzaLwiUHkAXzYjSo,False,10401000000,10401000000,0,2
1PeGWLhVVqjzKLgGFQkip2APDHqpXcbS9k,False,10396000000,10396000000,0,2
1AKepua4cQihdzFQJonFkyErsCJ9tq9fkE,False,10391000000,10391000000,0,2
16UTrkNNcLZGt8xnTTkGxZXGECZgNg76nn,False,33175000000,33175000000,0,2
1FUvG43R9QzzuRvYXRUEC4amPrEusEeEno,False,10386000000,10386000000,0,2
16ySKo1baN3DiwiZF2dre2fKMh2ZYz3Wz9,False,10381000000,10381000000,0,2
1Lr53dgUbHjTJHGwXQemzmEDMvjCdsGhKg,False,10376000000,10376000000,0,2
178Pi4QFmxdrMjvij4CQE9nHPMvZrUtzSD,False,193584000000,193584000000,0,8
14F4e8oRkFnYbhKRYnrjRk5E37T1fBvweS,False,92000000,92000000,0,2
1Fj6ULsWo8M2CnJfHRKedS3eJgg3v1HxrB,False,33170000000,33170000000,0,2
1Cj72J4cvEBQAShCqdL242AbvixWotUU1x,False,501000000,501000000,0,2
12fEVjSwiBpLzGkgNyPNwjnHiqD3J2v96H,False,10000000000,10000000000,0,2
1kKfhvNWbCX4D1FGvMLSzTXe7Yfmu6nNq,False,33165000000,33165000000,0,2
1BmxQU66HCeWxEEp4bzUu7ipF8RmjTSTcD,False,10371000000,10371000000,0,2
1NWUn1sFKPTk6uKQMjtj4bz4L63TEoT6bR,False,50000000000,50000000000,0,2
1DsfAJrBTgLG4582u5XykJcNNWv88K2gTt,False,33160000000,33160000000,0,2
1DhNgJgeHf6zfcmjeUxkU9L9pSNoC158Jn,False,10366000000,10366000000,0,2
1PyXHfoYWqtGUrv22KpjzepgbDpYQAuTdR,False,10361000000,10361000000,0,2
1EQbrzL63cv4LkngqMEvK9jThRK7Dm3QqW,False,10356000000,10356000000,0,2
133Gb8gWfBDZWcT6XfaJ7JRDDNuGLqD5Dc,False,10351000000,10351000000,0,2
1FZNUZnjzRbE9UCAtzvfM6JeoRT4ia7wtZ,False,33155000000,33155000000,0,2
1Cuq2n1cFAL6fQnQFAP5kqRtpKSF9j15kL,False,10346000000,10346000000,0,2
1FMiaHqr6yTE1tUZJ8bTMURFdSk4BG8nut,False,33150000000,33150000000,0,2
19UtZ5NwzZmjbKqaspayVVZhxgmiLErh5b,False,10341000000,10341000000,0,2
1DiWzbGnbosZ2cEyUFidS6jSCW6bmfmCPs,False,150000000,150000000,0,4
1HweFGoHxDNZ4sqM4tL3V2ArATuSmsxqAh,False,33145000000,33145000000,0,2
12tpwQiSxcsmmBBWBNdukkrzK1teDg4YPt,False,646000000,646000000,0,2
1FbKzCZrL9wTLAy3urg5pUB15wLiiE4Uzh,False,10336000000,10336000000,0,2
127pXDtaHkCK8MTYam5iiYeW35xopfSNep,False,10331000000,10331000000,0,2
1CTNY8MDPDtYQjm5X5wJ7dpESkQHBx4ukL,False,10326000000,10326000000,0,2
1BsRzg8hTfKXbywbXuaGbzHSsYtcwwXVtZ,False,1015000000000,1015000000000,0,8
14geRxy9nWw2Vf3JXboyfgAiLTacWtHM6D,False,1000000000000,1000000000000,0,6
1LV3LEKpJ8HhyzFsVUbCc1qmNv16K7xPAE,False,33140000000,33140000000,0,2
1KewyNAuJqeDiUDzrkNzKjmr5vrxfuWMa1,False,140059051000,140059051000,0,25
1mX1udsKPk7cLT6uKkyt46GRXSY6UJfny,False,33135000000,33135000000,0,2
1BiYN5mevdvUpZaTUXe14LFAd9Bp72XqkC,False,33130000000,33130000000,0,2
1GCDxaD1Ny1Due41zPrjdW8dPTrbJvVSB6,False,33125000000,33125000000,0,2
15S2pCibxaBwvMXYWEjRmXbt6bNRJ6fFfE,False,33120000000,33120000000,0,2
1LVRHunHxLbqU2rttqJR1JTVCQgNCdME79,False,4809000000,4809000000,0,2
18J8R3LRpgDWA6KfVYAfMwBiiZyRjRKY4a,False,4677000000,4677000000,0,2
1DFMMedJgJTkrnXyS2uNpL5J2CZLaF8TpC,False,12742989052,12742989052,0,130
1LmaRxFcqW5Bd9J5gnt8ccquRqhSi9oorr,False,4513000000,4513000000,0,2
1B42RcReWP2KWieKq8xd5z9BEwKXNdnoRt,False,4250000000,4250000000,0,2
1CndByQhDBAvmfMbFXx4DjcpZZv7Noh4sy,False,3878000000,3878000000,0,2
1FrEse8c9KE3JXqUbCVSs6sWXMzphk1YJu,False,3598000000,3598000000,0,2
1ZZDWjPEeU2dpNHroQujoHCvYvnX93ezv,False,2646000000,2646000000,0,2
1FHAyzTh3AAU9u7zHwz6cMcpDGDVVEhVts,False,33115000000,33115000000,0,2
1BQSEG6VLBzFLerRTKyG8SdgJCeQDjn8YU,False,40000000,40000000,0,2
1QAE34SgXj7G2dMgdN3c4xz5xEFgZax55P,False,18835000000,18835000000,0,5
1LYh9DcZy9Hghjay44SmvBJ9tYapzP1ZNe,False,33110000000,33110000000,0,2
18DPR9VLzSKjZJnm27p3jYS2gpCUYPyMek,False,2485000000,2485000000,0,2
1BvuQke3wP8knAcUDtLkqKRPY9xwcQ72et,False,33105000000,33105000000,0,2
12TZDWpEwqQM1uW9FGGqxv6YXcpwNE4j9v,False,2336000000,2336000000,0,2
1GLnT9qxe8RDSAvwefTmYKKrjFbAGDNbcn,False,2191000000,2191000000,0,2
1JtGGnKivTT7kEDrRjrZmh7oYvcfrtHMox,False,2047000000,2047000000,0,2
1FTgbdixfhtSx8YUSiowmbJhe8A6ATtLW,False,33100000000,33100000000,0,2
1NGuap8rhXu6QGYfVsMTVX9H7jrxPSqKu7,False,1908000000,1908000000,0,2
1GCvvp8XjQqRfunxqtmfjTrFXAxDadPisn,False,1775000000,1775000000,0,2
1AiF246uo6eRVfoEBk3DxWZzZEpKDh5Ru,False,1649000000,1649000000,0,2
13DyQWyrW7o8Kp3B3jXKcMqC3PYEVwGEMf,False,1529000000,1529000000,0,2
14wkVWmHt4jVuHde2vcrdHEY1t8rfKFyvE,False,1422000000,1422000000,0,2
17691xd5ww4mrwFggWbBRJ8V7YSaVF6Fun,False,1316000000,1316000000,0,2
1HCKWjYSyGXx3bva5miJQuvntMTuHDAaEF,False,128000000,128000000,0,5
1Pws3EjKNcwSY2S7cE8wFsXWouZFynAxrR,False,1214000000,1214000000,0,2
1PNSQNSL3N3atkc7j1j3RXnrHLJGYaEgng,False,1119000000,1119000000,0,2
14emYRuDRVqSgWRNySveqda3BRYZKKAgN6,False,1026000000,1026000000,0,2
1AUdWsbP8LkMqPZryxHewfPeyyDfRPhXQm,False,976000000,976000000,0,2
1KJvbrUMgUKKQ5dW9hAmew8TTkCSuMAuaZ,False,929000000,929000000,0,2
1ES9qFsWna1hsemwDNepNYq4uE7qMyNC1s,False,896000000,896000000,0,2
1NMNuEVSi9cepMZeqrzBihPtcaMdT7KC4H,False,867000000,867000000,0,2
12mgpy2JECYKVbDBUs6G1cEwxENuM9tgiU,False,839000000,839000000,0,2
1KZxejHTFUy5ppXFNpSHhVXAnZf1oF7MyM,False,819000000,819000000,0,2
15jWiNHR1krpanuC6JFrY2sqgcj7khb7AX,False,804000000,804000000,0,2
1ByvCkqgHUGued8u1yC6xdEqTjKAicitEP,False,790000000,790000000,0,2
1CbXQKg8mA87mbQJhACg72cq5h5L6JgrCb,False,781000000,781000000,0,2
1LgaiR2ECPP1QtuMpfi4Jp1mAjp12Qj1PX,False,778000000,778000000,0,2
1EKJFHeow3futiWptiNm8abJrJST5XFT7C,False,776000000,776000000,0,2
17ynBb4FaWeN5CVKKzFJTNJwwNooG6gpA6,False,775000000,775000000,0,2
1En9dCd2kRagNvt14AzdEydwbaKmtDD3ee,False,774000000,774000000,0,2
16Nsw6hqFcnpAZYTCMuHFnmiu5tjhkCw5e,False,773000000,773000000,0,2
1MMHvf8Jtjn2frK53NtbKQyMaTiiU8Xnvu,False,4587000000,4587000000,0,2
18Q3SvRiMNMfPBoN7TpAuRkPZUrpne9LQP,False,4641000000,4641000000,0,2
1KYnatR3YSPoRt9xnbvE7dTSzNrcxfVVwd,False,4614000000,4614000000,0,2
15VjRaDX9zpbA8LVnbrCAFzrVzN7ixHNsC,False,1971760025343,1971760552128,526785,9540
17zZct7mpGZckMkoLUXzYAczxJxQq3TGne,False,342000000,342000000,0,2
1M7UJ3v4mPfy7teZPaw9yqhKeV6mD1GsMc,False,4214000000,4214000000,0,2
1LAAUPsHuH4wrWvyupDucQQpRY4NS3PM6G,False,4074000000,4074000000,0,2
14BfCzSywMgyBBHTusCb2j3KVj6ZsocqXj,False,3906000000,3906000000,0,2
1PuDYrYxsXkBgvfq5hpaG2w3qpegEgGxXU,False,87325878748,87325878748,0,77
1DuMMVKgDEmk7AAn9cWrVETG6CW4UH4E6x,False,3104000000,3104000000,0,2
1F8QMc14HbzAasvdv23n9ixAWcgDjF2bc8,False,2547000000,2547000000,0,2
1K5jC8fW2GSDdiUeyJr7BgK3KzFyoqGSuJ,False,45644000000,45644000000,0,23
1Fed2SJNgre5qVySgHNLAYYD7MpaX2ii7R,False,2261000000,2261000000,0,2
1NbtouLaAeFbBdxGuMfNePvcvhAg7cyYdG,False,143000000,143000000,0,2
13kNnDinDAsjxh9GzBRraWb9pFAqC3zUtt,False,2354000000,2354000000,0,2
1DJ6VsU3KogFJVHa4RDeNzVLiu2rLZdWuN,False,1937000000,1937000000,0,2
1DeAjcnn8DdATiTNhHAQj8anvZE5tWHxhX,False,2181000000,2181000000,0,2
16WksgivL4NGuXwJmwn2AeXy9TkDt4JsJi,False,1624000000,1624000000,0,2
1Lhq3NYQJRWt1yw7LR63gED4NvbKJKeKCC,False,1236000000,1236000000,0,19
12xdbNCTdn8BrzoQEMBS6hcQrcC5p1ZAdq,False,2030000000,2030000000,0,2
19XGMucuaGAfVdbZdEht67bj88qzP7fsr,False,1332000000,1332000000,0,2
1PV6Vr2dKRHj1ih1E9TyH2aGJCqS49eY1R,False,1895000000,1895000000,0,2
1HEPVsFijys8XJD28tPi5QLznyVUwY8ghN,False,1041000000,1041000000,0,2
1CT2pYSZsdjmtfpHpcsoAQhkQviaqA9w2K,False,1772000000,1772000000,0,2
12FhcrQ1F9cfcEZZCtLBSGgCqjzC1pFmM7,False,761000000,761000000,0,2
19SHXbnFeJrTdSniXnHY1XiTCeoYkFnabx,False,501000000,501000000,0,2
1FUeF6cWwSTtkQKWNUs42tUCtnK3eoPSpt,False,595000000,595000000,0,2
1DKJrc2Z1ykNvbnk3fThAqHqYaoYv6aZoT,False,33095000000,33095000000,0,2
1FagRUKZYunzqzkLXgvoUGgBTqF1tdyRPi,False,1650000000,1650000000,0,2
1Gyz65RxR9DqQT8QW7gMRgiWbanSodCSBT,False,80000000,80000000,0,2
1DjHVxFnYQDhJMLAArygZRL91Cam6kUzed,False,249000000,249000000,0,2
1776YxKRjZhn2kiuAMBJqikhjCwVeAN7Sm,False,0,20500008181,20500008181,7
1Q94PLUZAbu1NTD9QYQCtzApddt9TY1Bu9,False,590000000,590000000,0,2
1NE9GYxo97vVafsVn4wv8mtr4wEsMv3rnE,False,45000000,45000000,0,2
13ZckfnvtzHsBQnH8RdrNqC8cBM8XSLTfS,False,1535000000,1535000000,0,2
1JV1Dh1kkkbrxDcYcCGnwSgde8JmahCZuv,False,1428000000,1428000000,0,2
13wUTPnDKQZST7huqmfZdAopF6MtNgSaKy,False,1322000000,1322000000,0,2
1JYdnvLcovYgYapsQpNLHHAxpYz3PS6R8z,False,2547816988,2547816988,0,55
1JoubKWVLLgtsmd7oGorwZjHpzkdP2kqpD,False,1222000000,1222000000,0,2
17mytH65ambqMdPcv2yy1PAU88ah5YFkQ7,False,1127000000,1127000000,0,2
1Fo1y7pg6iHRx23PR5r9ymHYSxEXPNEsGY,False,1041000000,1041000000,0,2
1JJ98YbwtvbH36CYCpgVsTMVzBHV9fTipp,False,960000000,960000000,0,2
1EMdyfiwQNfwhXj1LAUg9LfSYchhNaHFpR,False,883000000,883000000,0,2
16BnYRCPza59ASfTxzr33UbkgKqhr5zyiC,False,811000000,811000000,0,2
1GEKWAT2TebCWEfXj9douAfi2gnA7UBRhp,False,0,6087001094,6087001094,38
1Mc7gHaiDdKcKvhkyRJhaVyvpnx6UrhQNd,False,746000000,746000000,0,2
1EbnkYZkNsetDAMwc9nUHYvoStUgDghrtC,False,687000000,687000000,0,2
175XFcxEV2gzkQpF1Uy4zQEYtiGmnXMjWB,False,642000000,642000000,0,2
1HSFjPKB8A4zcYkbwbDZ8oAZ1Su4RuLGnG,False,604000000,604000000,0,2
1K6iRTnaRjNaEYA7tV55usMvadCm6xMvRa,False,583000000,583000000,0,2
1BmkcQ5wTp8uNbCRb33wkQAnFY3kKVyH13,False,570000000,570000000,0,2
1Cp5uVFvmaFPjhmjDDPnRSAeWW4nG6b9yC,False,558000000,558000000,0,2
16bScdFjsPWf9MVjubexzuhmSy2NfyG5Ux,False,548000000,548000000,0,2
1BRSsW6jvrVY8SU4aDfWBJ8RR3wQsfKnEn,False,544000000,544000000,0,2
1AnUM6hj2GhCRuviuQZpem6XHtqmmuUiJ1,False,541000000,541000000,0,2
1MowVpFEAV8f7FAc1RwwEPuVJgc7hEebMR,False,539000000,539000000,0,2
16K6u4Q7tWG3xbFukZUSqoZVEm8x9LQTsC,False,249000000,249000000,0,2
16kc3Lk4HZ3umZ8T17xhxTCfrReVZHz4by,False,33090000000,33090000000,0,2
1Np8t1A9hcT8oxYPsyxFbBShgaFEX3ep8g,False,4519000000,4519000000,0,2
13vHNdtx5cdoJHKWx2ejy8dAtms4okoob6,False,4488000000,4488000000,0,2
1GNRe5ubHnWMfMoh4x9qHbCjv6h9vwiieh,False,4437000000,4437000000,0,2
1NGamS3a7camNPUhFdsHEGPgHio83Q1nYe,False,4061000000,4061000000,0,2
16oE16iroVex3F92GxpYhEWuXYupBqoGpR,False,3765000000,3765000000,0,2
1Btm8HACKhZJBAVsHcYi3UXCbWkzNapk7Q,False,3371000000,3371000000,0,2
15u8eCAdyk2zjs9WqJs574TWYSbr2f8nXA,False,2090000000,2090000000,0,2
15Wd5BvYhbhaP45Xn3oH1LLKrTRVp6Li1K,False,585000000,585000000,0,2
13Re5SWYAjxW3BU8rd1T5JiS9cESDFLZKJ,False,1985000000,1985000000,0,2
124XExDC2bDZ6omcGUJvzvBiGZC5sBpxjR,False,137000000,137000000,0,2
1JpBsaPzQ4a8xTRL2ocTm7nQeNYp9EUp6Y,False,539000000,539000000,0,19
1Fwce8NPioV2iCzzzyxK8Ltoh5jo4iaRfD,False,1884000000,1884000000,0,2
1BnF8nDF9EXVU1RKHu7LfD3idCVs8k8iqN,False,575000000,575000000,0,2
1EbKEXsBwXA6DFu9eTRwNhh8rLRqYVBbRE,False,30000000,30000000,0,2
18gkp7enQZgsMuAN8jpjjHk7a31zFu9C1Q,False,1784000000,1784000000,0,2
15X1u7rxk5pZJWyCTQ2yFpVw3ExnuH8Bpp,False,1708000000,1708000000,0,2
1HpyuzQNem33p64PpkFf3sqgkhHfMRMeyB,False,26147000000,26147000000,0,57
1PiWPrCh3mHVYkavzGwCbNHK8b9uRm6DGJ,False,345000000,345000000,0,2
17xegJ73YAAPB4GZUQsuqoi95iZzFTF2eQ,False,1155000000,1155000000,0,2
12iVk65u5r2t51mYJHGLqGcL4wPRSBk2Mr,False,1663000000,1663000000,0,2
1DWQmcAs7fw4BBsb49yBjB2ZbZsEMhHBsj,False,1625000000,1625000000,0,2
18Wh8CHm3tv81zWNPu5KhAsfxioKAiKpa1,False,1590000000,1590000000,0,2
1DWUUifEk5QwZUT2rd76fUMdNQWeACd4eV,False,1579000000,1579000000,0,2
1MTQ5httUJMMeZwoDq7yNKW4JTqqKcso1n,False,1576000000,1576000000,0,2
1DvBuYrK3PuwJVBWMCzerguPPL3BzWJyUu,False,570000000,570000000,0,2
1PLoWWLHU27p1c66r9S3wkjRCNcL8AcY8D,False,113000000,113000000,0,8
1CBREvGiNjP8BVMPL2swzqkhDTAmGG8v9o,False,2840000000,2840000000,0,2
1MPHdjTsavHktZAgghtf3Qr4MaJAhSqLN,False,33085000000,33085000000,0,2
142wmTr5jEg2SR8eiyLPmJuRXatWhYG9SY,False,565000000,565000000,0,2
1M87zruf1NkSDwhfvttv6mQPhkkDUFaJH1,False,25200000000,25200000000,0,2
19xK1KXzjSVjP2v2aaFWHBULdzSBn8rU37,False,560000000,560000000,0,2
1E1tZaJJUoYsFeDY9aP1E3LYamys3QrnQW,False,555000000,555000000,0,2
1EoR3diNCqsd6RbKkUXaC8CSf1fYdtjcn5,False,45002000000,45002000000,0,17
1BCLTCCGsFyw24a3K26XKAXx3rJDXzPRwm,False,550000000,550000000,0,2
16uxFa9sXEEL2G5nWWrPkZzeVmXQq2xd3o,False,97000000,97000000,0,2
1MfpoHmkzCAhbGfaXqYDhKYDmv8jVHAj41,False,33080000000,33080000000,0,2
1E3nQMwdUhJVLN5RJXDSTrEGm2UxunmBgv,False,38462000000,38462000000,0,2
16un9HtEqADeEY8qgKtyVD253o3zMtqLhY,False,5000000000,5000000000,0,4
1285wbeqwTagixXNP7kmPYH4jaehRnjQs5,False,167000000,167000000,0,2
17B9bWaXbZomTGG831PPN8a7hhstj8oXBu,False,5000000000,5000000000,0,5
1LoK19ru5mzZjjtsLMqM9vmfQTZHKm18kS,False,273198000000,273198000000,0,20
13jc5aszxk1c4LXewgmvzWre9SsjjKe7DV,False,810000000,810000000,0,2
15iukW4fpU6nho2MBPt1Z1CdWsbG3TnQAn,False,345000000,345000000,0,2
13ADN52giBLU3vDdDfVYCbMXQ7mMWnWpVo,False,545000000,545000000,0,2
14F9yAWwk347sapX6Ab7cczUUPs7UWoLeQ,False,55056990860,55056990860,0,256
16gK4p5uQWH9yAA2C29vo8C6Kmc8RQciXe,False,540000000,540000000,0,2
17A5fu6Mt7z2FahcFk3qk9BZi8nBTycbav,False,4864000000,4864000000,0,2
1592eCAupyqGwLaPa614ucJys6CSKGGRbn,False,4375000000,4375000000,0,2
19qzRGvP8gQ4UExhLME9ggsF8YCbaGSejp,False,4334000000,4334000000,0,2
1CUbvL381JH6XTtvcFZHK1yK1TzVkq8C8K,False,4281000000,4281000000,0,2
1HekNxvFdkKbmCPS533SDxAs2BN7qr4WUe,False,3900000000,3900000000,0,2
1DJQktLj2YQpSW7amRieTYAakDCHVF2EhU,False,3579000000,3579000000,0,2
1A3C6AeCqm3tGqC47zjKMFdKQRbBAphVGr,False,3153000000,3153000000,0,2
1Pcx1wLBW4MoZmdQDDj6zvveAGHgbKvgqm,False,882000000,882000000,0,2
198UzdG7Nz6u7ScfoxUGB8M6SeTxPS6zfu,False,525000000,525000000,0,4
1EWqjQgNntzYHeE2hJM6jDeNQwXEiiMsdj,False,750000000,750000000,0,2
1MhmrrDt3ktHjVsRp4VjUCfYbp5hscPdSR,False,623000000,623000000,0,2
1L9zQVUgfNv77m6EcwNkFGZxDrHZqUuhWt,False,515000000,515000000,0,2
174HKcDqTXDTPnk2qkwaKswEmhkXndXEXa,False,413000000,413000000,0,2
1EYjAn9F8jRvsZ3Tri1m8B5egPxX2GowMp,False,313000000,313000000,0,2
1KqNRHC4A6XJLXEAAS3KXmbxSTcQTB1thx,False,221000000,221000000,0,2
1725ZXEfchF6GXCRuQDStAF67RjR8Df4yw,False,185000000,185000000,0,2
1Gn2RYazvBh9E2xTSRWa3XmbR8dCLtyh7A,False,154000000,154000000,0,2
1Q9h6QcUjMo4AAhjTiLVvRzsj14s4HU9vj,False,133000000,133000000,0,2
1NHptDGUGSBrpKge9i6gfs1gRXDw3fT4zG,False,122000000,122000000,0,2
1Dof7fFjh73cg952Mer9Fh7bhjMBhUC5PZ,False,111000000,111000000,0,2
1PkLB9he7XtKLmDbaMN6cCoe1PGM9YjxrA,False,100000000,100000000,0,2
1KJjguo33x8ksvAKrvJCwXhydK65j7ppdU,False,90000000,90000000,0,2
1GLjpowfMRSHGaNswytF1ZyDav3cxqErDi,False,85000000,85000000,0,2
1HSs9LnnGGncTKdnw4RGgT6z3ASZwro5n8,False,81000000,81000000,0,2
12Z5vQUZpTyDNdS2ewHE1E1AqJDuKFy8Uk,False,78000000,78000000,0,2
19YdUpW2TJvgGZwusJMaEUGRi5CiP2armg,False,76000000,76000000,0,2
1NYT2MJXdubUbFCEL7iLG8Rpsm3cf3ps1K,False,75000000,75000000,0,2
1KCz1L1y36uPD5KCHQYyY31aaQxwVzCy6a,False,75000000,75000000,0,2
11MCA4eaPNEU1RnkeeMsfqqKhL3q5P1Ru,False,50000000,50000000,0,2
199ZDBDXmodbTwwAVn9x95bttBm53QiBue,False,250000000,250000000,0,8
15uvTNM63BDMTCxt9rM65iwsJ5L1gQrdUN,False,90000000,90000000,0,2
1DwdKutLMQPrFwueE7akMXYv58ZrTvzGoe,False,4519000000,4519000000,0,2
121mFGfkq5UeG6tLZ4XeBdNdc3ihpKL6jQ,False,535000000,535000000,0,2
16dqi9jgEmzaEDmjqDU7jouFhMz3a4dVYy,False,530000000,530000000,0,2
12A3hSv95sjyHdaF8eGD7yfitNE1XbSsVr,False,223800000000,223800000000,0,4
18FAnsRheeWiC6VZ226Fjk4zqKD3DiFVRs,False,1556000000,1556000000,0,2
1BtQDrPnBzMwcc6qP5E8qD1nupj6QWyvzr,False,5100000000,5100000000,0,4
1f5GZZHTYPSL6SjypghinJEEf7z2fdaFw,False,3000000000,3000000000,0,2
1LMvuu6NbAVmqASd9DpigzvG5F4CDDMctP,False,4672000000,4672000000,0,2
13MfFx5nN6Fr9trKwz4mPvPrKpRGhRXnLJ,False,4694000000,4694000000,0,2
1AZYyxEKUqHcemXxUGUTYiaUUBvr5Bbk9z,False,33075000000,33075000000,0,2
1NG8HS5TPFL965wHiE4CknTBXyM9ERe334,False,4530000000,4530000000,0,2
1Gt6iGfZTfWEXLyZpquw7msiAHSXeunicD,False,3868000000,3868000000,0,2
1NQ8fGYCoCMmxx99ARxRdnmYe8MPNXqiRt,False,3760000000,3760000000,0,2
1Lm8rSgK7AHN5XnqiwbQnNZ5NWpnpSDGFS,False,3600000000,3600000000,0,2
1Pyr7RBvfngikjiCmRDU16Yd13KNZ6Kkfk,False,3217000000,3217000000,0,2
1KCEJ4rAGWsnHf7kRDeRABru2Q8ErLUtuc,False,2735000000,2735000000,0,2
1micBvxrrUvihLKWah8brz59YdH5GxD6a,False,1924000000,1924000000,0,2
16wVmtpWK2BsVoiNHJ3mQbJdG4M8PyBZ1v,False,525000000,525000000,0,2
1DakADnaGw5kbQRvmwLeHefTxPGHNYV9zP,False,1621000000,1621000000,0,2
1NnpiCpthVRoi94Q5FJTEwYEVFdpjKNQx6,False,54000000,54000000,0,2
14YZDb3a369cdjwBQLeJbxYNUkGQ79aHJK,False,1035000000,1035000000,0,2
1NcgPjcKCXpFr2BoMJYJTJr3VvZNQUwKFT,False,4557000000,4557000000,0,2
1H3bSzeMUy31XZXdbExGUAgZLJ53HjvNk6,False,4517000000,4517000000,0,2
19GUs5nrisYQtBr9z7K9DkorZf4nCQBNhR,False,4373000000,4373000000,0,2
1CiUFs5H9CNtvscqFqfAGPLfyjbLcxPNbM,False,3687000000,3687000000,0,2
1Mu42mjAUzjovMoqCjztxPMFxScHaGj1p2,False,3579000000,3579000000,0,2
1JPx4nMDPoaEkQvH2826DxfaMqJszQUgxM,False,3386000000,3386000000,0,2
1Cckt1oendvcXq5djVk4aF5EuXvJ1Ptp5j,False,2993000000,2993000000,0,2
12ykCjXKC4awFUy1kqdeWMq1vVUAhPz3HK,False,2507000000,2507000000,0,2
1LdkXWxiUmGjT6dP6L1hNkTSns3mpbRE3T,False,1345000000,1345000000,0,2
1EMSS41fpoRy5S37e2xqcApAwGykGy87C6,False,1218000000,1218000000,0,2
1AVMDYAodGfGMgMV9dtHn3xru8jusH1Vap,False,1099000000,1099000000,0,2
1Ma4RzY2LBFyiVisHoi7cWVXRRU79zT9V6,False,987000000,987000000,0,2
1PA7zDKYXzFusQB9FXcoUpd5ZGdiaJCYjd,False,1535000000,1535000000,0,18
1AQ8J3yvsB6t24tDHGtzvEu8aR8EE1tocE,False,877000000,877000000,0,2
19XxpzV4iwRFuPL8veaXfAEUjftQFdtHf4,False,769000000,769000000,0,2
1BdEigR9MJceeYNxEnYEbTVGNekfYka7aS,False,662000000,662000000,0,2
1NgXZNudd8mhLNekDZhNw5j5a2dNtzA7A7,False,562000000,562000000,0,2
12iufq96i1rkviyB8SZwV1yMxqEfR95WeC,False,804000000,804000000,0,9
1M1QvYvBRTpY6Vq9YK62CCKKKd73yS7ZAn,False,466000000,466000000,0,2
157qhH8cmMb1cPk5kKa27USDhUysbMkUSP,False,1525000000,1525000000,0,2
1PEyvdvfw3KyfG8KzWe2fewN2SQqRVq7mC,False,696000000,696000000,0,6
17QU6hCsRCAdh6QxmmMPzV3evabtGrVuCn,False,1560000000,1560000000,0,2
1L9tHLF3YzRUiwgxSZMiGxzMXMF8woAVEj,False,376000000,376000000,0,2
1PvWY7Uei4cVVYjrcptY7g3xkFEmhmnMNP,False,317000000,317000000,0,2
1JanmhoGB9EnT8o42TVmEcGeEJWBrsJbGN,False,288000000,288000000,0,2
1AAybNFvnxSSor2ZWTGBb2DZtcrXHiC7fK,False,265000000,265000000,0,2
1JGzhhdN8vwTJsagbyiesifAdqW9EejTP7,False,246000000,246000000,0,2
1Aw865KZR4i9U3XMYpwBrgRuhHiJXan9Uw,False,231000000,231000000,0,2
15cve3opQEUUe5osxrJ7QkM4wL4uRQFv9j,False,216000000,216000000,0,2
18qzjcoFPBTV3EDR7a2EhnTWJAJUL4JFAG,False,202000000,202000000,0,2
1LxH9A7S4BBwCdX3rAH3XXX41poo4N6uSN,False,81000000,81000000,0,4
1AuzDrDB8iAkh8kQTigF8CGXhi7ik6b377,False,196000000,196000000,0,2
1PTet7Wmn3QBzLozDdTudbJbBdwnAuUVSi,False,193000000,193000000,0,2
1JbXGeNpBDrLk2aPWe1GvjUvnAF1NfDQKk,False,191000000,191000000,0,2
1KkyUF2piBw7GxVmCb9EcMmFDvhwmm6uqj,False,190000000,190000000,0,2
15RfAvskZTRc8ybWjkycCibDQ7xS3KD56P,False,3800000000,3800000000,0,2
1BKCoU9UyvMitE7xgDfwucCrREMfmeFg2E,False,97000000,97000000,0,2
1HQpAeR7MtiBosXatSmq7wxWZ3qCzMc31k,False,2000000000,2000000000,0,2
1P7izXDPoe1hXeidjuXYwfJSzBRdi4DuNL,False,2010000000,2010000000,0,2
1HVocFYuc5vtb65UZQshs8GSZkCSWpLUNy,False,520000000,520000000,0,2
1PTEoKeczVQ6943AYVys6Gz9UoUAJXtszL,False,515000000,515000000,0,2
1CZKP5aGGaoNyojAby2PkBftocvkjf9UQS,False,701000000,701000000,0,2
1DZd3m9J9mgfFxU9jXSKeWFhEJctcHpSRG,False,2500000000,2500000000,0,2
13XwK7hLAXTfgqJs86c1mKv9Q8cTQDyfd7,False,493000000,493000000,0,2
19oXjfQxdg5HcS8Lh9azJTcANAwCjMNnpX,False,510000000,510000000,0,2
1DUUcxsHecSpWUgDgLDNLtbBsG87T7GsuN,False,180001000000,180001000000,0,45
18CHzn2vPmGQ7Gb32hkJwRFBrujcirZ1XZ,False,4910000000,4910000000,0,2
17xfWH5CHvHkXUtNVdQzzeusMVM1PmsV2j,False,4461000000,4461000000,0,2
1KJ2WVKZvdPCohexJ7jhYzcRpcbvo4UY8K,False,4416000000,4416000000,0,2
1ABkeUztRmhkKL6yEmt4Max2ad3imtTy4z,False,4271000000,4271000000,0,2
149Q51JP3v3VPTCJMK4w8j4NiEvqx3LCev,False,3585000000,3585000000,0,2
1MbJf84rt3ikhRM2ervmK2TxiJKgyxPVYQ,False,3436000000,3436000000,0,2
1CU7nLfVgo1HiBe2LZQydHkyMeA1maNhQd,False,3238000000,3238000000,0,2
1AehXjDEqQ4gkhJYDJ1cwEnKHLBsQ91U99,False,2841000000,2841000000,0,2
1Diu9pn6Z4P8eJeM4aBKgvh1Upkgdn9kuh,False,2349000000,2349000000,0,2
1Pkzn4yHQwS9RT8cQLvF7LmJ4Aaqm9ssAX,False,100000000,100000000,0,4
1FfVhA383zmni9qfKx33fJmKzbTtoutr1g,False,660000000000,660000000000,0,12
1E6ocEDgAxHg6Wd2WFB78FJrvwBMy7Hu9X,False,4867000000,4867000000,0,2
14Vge1CjeaBzNJAnGfWga4GYdxfi1ZmNgt,False,10141000000,10141000000,0,2
16k2y6suwZL6t8a4egQyGDnQ4Tgni2dmYh,False,2306000000,2306000000,0,2
17YQfSJWXHDBApHtDJziajBurZ1E5DDiB,False,505000000,505000000,0,2
1HeFgwgBbNXoASqHiRWMAkn5WDkJsVsx6E,False,4973000000,4973000000,0,2
13bTMm3aT8AXQreBUqWLqrafZeahWcNrvS,False,2266000000,2266000000,0,2
17NaJT19xEVbRjyfzesn41CRQNw4X8MmJV,False,100000000,100000000,0,2
1RrW5KoQ9VbQvn9WN9bXsSgmiRTW77njy,False,2238000000,2238000000,0,2
1EwrowUMqAMm1JWDdTQeTU5fxDdb8GftDY,False,2220000000,2220000000,0,2
1LEiJAjhRN7VsQQhkJYtgMtmLk1QwVTAPV,False,2206000000,2206000000,0,2
1B1gXBu9LPqESYeJQ7kkMrjNgxyykZAERZ,False,500000000,500000000,0,2
1EE8urzB73bM8LEYANkRX7R6ZM3MY8oZGh,False,2193000000,2193000000,0,2
1NpefJ7JgCkkDYWFaHGqtSVcxnk9GS8Ndn,False,2185000000,2185000000,0,2
1DgBhWb2MpTwStHpxSLBSgrkQkvvF7Gs3f,False,11877000000,11877000000,0,2
1PwpBShbZVAXUNsHmNaQnaM7hDRYftQfqj,False,5000000000,5000000000,0,2
17XmAR5YSewf62EKA23rcvJvCBn1XYgBWg,False,6800000000,6800000000,0,2
12JUm5RdnU4NYiAcXjr16FLWNYJV9hwiop,False,4727199995,4727199995,0,2
14fMdtEDiJcJVyoGGczpFxztgACQr9g9mG,False,4722000000,4722000000,0,2
1ET4WxUoCydSV9VJuoSt9qfpkvFCNrZNej,False,4585000000,4585000000,0,2
1HQg4xQDDmf8nCR8rr3rUBAp6wscjA54HB,False,4112000000,4112000000,0,2
134ZaZJ18ytDNPFKiWoZcpWQyWvoRsZg1w,False,4002000000,4002000000,0,2
1MfSxVVfN91X87JCKEUCUfV1LtGDfLALH6,False,3745000000,3745000000,0,2
18AHFzdf7rbq5GNcsPHokS3sabQ36mZ5xE,False,3026000000,3026000000,0,2
1JtjhzyNwui8xdu1Ae3A96KLwSs8gA3e7E,False,2741000000,2741000000,0,2
17kihq6s66wAg6UJk1rHrcXqvavrWXpKeC,False,2075000000,2075000000,0,2
1BfmPnuGwSuQJYN4R9oZyjtg63B23t4BuY,False,422000000,422000000,0,2
1L21bhqn4AuveM3RhzZt9vk7Qo6QyjQkfh,False,968000000,968000000,0,2
1SuyuLXywEuWwWcHyCKgc6eC9f1NzgBUr,False,1919000000,1919000000,0,2
18QGvVrbosLoExjFP6v9iJZesLU82dU4v6,False,151000000,151000000,0,2
1PuxyDtB6jgDto8NYT9tK7oLJ2xKf5rTkh,False,742000000,742000000,0,2
138VsXGQfn7SPFEmqXPzEFfqXebUf3B2Mb,False,1766000000,1766000000,0,2
1BQ2k7MLB4QtY3wrCQz88XtMR3bUCtc5oB,False,524000000,524000000,0,2
1LG949Xph8V1WhqhAgMqiu7G1jEogrPjnB,False,1643000000,1643000000,0,2
1AqvepjwtUPj4dM75abGLciMJ889MHFwaa,False,322000000,322000000,0,2
1FWiXJV5UqZBHGKuVvFsEB9iToWXHZpSHs,False,1535000000,1535000000,0,2
1MqdUsj87WMd2DfmGGaqcyMvjDa2qQrouZ,False,121000000,121000000,0,2
1FCWaCP6Lzqho6DLdtd2RoqEuAScFWDj9D,False,1428000000,1428000000,0,2
1GaHkg4hoLcxLfLxDMMffdsVUC7wisJiA6,False,6805000000,6805000000,0,4
18GctD84fSUsfpLwsBBFjzVAwuUazPFCVk,False,1328000000,1328000000,0,2
1KnNMARj8kxBqpbrLfFZCeSn4tmYPmJQTa,False,84000000,84000000,0,2
1Ht4rVg3b5nakVaa83fkbjcYqmEpJXTXq1,False,2209636412,2209636412,0,31
1CVRrE8Y6y2VMaBxTvgq1i2RcAmdqdTLJH,False,1228000000,1228000000,0,2
1EbYquEb1DEw1i6FC6bZrs8dzmT3ZXjpLF,False,1162000000,1162000000,0,2
1NMUpkDtEmZSvhMda7LpuqgD2567QVY121,False,1105000000,1105000000,0,2
1KvrbeJQxEn4DheGNVD15mJiDF1MWyouwv,False,1052000000,1052000000,0,2
144LrKZgJfFrHhcXAtVqAtjESR7tuc38Cz,False,999000000,999000000,0,2
1JHJUDavVKqpLjyAfB2F38tozPCf9a8q5n,False,224000000,224000000,0,29
1N2QtAXM7mMJeE9JB9ihP8mT4zAg2pgnrT,False,948000000,948000000,0,2
1Fipmbw5kS2GXJ12FqvuuZkeKDaJEULzVJ,False,901000000,901000000,0,2
1NQSWd9Cea3drCmH7SUHy7S8t3PDuMPJrK,False,857000000,857000000,0,2
1G77pJWHV61Fzo7XAYHkvcAqRCSxiMXXEM,False,825000000,825000000,0,2
16sH3AuxUcqaFjha5pUEu69Ubrjrz99UpY,False,806000000,806000000,0,2
1AC12NuAq4WMEEVszB8zKi1ngw4ke2F5YZ,False,788000000,788000000,0,2
1HdNe8zMytw7P9ce69qcNUZZQFK1a6zS9o,False,776000000,776000000,0,2
1At7rroVkz1RhD9yEQTZAMbXqyAZjcgfSa,False,767000000,767000000,0,2
18oGc6A4E7FBnoroLwW1LYLcoKfBbLXJwv,False,763000000,763000000,0,2
1HB4tDHp4gqLjUneQEWFuRF58Hvtp3BHCX,False,761000000,761000000,0,2
1AhMWCjojmcUdNg9frzVejaGkusBtsaKZ3,False,323000000,323000000,0,16
1LUPviGW9AUoaL1AYq2XMn2DvLCvVcghiy,False,1400000000,1400000000,0,2
1MBsAHbpXe8575tzwMo3CMDRdc2rZzTS9M,False,1215000000,1215000000,0,6
17k8RUWLFktPqBnm6J2TDgfFFqogCjNMGa,False,495000000,495000000,0,2
1Dy7eq7xoAyuVwWZkK3iZCSwF5fCqoZdSM,False,45000000,45000000,0,2
1356UhKmP1Uh429edpwsUjA7smVT8Pqwpd,False,1130000000,1130000000,0,2
1Fsn5gNRXCfpLw1eaJwM93ZcdwzwSFeLds,False,10747000000,10747000000,0,2
1LWJC79LewL6tB2Z2WqJy6RjScjiDqaVed,False,2009000000,2009000000,0,2
1PFjvBCX16RH4BJmTgwSBSvETrt5kpZWsD,False,2400000000,2400000000,0,2
1JkrU69Rn6uf8Z2LPqnJGRfc8RU1hpnzCg,False,2600000000,2600000000,0,2
13gfUGiCzFH5FdmcHYn3V9e1yzEyNUbtrX,False,2357000000,2357000000,0,2
1FoHDbDmMFFUz3bF4f2g95n92Pjy1sRJKn,False,7677000000,7677000000,0,4
17tu7616MJupwHVPTx18fD4qdTB2Rabd48,False,33070000000,33070000000,0,2
127b7gcRAtPmxNhxEDaNfbWJYvosfk4278,False,10136000000,10136000000,0,2
1EZHeShijGhUsJgZhsaC5eLwixqvgBzaoX,False,3300000000,3300000000,0,2
1HkvpC6faZj2v7quaUP7qwqLFRf23oKUGD,False,91000000,91000000,0,2
15HDGSTgUEUUy8f3GmLKwQHLEXWXrLYzsQ,False,1500000000,1500000000,0,2
1HMs5Uke7p4UqGm7NwHFcV1HMNgQYLyYhr,False,490000000,490000000,0,2
1J9fa8VGnJLzrPLDD5aygEEnv5iuWz3WWv,False,50156359015,50156359015,0,21
1Jm7ieqZMteXcwc91cpeA7cVGqBuPKR24f,False,10131000000,10131000000,0,2
176e4RiH59yrrZEor2ah2YbPovHBigbZ1n,False,200000000,200000000,0,6
1J8TQY7769cwV1FyCMJUy8GkJ8NeSYVf9n,False,500000000,500000000,0,2
1Q6VtkudEyUt5hfzhGHYeWAHzwgEFYHpUs,False,1000000000,1000000000,0,2
14ph7EMAsvd1GQ4HKFfsoaPjcMQ6u64axz,False,485000000,485000000,0,2
1Kg7RnYHcdK571HyS4TB6dLCCDCwtbmHDL,False,39536750000,39536750000,0,18
17ToNcVfnceXJ9bhj9uxw4pccGZybLBeHE,False,50000000,50000000,0,2
1BbBjMqaHwGQYgMvNNKvcjPZjEVhwhdpu4,False,94000000,94000000,0,2
1MnfEQC3xZdSquvzcUpfbEsHMDY9c5R1v9,False,10000000000,10000000000,0,4
17BbKeuqUS5qbhvfY8YT195N6uyeu5WxVb,False,90000000,90000000,0,2
1Jngi6D3pq8JBjj4t9jr8czd6eVTqw7khR,False,35000000000,35000000000,0,8
1Q82CTtu7avu3MSjbgL9WehAHdfLi9VUEd,False,94318448,94318448,0,2
1FTPjFHVMenXjnwSKWbMkSVdPiU7jg9Jw6,False,400000000,400000000,0,18
18MuJWtkSHKSEtLTjKHT2i93YUPc6ixMFT,False,50000000,50000000,0,2
1Lx936jmei9rHN5hDV5HJqqAmG1JDdECbd,False,75000000,75000000,0,2
1HyPHDZ68R9s1zsThXUJ3yCocaWavE6fdd,False,5689000000,5689000000,0,2
1GZhgryCv8PDbQtB21Xo43UDpPNuNrZR9Z,False,111000000,111000000,0,2
1NMbdYCwR5BxWiqjbzNHGDD3nCH3qmqpgf,False,2357000000,2357000000,0,2
1PEG9PgoDQudiFQCkzSTiQnQJGRzXPR46a,False,480000000,480000000,0,2
1RSQS7kS6Fv6o88ieqSzsnNgF79LUAXNV,False,749000000,749000000,0,2
15kvajdnsXdkKu9DU26xyenXcvA8hk3EYp,False,10000000000,10000000000,0,2
1KchKePkxa5hnZnehYdEgM5ABoDFKZAkwF,False,30000000000,30000000000,0,2
12CfYzaCMAWgZoibq8oXyxtS7XNzoQTW89,False,10126000000,10126000000,0,2
1NSKm8MoRQ1h4yPWX3U9VLaBexTZDfQYoC,False,41000000,41000000,0,2
15E88Zb9iKJcLSJE2XCHLMbP2ynsaukpC7,False,475000000,475000000,0,2
1JpHDxwF1ntD5K8Y9XgGwdTtKcRLFnZwXA,False,100000000000,100000000000,0,2
19diXjpbU9cMTcpEAiqwogChLz6G3Q2t8A,False,10121000000,10121000000,0,2
1BtBghSHgHjNXgywe79gVK6RuvttiemEZc,False,470000000,470000000,0,2
114Z7okm9gwWLANT24iYFUogqHHh5hSq1b,False,465000000,465000000,0,2
1ATixZnc5Tt8jxHMhn6HYVR4Gg3QcYmtb,False,460000000,460000000,0,2
16yuS5Y2m8fu34g1kD7kWV1tQTkETWnSSC,False,455000000,455000000,0,2
17tbiiWkUoiWj95MPDVNyRaK2QwhtoqdWH,False,10116000000,10116000000,0,2
1P3cSYyaqUpJ8CnPNQAv79XGiY99JqEtxv,False,450000000,450000000,0,2
1NGMNbkbUebtvDDq9xkrpW6bZZ1Dhm5EHV,False,445000000,445000000,0,2
1CJG4c81CCj6Ez2rEBJGDeQwWEXjNWpTPw,False,33065000000,33065000000,0,2
1Nkiv2hp3gj44Ea3Vnq2TwJmD3z8RrfgUC,False,10111000000,10111000000,0,2
1DBQ6Y2Tgf6HcBSCnxdxhbdDq3HaJWNNx7,False,440000000,440000000,0,2
17H66sRo8pr6j6ZmqiYF1XUPg5em16bLh9,False,435000000,435000000,0,2
14rQ8qgRemxtietezj4aAtmhzo14jzVZb7,False,430000000,430000000,0,2
1EZc19sLhm11ZWggMVGCh9nuidaR6cCRVM,False,340000000000,340000000000,0,2
15NyTZKMo25akWcth4qDCjmaebrdvod6d3,False,425000000,425000000,0,2
13gn7pnRtz62dbAHuEwWW7GD78z3Q1WkhY,False,10106000000,10106000000,0,2
1DnxHwotG9kqsZTz7R6Gisai3nNdWzg2wQ,False,420000000,420000000,0,2
1AQf7NfHPSsqF6sKFny8En1ST8yfWohN8U,False,33060000000,33060000000,0,2
1LUTn3WJDhZFJpfKyeyRZNBGA6QaNTAR1,False,10101000000,10101000000,0,2
19kcSLdEmpiNcd9CeG7xkvZ2mmdeDtGitD,False,415000000,415000000,0,2
1F19CQM97DdqXv6LNcSZGAJwqZ7apTuNFU,False,410000000,410000000,0,2
1LNn7XfFLA8gRCtfjG6TKGF3YT918Emfjm,False,405000000,405000000,0,2
1M5Z4AdaRXmh3W7DPzbURUmHcqfMuN1pDP,False,400000000,400000000,0,2
14dPYp6gyuWoB4gizfA81Bs5W657vS3WV6,False,395000000,395000000,0,2
1PQR7rcHQXLFEpQJy7yiUrCK1pEEcGQ3Xw,False,390000000,390000000,0,2
1B4Dsd35S4PXYAyfYXmBsQGP4ugcQ347h9,False,5000000000,5000000000,0,2
1DrAkniXz5xHbGNSawfDbJuLoT2UgYHTB7,False,2500000000,2500000000,0,2
19PiCyD1bV9Ww1xVeiGkGmQxN3bvxH8CUa,False,10096000000,10096000000,0,2
1KoRUXLj6xGBsPXYARaNya9kJELuMiUhsj,False,385000000,385000000,0,2
17PdBKTPjafygkWjjBQH2VDWsUHpN7tTva,False,380000000,380000000,0,2
19vYLLdtdtWva8MRQmTgKMGkJoQco1PQNe,False,10000000000,10000000000,0,2
15gkVDSZE5ayQ477nZ7ArM8sADP4W5sndu,False,115004000000,115004000000,0,2
1PQ6DcYrp8FcQ3yQa14usoyStusV2UDb2P,False,4969000000,4969000000,0,10
1KEBz5xCQ1shme7YfyfujBFymn3FVjcSZ4,False,2640000000,2640000000,0,2
16zaP7XTr1rmTtEvLiLmgiqQmUuUbLttQ1,False,12000000000,12000000000,0,6
1PAdRV6L821rSNP47e7b44Kh1tykGVpate,False,6000000000,6000000000,0,2
1AAjQsCnuNQwaP1zJ9gBZMGnvfvbJExbf4,False,375000000,375000000,0,2
13oTMZcKh7ok5pJbVGVUmhhG2SQrhmNwvW,False,10091000000,10091000000,0,2
12fw4PwFNP5EzGWtFCXJr3pvSjuTt9bJFk,False,370000000,370000000,0,2
1EdvFsbFQYNfz2M6eRV9BTJi5bsBPgPUPt,False,365000000,365000000,0,2
1N1bR14wrD5zGsbNBsU8LnWQNEyrc8aWNg,False,20000000000,20000000000,0,2
16dXYB3YrBSgt1jS5HJeqWUgC6eTTHLtQu,False,33055000000,33055000000,0,2
1K3RwvaLh9h5DFmwCZCvtV1FRsjdAiutjM,False,10086000000,10086000000,0,2
1EkpzvWhMtFp6sPiwSstei4cfiwsrnMh65,False,360000000,360000000,0,2
16WE38ccb71BDTQQZyoWFLuJgRHFaapFss,False,743000000,743000000,0,2
1N78BE26SKzoBQqiz9rAEWbQgkBvW6xyFq,False,33050000000,33050000000,0,2
1JxeXKu7z6qpCLAEqTvhHqUvXcgqu626Ty,False,10081000000,10081000000,0,2
1Fe7tEPznLYMwNQ9RVED38NAeLBuFyfa8D,False,355000000,355000000,0,2
14gcMBQQF2KMhqQwo1544NjvHe3rbmPXQv,False,350000000,350000000,0,2
12qNJemz9dbryHcRdp6FKn7jJQwAtgHyYF,False,345000000,345000000,0,2
1E483kwCG5bKKiuHAtG4RxdanAgxKuMFbT,False,1000000000,1000000000,0,6
1Dv3t8bXmoRCSJYqa6fh7MRBtcH88ro5xe,False,340000000,340000000,0,2
1K68yKzE9a7n5kSprmfqrryP35JdxeDGo3,False,310992000000,310992000000,0,114
1AF2mLsKsUZvA8wbodRAr6U3MEdrfGf9YG,False,4820000000,4820000000,0,2
16TC3VWKMbHeHA5pYDSF5SRhiRoeh46h9o,False,4826000000,4826000000,0,2
19MfFTpMBeYd7AUnWsJQ9CiWApu8rt4zwq,False,4522199995,4522199995,0,2
1s8k1urjj5CCSPXFNYMntXVd6fZXnjWDQ,False,4484000000,4484000000,0,2
1Bo5gv2opdsA9bKH448wxaGixgxJCaUbSx,False,4329000000,4329000000,0,2
1K8uZP4FiotoHKFohon3rPZqA4utJSpGrq,False,3855000000,3855000000,0,2
1PNXXctVsFtuLmVTrazQRfVqS2DSPbDyuD,False,3709000000,3709000000,0,2
1G56mk7VHwncGJyfXGZRS26ow5cuxV6roH,False,3450000000,3450000000,0,2
1KKNamaQYUktXCaRACNL9fAuj2XtkExing,False,2632000000,2632000000,0,2
1Eu9P5i7fpQ2ceh96cNQBcVa8gFyy2T7gN,False,2173000000,2173000000,0,2
1JbvVkzKBUYMpQLnbiSkDj7cYtWsaZ5SWp,False,33045000000,33045000000,0,2
13Z8Bu2T7KLak33xC4FkHfrzsBhxy9bzhJ,False,10076000000,10076000000,0,2
1BKYqcecnamt8oaXtwfVDFjDHTxc2kQR6o,False,31000000,31000000,0,2
18thxJ14ezKzMcENdAFUfawoMzMD95L9Te,False,335000000,335000000,0,2
1QDXRumUrptipSgzG3GjAwZukMMyDmc4xg,False,2002000000,2002000000,0,2
1Ku6d8qsVQLEh9SrudqoDduHsKT8j2qDTa,False,330000000,330000000,0,2
1Pf5XPWk6Y8qcm1dpHtY4q224KvK2tuGSW,False,1853000000,1853000000,0,2
1qm2ZedsiHBD42R7jYssWKRbZ5g5aCJiS,False,10071000000,10071000000,0,2
1CX5Zb4ZbJPPWZ6VEiULGPKi3Hs61Ba2p2,False,1711000000,1711000000,0,2
1DYnDAsHwTmaxPPvL63Gi8mds321Kkkk1g,False,325000000,325000000,0,2
1Q1pHBMc9H6KS6LcFsxjXPgMdVyQ7jjaCU,False,1575000000,1575000000,0,2
1Hrqrc78SfGaWL8PHA8jqatfFwNwqDvek6,False,320000000,320000000,0,2
1Gy9HCTGasH7jdc1Qhht5dRtc1oVro2yqk,False,1460000000,1460000000,0,2
1ArWuCfkdGsvGVJdiEtwHM4HoZMmFtTEvz,False,315000000,315000000,0,2
1Hz4fzBaLRFB5eDfQKfmSEHtrLcsusi82V,False,10066000000,10066000000,0,2
1P4GuC1mTPjtdNeC6mX4nRqDy4EkEqH5jU,False,1350000000,1350000000,0,2
14te3oU6453AVK3Qje7tskBfGWeHjinjLJ,False,310000000,310000000,0,2
1MfWzbCJRY64vnEL4MdBuGmQYCmtQMV1Ev,False,1242000000,1242000000,0,2
1CvTkjALVv767CEzoMXsGdXZuTJvrAStmo,False,1134000000,1134000000,0,2
19Nbbd5iTgc7mUGyHdQUW8VMrCsTnJXB6t,False,1048000000,1048000000,0,2
15j6ByTbBMwKoyLXdwaS7oQ6w1Swd4s41k,False,970000000,970000000,0,2
12C4AJ8vQ8vZWoFtARfhNDGWcBzG78Jbr7,False,895000000,895000000,0,2
17QjwdbSSXBsjYRoRNkbDT8XMsCB76hSZT,False,826000000,826000000,0,2
1JXwtMkWB2Z5H39Pe7q3676UfVadDTrL9s,False,2000000000,2000000000,0,2
1KbDnkiTvMG6rMFnTF6Cv6ohdXQFYRAD7e,False,771000000,771000000,0,2
1UzJSGsNmHUgRwudsYE6GqY7uw27VVWgV,False,720000000,720000000,0,2
1FPVkV4GPHPL673SiVuW8ySwJBhPQWDQ34,False,685000000,685000000,0,2
1FNppHxPuxZSYFosBqvt7mXQ3gWSA5Anvr,False,225084000000,225084000000,0,259
1DnRVabJ1XHo1brqLViw2wE3t39KbHPsgx,False,655000000,655000000,0,2
1A5EGtdiXTb2cnWYvjJZjM1cy5fBQggXL1,False,257535000000,257535000000,0,91
13oY5oQkDSrTgrySq5U8JRufPHKdn43uUd,False,633000000,633000000,0,2
1CHSFGVYX1GY8habDBwPZ21JsMZq1C9ZBt,False,615000000,615000000,0,2
1PDwPdW3wiBAas4ZGSjLTn7pye1d8r5N6h,False,599000000,599000000,0,2
1CQK4myQJB3DyG6XXUYziZ6dNAKfmW39XT,False,591000000,591000000,0,2
16RCtGjvD5ZM66cv6qaGneVzfi4C6z8JMy,False,587000000,587000000,0,2
1DM1zG295EayvpmMUJZeycckrZmvx45ZBc,False,585000000,585000000,0,2
17QyeizQBZZX4iivk1X7F6ooSBrW2c27yG,False,583000000,583000000,0,2
1KpZScx93jrGhxaKiVaX3LUcfmaeKmvstZ,False,582000000,582000000,0,2
1Pst3buop62SXoRUuTMNGrG7nN1UbXNVLa,False,33040000000,33040000000,0,2
14uzP2HwTcpEs1RibQgGaseVE3YS4t3UWp,False,10061000000,10061000000,0,2
1Aja1ZZstiKhE7vtBCraMqGjUjdejTQ6SY,False,305000000,305000000,0,2
1EMUb74akfEkYareV11iK6yEAnKAbnCjbA,False,300000000,300000000,0,2
12uwAUAuFDHqD2BcPoTF7gBvpir5yCBR3m,False,295000000,295000000,0,2
19kBmsJHHrqYyKmSar6ex4h6ogDVT23q4n,False,25000000000,25000000000,0,2
1QL3irkSU1iCxJcxTHsp9XV7m5hoTnbBB,False,33035000000,33035000000,0,2
1FjwaB8yvg1HTfekg5NP2QBhGyv5hX8WC2,False,10056000000,10056000000,0,2
1D1xTjWLKsy5dn6mCQZFjyZkp42QnCyGYN,False,33030000000,33030000000,0,2
13ceaEsfHRqwAfsm87qehMP3V9NhDWAg4J,False,10051000000,10051000000,0,2
1M3YhztLHMx9JN4R7mcVKBYK2r9R81Savd,False,495000000,495000000,0,2
1L2F4yDenK1KhJyR16zZUVMGGhcKMVa2x7,False,290000000,290000000,0,2
1DTyt8gneKHfy3YSogW5ugAz2kR3MJE23g,False,4837000000,4837000000,0,2
1r3aeRQGdCLnuudofRrzPwkEaSbihEkTU,False,4348199995,4348199995,0,2
1JrkRLQj8wWTmTveEV2WCUvEwYtjCsTPYQ,False,4278000000,4278000000,0,2
1CZEXkpDtyHo9q2TmK1Cy2dTMo65aobuFA,False,4095000000,4095000000,0,2
12e7L2mxbThE22GDAKGaKpi5JWM5wHmBER,False,94000000,94000000,0,2
12Ez69vTwwHneVKXrLuL1aViTX9P57FJv8,False,33025000000,33025000000,0,2
1JTNZiPHCNZhezwju3Nq9LxtzRwQpkU78J,False,3274000000,3274000000,0,2
17jFK7jYWTScqYy5ZtmQ4TvKDLkNZgQZB2,False,2687000000,2687000000,0,2
1EdEbEyBSpE71TPKu89r8VukpV7oEQcUEt,False,803000000,803000000,0,2
1Kyw87MoQ1rYxNE1d5bgkhnFAy7ZzTHyKN,False,10046000000,10046000000,0,2
1D3mBF7KgduazZJNp53AfVwjmiG8ysLXMv,False,2642000000,2642000000,0,2
1QEwEysAryGiNLhdkZn3yYdnUgEcdScTM9,False,285000000,285000000,0,2
125k2wLnmhuGzn19gJDN5kiYPBh1ARfEjx,False,649000000,649000000,0,2
1ApgFYpZi6ztedsQLwCLn1ngsdosEcnTaL,False,41000000,41000000,0,2
1CytXp5NcNSg9gQ4etUmyBivwykN5ZxQdC,False,2601000000,2601000000,0,2
144FvhhvyewUc2CzemdW6APeGJL7HWWr3H,False,512000000,512000000,0,2
12Pce6izwJFydsq27s6uqp1dfvGorHkFpn,False,2563000000,2563000000,0,2
1a6sZv8JJzKgcqjtAmNRFPQp3bjCjCfb1,False,33020000000,33020000000,0,2
12h9kWFZUQffzZbrV5gPhNkBudst1Fv3H8,False,10041000000,10041000000,0,2
15hkrzsc7dN9KkXpz8mez68fBE78CNesiM,False,2529000000,2529000000,0,2
1EdEeaeD7DdVSHw5duyntZ2V2HNPFmLr8C,False,388000000,388000000,0,2
1AAdedVmicM5V1GobXQApmuRyPTvLtJCmU,False,280000000,280000000,0,2
1EZHJfj44Cs84Qm7TtrUvYgD9w2UUcwrph,False,2509000000,2509000000,0,2
1C6hZPKP5ACwuJRrZoXppgpSQjfkPWzANW,False,275000000,275000000,0,2
1FDxuXwJdJjecBAS7nsxd1H2NxrUaiUDE4,False,2496000000,2496000000,0,2
1HjUqEimT1tNqH9bb537XVXWKJdJSVvhSd,False,169000000,169000000,0,2
1C9bkmArhzBKejYpGjtsp8KKZeVbgNkHSq,False,2484000000,2484000000,0,2
1HHGofhpbFs9wVuHkYqcL9xxMCZ1BAvuEj,False,2500000000,2500000000,0,2
1KJ2mAGYLtjALCPZdy8to9R8hvJ9SdsW3Y,False,10036000000,10036000000,0,2
1D3euE9MW9Y1hdWs6yjBJVR2aGxJtTafHQ,False,2474000000,2474000000,0,2
1NcXa58r1acCgXTwbqKFsVbAeMuvUuZpGD,False,33015000000,33015000000,0,2
1MQGxGJQwEkyiiiZfET9FGfDVKgf1jNkw1,False,2470000000,2470000000,0,2
13XcNQdvCK4iYCibTuzu75DmAf3ABGyAEy,False,69000000,69000000,0,2
1L1uoujPQ9zCBykP8wDdY8SXKuYqgMRiCA,False,275000000,275000000,0,2
12NkZttgh1wg8Zg1RzndaUBwUm9sk5BocK,False,2468000000,2468000000,0,2
1C1L6DBoFNgtmShbZzcgkd6rq7oCyic5um,False,2467000000,2467000000,0,2
169WtgRbn4ToQjF5fB3mD4v8iMxkt8QYWW,False,2466000000,2466000000,0,2
169T7YAVhqBcR4J6MQ4CyK6jofY3pdJZZg,False,270000000,270000000,0,2
1EL9eUoG4reKEUqC4qWiqAPKLKCDGT8RST,False,10031000000,10031000000,0,2
1DEdAoesvzbxa1SuokoxtfVke3zwPEhmAh,False,135000000000,135000000000,0,2
1ZwzJ4bHnNK4pnhsW6q2YssQZ9kXndHDC,False,150000000000,150000000000,0,2
14Q4rfxFWWJLNWyJLUNMDgYvgETRBHUfhN,False,265000000,265000000,0,2
1BuAkH8Ff9jfxCmfeHZQzNSe6q9px7Su3k,False,33010000000,33010000000,0,2
19LL8XboLK3MgCvLLxdthgDhryrMGL9dQb,False,260000000,260000000,0,2
1L8vLXiYtPMK1e8SGybkS7Dz4SPpCYRbd3,False,314221437749,314221437749,0,81
1J4xn6a2SWjRnC6nNi8gwZUYkzjFipc3EK,False,255000000,255000000,0,2
1KyMZj9CMQQuzFfaa2A3TmmwJJNgXHwBRd,False,9935000000,9935000000,0,2
1MXEmfkmhyVEaAecQaGx39gVC8en5r2Aai,False,53000000,53000000,0,2
1JAvqRHVPCiSMy5rkXDWXMYwxaCcodbrGh,False,10026000000,10026000000,0,2
1JJb4YXwNeL7BVdXNXVejDTMJctBgf1GSi,False,250000000,250000000,0,2
16t9LiVm6b69Z9iPtXWvqD64LNyPG8fjKH,False,33005000000,33005000000,0,2
1BD4TeEGAzM887oiAGptYyBG3xz27DxE45,False,35000000,35000000,0,2
1AaxNmFhcWYy7drFGkTmGD13QZBYCm9njH,False,10021000000,10021000000,0,2
1PsbGorNXCwrXVJ9nDA7CapnqspZaULbnV,False,2456000000,2456000000,0,2
1BTUkh5u1k4FRy6ZKw5rc2iN9aLKsf65wf,False,245000000,245000000,0,2
1JrTcSo5Vinkz8SJ6oDWWwVFdcY1zHwdtY,False,240000000,240000000,0,2
1FpYZQVcMP8B1BjdqDEAjYZkuZN2uVZfH9,False,235000000,235000000,0,2
15hLTuoucjTo8DdJpL6hwYs3hzKfDx824n,False,33000000000,33000000000,0,2
1Ny3UC7ZdocTjy8r2p8enG2D2WEVM84zpL,False,10016000000,10016000000,0,2
1QCknivQZV1uzZT78B8UE8HZyr3NBtBsRn,False,230000000,230000000,0,2
1CebTi9fLCGkVXFq1zU7WHPL8pTVfDnDGy,False,7900000000,7900000000,0,2
1D8kd5rGX3BpV2HfrzKPEQQD4NaJ4V5Vzv,False,2000000000,2000000000,0,2
1PyK6TEc8duRUfb8xGL5EKnNYRtpphcbv4,False,225000000,225000000,0,2
1CTh4Bo8fnSiLc66t523M4rd1DYj6TTwxx,False,220000000,220000000,0,2
16TGYTMx72nywohKjuY1iQEEu6uG365Z8o,False,215000000,215000000,0,2
1PkXAS88u4R7gZdqKuJ2K1HJWajnukMiL6,False,210000000,210000000,0,2
14sspWvGgShU6Rmu1qdncqZ7YjLcBbwHEQ,False,205000000,205000000,0,2
1KkFdCsfozt9386QkzJNDbtMDtriAN8TQh,False,200000000,200000000,0,2
1Nb7ehHtFgjV1HVhNQkY4EuuknwWzt93d7,False,195000000,195000000,0,2
1FHjAQeWxh5UQLefZABSQoVbUgKCjnD7nw,False,190000000,190000000,0,2
1A6RL4dJN9Z3cm6Jv24zELxc2YmLPcqJYn,False,2005000000,2005000000,0,3
1JfbFLFpKGZGHMzFuL9rvtrC9UzxW1UEVj,False,185000000,185000000,0,2
14SPDUerJKmjCMNoyR4YA2gRUwB5W3pThg,False,180000000,180000000,0,2
1AXJVMXasafDyMZqPYrtYc55neR5NpDgJJ,False,175000000,175000000,0,2
1HVtnmZ6wovYF22MXwwqVSq3mmTuiiuuHd,False,170000000,170000000,0,2
1F6mjEZV6qXYyQ95PaYCAWe7J9wcu9L2wg,False,650000000,650000000,0,2
1DfBKsawpWGFo93mWfxMDBQp6PvALEdD1a,False,7700000000,7700000000,0,18
1Ldncjyt9NH95Q7xXqWWrgZrNLqR1Pg8CF,False,165000000,165000000,0,2
1LyxqpZ2EPdfnZNfqHp6Sd6KZND37eeB4w,False,4355000000,4355000000,0,2
1LAPQ4GDmpmKRp79YLtVU5pqZMfmo8zQGd,False,100000000,100000000,0,2
13hrGmh87zW8ch6fnv6L6YSHVYdKTQ7w41,False,32995000000,32995000000,0,2
185QyUYZNRupk8WDbXkCjt957g549Hs7G4,False,10011000000,10011000000,0,2
14bw6xGb6w4un5DSVuUXzxZ1gdq4UbgKgo,False,6518000000,6518000000,0,7
1L1Vn4FLPi692NDsdtREs7Dp4vTpobwtqa,False,5900000000,5900000000,0,2
1M1C5o97KKzXoeTQRKKLayQF7bNSMaPBPg,False,160000000,160000000,0,2
19K6A4DZVGxrCG5mtymmWE4JXT4QGpeQzU,False,3562000000,3562000000,0,8
1BBG1ssoHW4zhRUEF2gTKsiASTGQWLhE63,False,2545000000,2545000000,0,2
15Qvts3L2ML538ybH3xP9hKrM282QS6NSL,False,9612500000,9612500000,0,23
1MuJeMb61aB7eUrs7y1GiVUExpFz3kc4ru,False,2440000000,2440000000,0,2
1HQ1Kw3EvBMkWvuo5wWuprWmnJk72SdCin,False,32990000000,32990000000,0,2
1ANQrQovKUkZwQMYsuQbM83BJf5zBcDLis,False,265000000,265000000,0,12
1HL9s9w29Jm2izbyaKK7dcRtgKCLiSr1RC,False,215000000,215000000,0,2
16LVbNiW5bUi1SWuSFDr8A1tEisEGs5Qxj,False,10006000000,10006000000,0,2
15uh68nSJwMMpqZFanNrKdjctNnxbwUoYa,False,150000000,150000000,0,2
12gGGansYrwCTyFuP7pdJ5igPvfLcaGfhW,False,145000000,145000000,0,2
1FSShFzGwLpHLkgF2sp3hR28nbotG7Nvnx,False,50000000,50000000,0,2
1DdRi73qJcDuC5RZnthqg2842Gjet7PRGJ,False,350000000,350000000,0,12
1GzEoxzTeMmosm6g51VNr3LT7png89FcdV,False,75000000,75000000,0,2
13u8aVCFJKKyz7TMrRd4aUafxUoVfuopa4,False,90000000,90000000,0,2
1Lq3xPKEFPHYBQbrw8VN133TxYzUCEqweU,False,32985000000,32985000000,0,2
18uLH2KDRtBvh79sdQ9h5WjJmoAx6ts77W,False,10001000000,10001000000,0,2
1EkhSJnnhuWW6AhUXVLjQo8L4ihE6BhoPB,False,3000000000,3000000000,0,2
1MZ4GxTCWgZmAUv63SiK2s9E5aJhvxdyfN,False,32980000000,32980000000,0,2
19ApKR9ZWkyY7BtYC3hrvNxqh3bDfWTiX3,False,40000000,40000000,0,2
1F5sg9eSQjzPLQPQKqHr9htLzF1azK2sos,False,9996000000,9996000000,0,2
1Hy9dexzNzjvQYkYy6zKRVZMU8k2j5vuPt,False,5000000000,5000000000,0,2
15CsxsBrzfCp5DNwPdepLE4zNLu4grDbna,False,649000000,649000000,0,2
14o6TBJN8hTE8FiFSeioUvZAm6zs3RWb8Z,False,9991000000,9991000000,0,2
17t1A11S6s3sRj1bSNL1NcsWGnZJhuGBzg,False,25256341974,25256341974,0,124
1H7mLBw2gk3Mdw17ZYZySaK2GmYy2TeCPN,False,49000000,49000000,0,2
1NZn4GxZDzdGpesqXWKh4gNMvW1g6UVp9b,False,32975000000,32975000000,0,2
1PoqKyKn6K7seXNNRMys3Ywe8hJ9Ap2WHk,False,9986000000,9986000000,0,2
1LZrkN6HxYPF2DTRxh4e9yhYv8U7xiWnBd,False,32970000000,32970000000,0,2
12DZCKNan7snYV8a8zdjfL39fqB8GUxPbV,False,9981000000,9981000000,0,2
1PrtFkYngcQ99uE9Vfjdj8gRG6ugRqpxWq,False,10000000000,10000000000,0,2
12CfnyPTRX1eQCcpZWG9wpXeXsz1jdY2VE,False,4934000000,4934000000,0,2
1L9QhtYPYSvBv64ejWs8unocWcfcF9oeQg,False,32965000000,32965000000,0,2
1KMgA7BN83756nPiu7hazgM1MmrSaTDZ3E,False,9976000000,9976000000,0,2
18kpUeh46mKRXMAcFcNfdjuUD2PRyN9g4e,False,5000000000,5000000000,0,2
1LcZzchTFHPBbvHjr1BpVLsWyHMWGAhA6u,False,4768000000,4768000000,0,2
1MsfSoewBAQuhMquLNEyzoKpfiMXGmqF3e,False,5000000000,5000000000,0,2
1PQZ13vmT8bMY65GgKxxNsb4EcZgAW2UnR,False,32960000000,32960000000,0,2
18y9jB8pQRLspMLHLkVHREZ5sNCyF9TSxp,False,9971000000,9971000000,0,2
1JnJa2Uf8uLkKdVpKC15CkKhAxad1A8bTs,False,9966000000,9966000000,0,2
1LNqaxGqDcduJLnDQovPu6yYKJoLJCrzrZ,False,45000000,45000000,0,2
1ARK8faKXqXVYgHhBYGWSCBrGujmRfVfJM,False,9961000000,9961000000,0,2
15c7MxXvA1JDXSTFU7z9BgDgzDgdY74tUD,False,5000000000,5000000000,0,2
1CcZ8uRc8B2UXaVPbhtDJLV3rXDD6MWtxu,False,9956000000,9956000000,0,2
1EQ1iuUD6aUuwmu9AAMnNdJynseMdMFoBZ,False,200000000,200000000,0,6
1N397SFHvETuKXA6RXjvAhoEYBpqVaM4oV,False,35000000,35000000,0,2
1NP3qTkWYQGuER6QT7enLeMsD4sxUdhu19,False,736000000,736000000,0,18
13z3mECA4jEtZbCWFtL12MfTo194rzUy66,False,798000000,798000000,0,18
1MErT27D8sGYLYnmGZXt9uZPrHpWbenDk4,False,16999000000,16999000000,0,2
1HkPRQJ6tRkvjQKFMyxXrfM3iAHDdZ6GZU,False,13000000000,13000000000,0,2
1CRvjgrg1FJynbfkSCiGud1NgfazCoLeSD,False,75000000,75000000,0,2
1NE1wkL3ydNPpS7vKtYFzKbkdDvEgV1S1t,False,90000000,90000000,0,2
1NRmZGc98xjKUWaGu7iDUBja955rA4g5aV,False,535000000,535000000,0,2
18fXVmxPDpswGwjAiPtEBZb6NWegzECaqH,False,205000000,205000000,0,10
1QHzbZJXXAWATCvjhPuSpMqzSWbQQTn1kU,False,50000000,50000000,0,2
1NXqptgVUfmHJ8NW7bprCHWYrBuBCT2AxB,False,470000000,470000000,0,2
1JHLyVMNWj28PiY6c2fbtD4J1Dr5uR8NtZ,False,1249000000,1249000000,0,2
1B2jwsSQBmtQncifQWQokMsJpx2FYRwndL,False,3711000000,3711000000,0,25
1LuFRDhK75FrCWzz3XWYVQLiXTde5M719S,False,32955000000,32955000000,0,2
18e6WCFp2MdodLrw1HfGdUrmdRn99rTejH,False,9951000000,9951000000,0,2
1Nqr3MqVyUp6k3o3QPePAdn4Yg4tzgB9kw,False,84853962164,84853962164,0,353
1KYFjPj5PTfdGPLiycHZevGu4u2YoNLzTr,False,1480000000,1480000000,0,2
17C89vVyMyDaWh5KM1tpwKND2AbiiqfdNF,False,100000000,100000000,0,2
13vvCYRYD39z5wsJ3NVqRnf38uJme1pH5x,False,32950000000,32950000000,0,2
1CFjprcKzWHLVYdUrA2CSCf4UE5X1YXgwF,False,9946000000,9946000000,0,2
1ETgT6C148wDqT2cWFbDvniVH2wuhn6Zgc,False,9941000000,9941000000,0,2
15zCcR7z4MGASAjPW8WWM7gbuuij4a8udF,False,1373000000,1373000000,0,2
1F16XqFx7g4FmAsEJg1k7CkRHVyHa6YsaN,False,32945000000,32945000000,0,2
1Kd2rcHE8mQdEB8HS5eEJRx7CaM8y4iMhq,False,168000000,168000000,0,2
1PtqgbkDqFZfb1uCWKQUrUs1Uq9PGRHBML,False,9936000000,9936000000,0,2
15F39wZ5sWYdvZTZut4jf1E7UnjGjNE1fU,False,38591000000,38591000000,0,2
1LuUHPPKnHh8g6ahJNnkaRQyVjJm7nLBMQ,False,38000000,38000000,0,2
1Lz8J2MufpETgyArPzBpfzgKSFRVU9UJ6P,False,249000000,249000000,0,2
1P1nJ7iA2PA1hV1mTXi8yiipjrjKriqf2S,False,9931000000,9931000000,0,2
1GGNqTtsYeZF18Lm8DpuFy6JBiJpn3JHJm,False,2014000000,2014000000,0,2
19n8ogD8imviHn9iZSpmUgdZqjTuDxzDwv,False,469259000000,469264000000,5000000,11
1tcaxeSE4dTNsqWRwKvAfJTe5X2UDXyy9,False,4500000000,4500000000,0,2
1NPSHDkSkmLrtZHGijj8TcadNcdH71xhvH,False,32940000000,32940000000,0,2
1EkkUzqrX5ahSywdRHTQpnB6F5sCyiJmVg,False,9926000000,9926000000,0,2
18t1MCxswaSG2xQT6tYjEKT7BuMLcbvMXY,False,9921000000,9921000000,0,2
1BpC6pZq9qeXWUJ2LF4uMGRiiteqx8a1Hi,False,168000000,168000000,0,2
1HSJnsY2hGTpZrvngduRPU8ktSQzoUpuwu,False,1130000000,1130000000,0,2
1DVQEpTFjxYpZMVy4Bam9MCxeGEtmMmQCh,False,950633000000,950633000000,0,8
1AkaM9wTepUXvSaTJAybqxsgV5X4MzSjEA,False,81000000,81000000,0,2
1Lnfce21gYa4WMZFFR4iVUFz9F39tHmz7W,False,8000000000,8000000000,0,2
12VLe9wFVdio8gEjRqFJdZ1g5qBDfVfZkJ,False,2000000000,2000000000,0,2
1LiEy7V4GK1JUMBPomx2JcCREdRdtpvuj8,False,1000000000,1000000000,0,2
15ZpDyyehXLc8BiCUBMis5sTa2pJdNpdeD,False,7000000000,7000000000,0,2
12xMEGLvbtsf7mvVJsBMKBKvCZPeLiAqyB,False,9916000000,9916000000,0,2
1B9nZm9MJikMymBd5hH2BYDEDEhUq95d4W,False,9911000000,9911000000,0,2
1NeibPUEzJPcHmdXREN9z61471qGCDPZrX,False,4900000000,4900000000,0,2
1DLED3QVmM6jLzAfcE7G8FkpdbfCsCu8Ww,False,9906000000,9906000000,0,2
1HpP6Qq9GzQSNQAwJxzxz3BbPnkCfeZNU3,False,10000000000,10000000000,0,2
16En9ZULC59SeKvj4SgNBsUW2mwp5ntQfG,False,9901000000,9901000000,0,2
1Br25jJ5bZhLicgg6nRdenSamJbBY2ENvm,False,18809000000,18809000000,0,2
1EBsPz9SXfT6Bb4X9ZbPUNN2vaPT5KfdUs,False,1186000000,1186000000,0,2
1GVGcHEMNbUQocYShKKUmUC2yeT5e9fM5A,False,5000000000,5000000000,0,2
19f4SVqh7NSjA3UTU6dHouHHJfDmeQaSaa,False,4796000000,4796000000,0,2
15hGbpw6i2wDi3fCM2EM1mMc8wkKJhjrHJ,False,9896000000,9896000000,0,2
1DeDK6yseo2t1vvc2YhPeFWcLaUnKJfiVg,False,9891000000,9891000000,0,2
1DifrHesLfZNPMfS2q8jXmhFdiUhDaNdkK,False,283803000000,283803000000,0,34
1CKTxZkc3GpN1QE8XSiDiMEJtDCZoMVUkf,False,400000000,400000000,0,2
1NwKm6QR6fqYs9urJeHLkTuMNXKRsteAHy,False,4863000000,4863000000,0,2
1JoPfqNkEAh3kdUJSxtBQpbemuGRqtXX3u,False,32935000000,32935000000,0,2
197ySPfoW2nopq5BJwBfJ5V2cMcD9DuFD6,False,4684000000,4684000000,0,2
18Koepx39Du1uk2rCrvJMbc5R47g6rRCU7,False,4179199995,4179199995,0,2
1Gzmzk7RouCBKnPWLpGXuLoQH67fudsDW,False,4102000000,4102000000,0,2
1GhLPjqCJeefuKmUp6A5EPyjQ3ekEgEDRP,False,3906000000,3906000000,0,2
1K5Bdp5Vq5iGqPZbAMJt79yuXjMPfvoLEG,False,3071000000,3071000000,0,2
1FKxWKStnXPamHdheSZUL5TqstrHNMXrjH,False,2000000000,2000000000,0,2
1KoBXwtbYc1XKZPZnsaxfockLmqh9UMv7L,False,226000000,226000000,0,2
1TpjKExZoAD1KBoX7BfVZNfKbfeByAWni,False,1091000000,1091000000,0,2
14dfBKuVoM8V4BjdZbsG9K8PuqgLvDFotL,False,32930000000,32930000000,0,2
1DJVqMLtwKDmV53413LTjLJQdRLxPh3Vrk,False,9886000000,9886000000,0,2
1NiuEnvHvPn1xYeKV6DcQ8urztxdWt8MKJ,False,969000000,969000000,0,2
1TsYa1f8NMTyWB7TZAxhr5Kpdm5ttYchF,False,9881000000,9881000000,0,2
1MbDVqVJxPyqcHRVGXuSpDRZZvDBkA2Lhx,False,91014437724,91014437724,0,315
1G6tu8cRwKbvvYi1mTRQZoD9bKrBEyJTB6,False,856000000,856000000,0,2
1UroZHSCZqZ3sB59uo4EvisHB1auXEAyA,False,746000000,746000000,0,2
1LvTZuMiewD7z8SnQzr8Wr14gdoWG7hXsf,False,640000000,640000000,0,2
13r7yUS384zTLJNdA2HerDc3u4NHPBxvVU,False,538000000,538000000,0,2
1AfGBqXb5ZUuwH8nQkSJCKvj3kWg8aJFrZ,False,14031604617,14031604617,0,134
1DKRtoTMW1awWX5auw3wEHNmme4XjxbJjA,False,475000000,475000000,0,2
1QF4nHYPjTvTjjumqkuyG5dH5JZRuimpRr,False,414000000,414000000,0,2
16jbWkkbUYnV6Bv2DB2SeoFKVGA1oY4quf,False,354000000,354000000,0,2
1HAnpTE76WTzVvEmyNmgpxZHGZqX6i1X6m,False,2994000000,2994000000,0,2
17q15d2r3qgHQCWprHEL3rqAuWBboB6uCn,False,299000000,299000000,0,2
1MD6ZhU8cLUemd4yCu6UWiazB957fH3Xr7,False,627000000,627000000,0,2
1FJCdezMXUVkddpqKm3YwJs4QYuRcDMvH3,False,251000000,251000000,0,2
1Eh8Vhf9kmMkEj6QbpuQbg6CTxGgTKAT8X,False,205000000,205000000,0,2
16TSZH4b9XcjgdVXmoRCNysAMm7B3U91Gi,False,162000000,162000000,0,2
1EDFKnZ7H5kQPfRuVas3mHt6Luz8z1YUsb,False,135000000,135000000,0,2
17dGmRBEg2dMMsTDTQmHf4esz8VQiWkW19,False,122000000,122000000,0,2
1P9Lf9qTjTHyZ2U4mJyU3o2iQHduPxvkMw,False,111000000,111000000,0,2
17Yt5kNYfKyg3ofyJCKuSJM9LTEp1Uia14,False,100000000,100000000,0,2
1PLLy9Nk13KBifXErwaXsU4P2EnEBnKh4B,False,90000000,90000000,0,2
1MPd17BsUfaExrbndCVFRvjoTPpEPzujmz,False,84000000,84000000,0,2
152oi6HgpEiibYtNE4rTdh6UY3pd3Mpr9J,False,81000000,81000000,0,2
1D9TQau27SdTe4qeLXcNMLzKj2qwo2Ko7T,False,79000000,79000000,0,2
18WtbPANLJkboXnu2ubQJMJ658B7Qja5KA,False,78000000,78000000,0,2
1LVvPCVqZj8BzKzkhitTLs7CgbHnDfhgEn,False,77000000,77000000,0,2
1JPzSFW5n45G7RsF7AA4ivE4b9czPTwNan,False,76000000,76000000,0,2
1HTmV3WvLAYxf4cn9CVrSKwEeLdTjqeR84,False,75000000,75000000,0,2
18ygfoYE92xZG8tSs3bh1KmTpBveaFSevE,False,32925000000,32925000000,0,2
14ZugTwEkxbDjH7JuSnGxoPMfUiPXwCok6,False,9876000000,9876000000,0,2
1LZCuLbaetMk8mrm5KbUBfBu83jNZyg3vR,False,32920000000,32920000000,0,2
1Q8m3Yd6NLZ5YT96cLhdBZ6iY7mkPvYSeX,False,9871000000,9871000000,0,2
1LrQuJ7fg4Zf2wrucb9rgqpftksQgmFLT3,False,13000000000,13000000000,0,2
1JiYVnLHX6xZwwZbupSgbyHK2DRU63e6KJ,False,42288000000,42288000000,0,2
1HUhpCnBbYbdQbn9dE6ahJRwfXfwuEwrfw,False,1600000000,1600000000,0,2
1296ASeUc5Hc27antXQEWvV5eYaFaX2x5f,False,10001000000,10001000000,0,4
19TpAwkVfjnsZXBCJKY7PUGpnMKVzpfun9,False,32915000000,32915000000,0,2
193LFSzuhvLRaZpq9PJx977SKYVfmRCJLk,False,9866000000,9866000000,0,2
1LDLcQPxkvr8m8CNtoE1MyK8LvmfbpcKgu,False,9861000000,9861000000,0,2
1Jfr32X5ygR7LFKLcFe1CChSVY2H4sZyti,False,9856000000,9856000000,0,2
1JsHVVvE8vk3F7xrKCnPme1bT1g9pzSAvs,False,9851000000,9851000000,0,2
17aMr9jKomsNPczRobNKwHhFBY9BpgFKo1,False,9846000000,9846000000,0,2
14y7ptaw6XsTn5NjmxE286wpgw47aEnJyQ,False,32288000000,32288000000,0,2
19fxddEn6kFUJSnwMS5AfnBrpXcGy7yiXc,False,10000000000,10000000000,0,2
1H9TqRd9tBAcMXS5oiupiK196w9GyoFBGR,False,37338000000,37338000000,0,2
1GEB9PFpwsvTaHB67vruuoURttRk66Uwbt,False,4698000000,4698000000,0,2
13NmhzSKW4oGKyDRF5ZqPogdYviiqUMj97,False,3983199995,3983199995,0,2
1JWzbyeD9icW5yHhm9HDPeetpGbDmuNNjh,False,4854000000,4854000000,0,2
1Pxyvx9wU4zk7V5dX4ZoenYB9JUh5A1p6n,False,2499000000,2499000000,0,2
14xWBoHT5Q9vmT3ayL5msyViQC6dXFdzc5,False,3646000000,3646000000,0,2
1FEaHBmduMenpEyj1Y1aZqvhfENjemE9SB,False,4697000000,4697000000,0,2
146ZzPgoTNzwzZLT4g7eg6ohMDBps2Uu74,False,4494000000,4494000000,0,2
16a3Q6sWBtkvbJFmzDFgA6mboaZ93qKoqV,False,221146000000,221146000000,0,51
19WYajkV7CnwbR2MfpoNQmVV3BMd3XoKbF,False,3890000000,3890000000,0,2
1HSAoHX2BheAyKEWzAbCgmNFnQ43YXsJCK,False,2365000000,2365000000,0,2
1BKU68twwqZ4t62GzU5fBmuX4Q1G6BLdew,False,2237000000,2237000000,0,2
12QfNQjThwMwHxJDaXYK8AJdnELfxgVqr3,False,2120000000,2120000000,0,2
1M3zUz7mtgX2riUMrntwMJjrkTBKxwPKip,False,2008000000,2008000000,0,2
1AreUhy4HHLnD8UwxshsDz4iMf6SFYsQNE,False,1904000000,1904000000,0,2
1BYeU3CzJhXwJYWoSbRVucNMJ5gyHWEsvm,False,1837000000,1837000000,0,2
15Aq9M5Y8Q2kpnAdXjaTXGoUV8c2sAgrEi,False,1783000000,1783000000,0,2
16g9QQUi2GDcNG8B8Jc9gmg7U38PnBPMEH,False,1734000000,1734000000,0,2
153VRkh1pDnSk1PKDKLUVNWD3PyuKzR3Pi,False,1695000000,1695000000,0,2
1LsbA7Et1mfhNKGHaitnQMUmrQ8969vJFP,False,1659000000,1659000000,0,2
1CgPu4dvsZg1gPjXy7aX3BGNgCSL88pZvu,False,1637000000,1637000000,0,2
1Gs89Cs1cDAr2s7BaHYTje1UPM1Y2Ku81T,False,1622000000,1622000000,0,2
1FsKWFPpGDDeePGxArgnZMhUzQpK34wv4k,False,1613000000,1613000000,0,2
1G24jWw4MdeSZ1RRRawELVvuy9rDVsn2Xg,False,1608000000,1608000000,0,2
18ErYMDfvuep1g4qvUyJTgJYPC4k9GEdet,False,1603000000,1603000000,0,2
1H9agVJ4TCixxLRoLjx1RUxvBy2fCfVBQY,False,1602000000,1602000000,0,2
1PAEJams9i9kxVnPQKGdNL2v5ErsSFwuDi,False,9841000000,9841000000,0,2
1EkDorvc4XCB66njwgcTo8hEDvY6rvvP1W,False,32910000000,32910000000,0,2
1FAifHZcxdonuWESbc5MBUHq5ncYp9AgEe,False,9836000000,9836000000,0,2
16EnhfSz2u7tn5c1F6QDiEawAzpZ6M9gyX,False,9831000000,9831000000,0,2
1AkkyqwUrXgDKyAReEPqky4XsUpygpy5cR,False,4100000000,4100000000,0,2
1GGKELaoz3m4eoUa5rq2f4S8atFVGusrdp,False,32905000000,32905000000,0,2
1Mpz5Vwxvie3mUXWWnakoW4jHZYZCPdmPe,False,9826000000,9826000000,0,2
15oo85SHfkzDwo7baXNurTMXirdyrML1Bi,False,1440000000,1440000000,0,2
1CToChq6apAvrRcQjKj1WxbnfEpTSSp8yd,False,200000000,200000000,0,2
1CVuMX1yEMhoNxV5ZGygc863aZYHtr6zb5,False,9821000000,9821000000,0,2
18pfQggnohre4z4Ja6jmzi73fPWFshJLM8,False,81996000000,81996000000,0,2
1B1TeSXpEMV84FeCSoAPZV9x1YiuetaocC,False,32352000000,32352000000,0,2
17CMYvvZ3PpcWB4ntJxJqgErdhURW3yRW7,False,16950000000,16950000000,0,2
1Dj9aaZ4RrDWrHgqEJZefak9BvGDwEMWeJ,False,2111000000,2111000000,0,2
14yG4TiTjCyHc6ULvdhnn5k6PekU33xP83,False,4830000000,4830000000,0,2
1GVnPhMvu1BPvGNGVitrbrt6vHjwsvqdSz,False,4677000000,4677000000,0,2
14LqBzwh7XYxVbMSL3ScyusAREF1kjBk4B,False,4515000000,4515000000,0,2
1GcyDUZGUZGXxA71MRGaVhK5PAcEj34cAe,False,4254000000,4254000000,0,2
172TqNZpk2smdLTj37d2s9PE5xDrtWy2MM,False,3684199995,3684199995,0,2
12npMzQQhVDNFr6enQJLG92iMhPX12ykDG,False,3574000000,3574000000,0,2
1M9UwkyZ33728pFXbDuW6ZqFvmcDfJWgCj,False,589000000,589000000,0,2
1P7PAfSr7WKtGtnmcobdPMDsYEQsDu9cqa,False,3057000000,3057000000,0,2
17obcFE53BrwdnknNR8C3dvGArTxVAgHL2,False,578000000,578000000,0,2
1CL4hr9zqJHsusohi1qoAQSUq7uEV22Crz,False,625000000,625000000,0,18
1GZrXC6LgSZ1M1nEycuXa6XvKYfBgjbLVG,False,9816000000,9816000000,0,2
1AvAtrahbbXWdFHSA6zC9mb64esrBsRUw9,False,21388974673,21388975673,1000,281
16rbRi7oQcWo98AFg1kg2JUDYFw9GQUKzg,False,2935000000,2935000000,0,2
1CHy7j239umUk7UFRDnrx1JtPcUaicG9Gd,False,419000000,419000000,0,2
1BfUGvffHKuZTMGcXtF1F3Eps2FQvo2JzG,False,2823000000,2823000000,0,2
1CtsFfBvJZWnojgRQomGvcVjj4Ya8YTVKo,False,272000000,272000000,0,2
14nUr6EYDKsabGoFyAJCCt3hRLpJdbHN3x,False,2719000000,2719000000,0,2
12bvxEA3KH7sNgjfJV7bRhgCNBfBxghLfc,False,141000000,141000000,0,2
1DPnNhgCAjWbEGz7f58HufLBsR16vKeidT,False,2619000000,2619000000,0,2
1Bhftad9jvFPQbY3yw1fANQeQwqF6pSrnd,False,2575000000,2575000000,0,2
15Ki4ZEJyWsBxGeb5tm5A7zw1q5gan6gig,False,32900000000,32900000000,0,2
1CktfgospC74tVq6vremS3ZRVomqVefW68,False,9811000000,9811000000,0,2
1EMfUNBt7zejetBPhmxyiaWp8Ax2EC4Tzf,False,2532000000,2532000000,0,2
16E1epwC7gfjsmarHtvifR2uka6nWGkpbs,False,2494000000,2494000000,0,2
1HVXMUU6RWqfDsbXuwSUyFeghU1kh372zr,False,2456000000,2456000000,0,2
1NfxZniGL5AVTHxQFr1RfesxeepmT1vRrr,False,2419000000,2419000000,0,2
1LfyF24gwAsSQnTkatfCTJXCWccFzrnW4F,False,2396000000,2396000000,0,2
1DNdJ29bfchMUctTwd1mfeLLzu4uTJKWEU,False,2374000000,2374000000,0,2
1GpDiY9PMuG4fF56DjuSMswC7xVqH51h7D,False,2353000000,2353000000,0,2
19pqUT2xBSqrug9qwTLfV78n9ShaVqkfdj,False,2341000000,2341000000,0,2
1MbUxdwZwuxTYuS6KypiWrRqZNKyrqnGBV,False,2335000000,2335000000,0,2
17hvihzz8vUm3rizFg9bsYNjNhgBDvyJdD,False,2329000000,2329000000,0,2
13EnJBFcGk6DBNAjva7ez7HYirzvPd72q9,False,2327000000,2327000000,0,2
1CaATWzcaZUE4upeKe5qwqBhasjJRQTyfb,False,2325000000,2325000000,0,2
1B7EysEwZpfVBo4GxyD7kvZPECH3iHcgFC,False,2323000000,2323000000,0,2
1PfXXkR1cVcQoR4UPQCyh1ynQDqDKAAnZm,False,2322000000,2322000000,0,2
1MxY5hoEXBGnSkXQ2jnLshheyfHiP2ntRV,False,9806000000,9806000000,0,2
1PDPVzF2qRvuFyVUUojGZRTdUZwmbeH2vC,False,32895000000,32895000000,0,2
1SFQXcUCVJX14fDc23LsG7zep6jCZ2kiP,False,20000000000,20000000000,0,2
1Pyi5SoWPeqY4ekmxH7i4ypC4vCbBWfPgo,False,9801000000,9801000000,0,2
1LxV7MKTHPFt8yhdihEKjEAwWafnp62ZoH,False,32890000000,32890000000,0,2
1NZTBbqxWcZwc7Nc3e1pb3dsvdxV3eyUiy,False,9796000000,9796000000,0,2
1CQYStFnC5PabUCHXtrehxpsootu3ushod,False,9791000000,9791000000,0,2
1HTttXrsQKFcYoC7zRSa7yzq55JRASyWPz,False,9786000000,9786000000,0,2
182pffDgtLwiZm7VL4fmnf85FhKotAjMCa,False,9781000000,9781000000,0,2
1B1dJd3iTYG7iysQVHhZaUh7JJhqMRg53u,False,2500000000,2500000000,0,2
1848ks5ry2jMF3gBchYTVNrgN5gYUQENK1,False,32885000000,32885000000,0,2
1CbsfJYP8n7xGiiq3PBNBgKT1mDLpjtbPe,False,4890000000,4890000000,0,2
1Fx4258Fp81AKTnapJWk4PXhcPJBHvtxAQ,False,4696000000,4696000000,0,2
1FtgF7LMtgBjgY8KEyE9PHtz6fb5avZGU,False,4521000000,4521000000,0,2
1NCXYkzyMrsAbXanhtoxMJWeLV73cAatRg,False,4349000000,4349000000,0,2
1atuEsQCvyH9xkQQotZ3q4SXghZjWgRb7,False,4073000000,4073000000,0,2
1QFhWmfbhrEGpdPT7jgBmPMik2Kvga3G4f,False,3466199995,3466199995,0,2
18zv8oiE1Y6GXobAneZHQrsvMPnt69ZsGY,False,3349000000,3349000000,0,2
172Y7Bn8gj1ABcCFyw4PkqXFjroqzjc4Sc,False,32880000000,32880000000,0,2
17Rd7u6JdM9YYLLu3dFSrpS5aLhuoqzjBi,False,2085000000,2085000000,0,2
18yoJzteQf7z2vnA8Mdyd4yPrPFzKevrfP,False,9776000000,9776000000,0,2
18JZqv1ZqSwBqw4ceULWvzs6MBWcBzDzBg,False,1976000000,1976000000,0,2
146Y94nQCPMwrvxHTQ5XPVhW4pxQ3GukGp,False,1869000000,1869000000,0,2
1Q11SY7Ehi7dtqRJEoSUUE7su1XAmVxsD,False,1762000000,1762000000,0,2
1B6dWA7CeqSMbPdmq2WDMQPoGggbZZhcnN,False,1662000000,1662000000,0,2
1EKLZVr7hXXinjsDPnzGBq2GhpLVJ6XGMp,False,1570000000,1570000000,0,2
12bRpxmq4KHYXqWzgy4LCGRi7fCBFNcLaE,False,251000000,251000000,0,6
1H3hV3aiYNZzQea4P7YRD8ZdJTzSqd8QVM,False,1519000000,1519000000,0,2
1APhrNHBFtYQzPdFYzqaXhpL7tRCmm1a7h,False,1470000000,1470000000,0,2
1319qMP2KKcGDrnoy1zXv2UxBGyZfixhWU,False,1421000000,1421000000,0,2
1LLDJQmGdmPCupmZfQ8eDdap8Mkua3AEne,False,1386000000,1386000000,0,2
1NYnx7hnbovdkKmRct4tmCSGEvdm5Dk4Gm,False,1358000000,1358000000,0,2
19EqCBm8EnhEWMfc3bWUEfvmDKv7wupLvw,False,1352000000,1352000000,0,2
1JneS94cxrLhJHrXuqBqEaJWYWfPFfVUUJ,False,1350000000,1350000000,0,2
1Cfyo9gT13HHCZjaejzLp45qqyGi6waG6h,False,1348000000,1348000000,0,2
15ZcHP3bb2YCPZQBiqHauvbFF5tqMhbMA1,False,1346000000,1346000000,0,2
19Wv9hygFCh3YCP1u93q5oYDixeqVniAX7,False,1344000000,1344000000,0,2
1NK1463c93FKu2952jrbFBesVJDCpycTb3,False,1343000000,1343000000,0,2
1NMt95tSvkPCF2gukKxLAr7oWyPdW2P8gb,False,9771000000,9771000000,0,2
1HhxiFw67cAnJzipFcSbYToJGfSayuUsC3,False,32875000000,32875000000,0,2
18R2audxhhXjQmcbfTdt33ErU52wFG8Yeg,False,9766000000,9766000000,0,2
16z3qcLqjymHAKeUh9dFB2hmJpcGmzFZLt,False,9761000000,9761000000,0,2
1Hac3Mk96Wmy7rz4X9xAEVBcdhL75y1WoE,False,9756000000,9756000000,0,2
1MznTjDS49j5haZhzGxkTy99rkQe1yEjuy,False,500000000,500000000,0,2
1AtJpUdVUquHq2mLvkTsvVwYEVZL4myGir,False,4839000000,4839000000,0,2
159vdkSTFp7o2VBqTdWb2a8BTn2DGz3VqA,False,32870000000,32870000000,0,2
1KkYqjQoNGv8f8z7ci8tiKbiUNZGrkJNyR,False,4726000000,4726000000,0,2
12vXGgmW3XaTahDUmnaJtPztD2cYM71dVS,False,4486000000,4486000000,0,2
1JjW2Kd19Vge1RbRSKKWLrfZXhiaFbDwMw,False,4256000000,4256000000,0,2
19V39rSZyAkz5Bcmwtm6931dXsZDHUWMM5,False,3736000000,3736000000,0,2
1566HPEzQEZAUawBD5QdnCvQ9QM6fVNLzo,False,2828199995,2828199995,0,2
1Ju4ZnFuL9R184xnnqjVzaWFFHhRVDr3gd,False,2636000000,2636000000,0,2
161sTbMLdQd9GKqd5ToaKuVkTMNcqsCcjb,False,9751000000,9751000000,0,2
1PNRopE7Zy95i4w9NeYStvH8WdnSsivBrm,False,387000000,387000000,0,2
1DYfUyP26jYDAZMYnn7hDersccuvzViXdu,False,2502000000,2502000000,0,2
19tN1mLPtyaZQjyPaUpFpM3NUMskVBDS3M,False,230000000,230000000,0,2
18LBbJZzEmJt2e1MkKBbcwgxzpG8keJdwH,False,2373000000,2373000000,0,2
14DdnSLwsM5KcX4tjPNtycVKcGoKm5JZgJ,False,79000000,79000000,0,2
17An8JrqtrPMQ3BEwvithLALHpbHRQZanT,False,2251000000,2251000000,0,2
194avrtmTtM4kC1T9kKvWNyFQUpUPs6NTC,False,2148000000,2148000000,0,2
1GnLQtmMFiWnQwC315UPp9yyreqA53FK7f,False,2047000000,2047000000,0,2
18H5MaG9xizN74QPEdUh5puamvaEd1xQME,False,40430000000,40430000000,0,83
1P63kYWu25v75bTpcTdfzhzPaBatssSUyz,False,1946000000,1946000000,0,2
1Pe3d1tSJZd2LJ3vhHmUYgqUj6rHv2MA7L,False,1855000000,1855000000,0,2
17diynWAy7ze9Umvc9TKdUh1edoPLUqges,False,1811000000,1811000000,0,2
12PFYtsKnaJv5HqyjD6usmMe2DrNDcpaCU,False,1777000000,1777000000,0,2
1BgQrVdViqxc29GRYvYqYchVFZyocg4XGv,False,1750000000,1750000000,0,2
1BpVmYLmiu7kRb9JRhqW7PC9HnPQKG96wH,False,1738000000,1738000000,0,2
15PB1tEeV55ygg89yvGQYZtp729YxsgPyu,False,1729000000,1729000000,0,2
1AWNV3d9GriKFxPy6AT6SYo96Xu5A99U41,False,1723000000,1723000000,0,2
1CRCF7qQPV9Sybe5RUN9ZcsQfqbyXycqyR,False,230000000000,230000000000,0,2
1MeWY34HSdLCqj5MReGJ59fT33G39CY4Ej,False,32865000000,32865000000,0,2
1EkU9oeVda9MtoUj9FhjsSnpRF74YauAZp,False,9746000000,9746000000,0,2
14pJ1XH4Csj6ThMhrWBZENxRg7jTcHhTYP,False,9741000000,9741000000,0,2
1rZ6QRwfoNQ3av1Da6yHrwXmwa8k81iVR,False,275000000,275000000,0,12
1P24Z5BevjaiWUujSFZc7GKH8sgRm1wuNL,False,90000000,90000000,0,2
177mRyjQU9nqxBbYH1T3sR4QJCg6oDnXv9,False,75000000,75000000,0,2
1J58mJj5wnjyhhmdFdVew9amSvzwkVh5dV,False,5255000000,5255000000,0,746
1KrA5t7dBK8pn32j5k5K12TurGgdyFf851,False,50000000,50000000,0,2
19mW9JNJWCWkiVWLGMeHiF6TA9ZUCgWgT8,False,9736000000,9736000000,0,2
1EosXpCFx2g9ESH66o8T1RktMZayrBMQpg,False,4878000000,4878000000,0,2
1ApkgmWe4PRkHMV4QCZQnJACH3fadu83C5,False,32860000000,32860000000,0,2
1N7Jf8RNoJ1nCvgBx7qYnWZMcxmGuvhdGk,False,4705000000,4705000000,0,2
1JjRD7xWHfMuVjNLr9kEKYwuSKksTbqZ2U,False,4587000000,4587000000,0,2
1EUuBkLiNrY9SxzNJ39XXqakZSXuRS8hWE,False,4302000000,4302000000,0,2
1E9fFNV5ghtee5yvQzB7QMqfWeEvnH5ymk,False,4063000000,4063000000,0,2
1HUqCzhqpkJhYe1o5F5cTbjCtJQbecfZaT,False,3472000000,3472000000,0,2
17py8V84EAz7bmJ3e2XGpo6TsBxp4cr8Am,False,795199995,795199995,0,2
1Kvam4KYnMfcLdTz8NkuenXCcpm5opNQYy,False,1202000000,1202000000,0,2
1HmQ7rrt1XHFmfe6ErRFzRjvTGurm6YNHc,False,9731000000,9731000000,0,2
196idocwB3d7kwBGZ7Z2N5Hn8Fi9616qkG,False,3101000000,3101000000,0,6
1Hx6tzRNb6k383ia1BWM7xfM82acSuibJk,False,32855000000,32855000000,0,2
1LcCEsxmGRWFAsuETmAGuWDDDSDQPTmyMR,False,9726000000,9726000000,0,2
19EyFPzLJqjE6PBTir2bFW9dG2zLWni69a,False,1182000000,1182000000,0,2
16P6sqZFoHtfuKiRdPEftvuHmL5Xa3xDmF,False,676199995,676199995,0,2
1CSVLLyroymwAkzTLdzidZ4iPLYLXhMicJ,False,1163000000,1163000000,0,2
1NgAuGGsU7jmEFE9M7dMSPDoweqffTN1sJ,False,559199995,559199995,0,2
1NizUj9nPSLM289cD215wepxVBd6UeLnaR,False,1153000000,1153000000,0,2
1ACpqtv9igeRd8tzDUezvqJWoxK75JCN78,False,453199995,453199995,0,2
1Cr3QyFiQyJ2YGosqiWczWEZoEWKDpbaaR,False,9721000000,9721000000,0,2
1JBjRX2DEoEQonRaTWooVaxip3qwLTNzrr,False,1145000000,1145000000,0,2
1KsSeTRuqSQfsf529jz2tkrtXxSPq3oRap,False,367199995,367199995,0,2
1BZeFGytDv8gpXNxbPZhSaGFQKGP7mKLbA,False,1137000000,1137000000,0,2
1GpXJ17a6sShE8TRmDe25rW1wzk6bx6V1h,False,287199995,287199995,0,2
1D4zA1yvRSFWi9rn9XM3cG2itHhqSDUojK,False,1132000000,1132000000,0,2
1EDBhYgjqmUAeDrWxqM3ELFibaH6rnB3gw,False,227199995,227199995,0,2
1DmopMeqXUakxFrSUGgL4ctRhouNaYebdJ,False,1129000000,1129000000,0,2
18ZKw7RetJtiPkDvvMuiLgMhqTS7u3EtYo,False,169199995,169199995,0,2
1BriqsWyiC84FkyFGXsL3S5wPdC4Hr2aVE,False,1126000000,1126000000,0,2
18sQmK7g9AG9GHpeSiMJK9S7Tmg1inEeyh,False,131199995,131199995,0,2
1DudytTeaQqm8t5rE4ViQQyTY1U8CynVS8,False,1125000000,1125000000,0,2
1ENMJVqAQJbNGouHFLTwfthvj5d6HwH1q5,False,97199995,97199995,0,2
1Q6NsqETHwU3Qkq47Lrd4KKtLMpHKuEG9y,False,63199995,63199995,0,2
1Ci9i4Ak5nvLk1ASBsxTb5Z6k5Ee9czs8y,False,32199995,32199995,0,2
1C6F1Y9Qcwq7Mk2Xhrqq2vc5RSpji5GLqt,False,32850000000,32850000000,0,2
12qaTvj9ecnCEE58cdiCbYPhcjPehJRJoj,False,9716000000,9716000000,0,2
1QGbzRts72eJDXvqm1ghCxc9gziu22g47k,False,1124000000,1124000000,0,2
1FVrTiRMAL7HbPvJhe7jCaByu2J2RoSKde,False,9711000000,9711000000,0,2
1JzQuimjEbXTPSkgTRJGD8vsHpsZz8EECt,False,9706000000,9706000000,0,2
1PL3Br3C9h1qW48yLd7hWcCFRyZww14RxJ,False,9701000000,9701000000,0,2
17wfxFmzU8oe7S9MGi2HAY5AK47mK8nUe2,False,32845000000,32845000000,0,2
15h5CPH8kXFYZy5nfVzqNdrG9ZeuyFMcve,False,9696000000,9696000000,0,2
12Czq8hNDRDS1Z42nf5QJrrFrFjWZ7jFa2,False,9691000000,9691000000,0,2
1DdFjG29mgMTcRdxt386W6tLCcmKyryN2P,False,9686000000,9686000000,0,2
142aBoZVTCmg61n1pLdKauzf94eUEzg8ux,False,9681000000,9681000000,0,2
143WGY2z1hcz8F6ALtvxVWecoRH6uGVxHe,False,3300000000,3300000000,0,2
16mdUAqEjovrGVHJBtCXQPtpomoQ1z8JzR,False,1771000000,1771000000,0,2
1EPRsh8j2kvDkaucYMWAcaf8tZrA9RtsRR,False,586000000,586000000,0,2
1Pa2QNjBoQoiyBDi6ECcAgsxkrJMz6Zonp,False,32840000000,32840000000,0,2
1CumHfcoFUo3rJuqL9Jo8snpCZNY45LQmH,False,9676000000,9676000000,0,2
1JAEPNAqPbeb35JXPrQp2SMWfnntFwJGk8,False,9671000000,9671000000,0,2
1AVnKLqdFGc6TAFcCCzuS9yzS8dNf5n29m,False,5000000000,5000000000,0,2
17Kd9bB2kQjG5JEbBYH4EwgGYJZTy7CHjT,False,32835000000,32835000000,0,2
134FhP49jwvC62H72nY1LbzsGzZkBG7Kdr,False,9666000000,9666000000,0,2
162eXtbaB8psdo1TiK5NP3hwCFFFfcwZYc,False,32830000000,32830000000,0,2
1NLYaRjcBcbL1rAURqbez8RreFMqjosZzt,False,9661000000,9661000000,0,2
13wd6ad8N2RrpFtdEWxH2thCZCnbib2zAH,False,225000000,225000000,0,8
1JWFBEvMsbvLsmBxNqWmrQEhQR7kTxecb4,False,4900000000,4900000000,0,2
16zytd1hharLvGsQTowDw3LsZkJnUH19WK,False,32825000000,32825000000,0,2
12j1FMftSSzc14LE8T1GBuS3QCAEruw4fz,False,9656000000,9656000000,0,2
1CxVqerMPsbZjF78ajfJnuf6sSfkSvgzqr,False,100000000,100000000,0,2
1J3aeqU5vNAZSSXxp4RsRcwiyNp14rqohL,False,400000000,400000000,0,2
1G29zDDUn13V8sQ4zU7WfV5ZbWjrspTff2,False,32820000000,32820000000,0,2
1JrHXDvRMd5F6pcdvf8NQLyhgnNe4iSUfT,False,9651000000,9651000000,0,2
1AGLgVHteVaaC2hoS6daP52DHYa5PTAhks,False,367000000,367000000,0,17
1EGinshRE5p4odJGRy6iHgCdHi1Z8NUoWs,False,32815000000,32815000000,0,2
18F3QKzkyqz9W4AQF7Hk9uiu8hB6WagWCB,False,9646000000,9646000000,0,2
18WVDVXPaFeGjqwRVJ7fEmuRerkVHMgazo,False,32810000000,32810000000,0,2
1M6rVUuNdGsKuKZ4aVheXJaZWe9L3uNQo6,False,9641000000,9641000000,0,2
13voFhUB4kfBruoXYAsH7d4dLM6xmxSYEk,False,9636000000,9636000000,0,2
1KD3E2WioktU9axj5VPYdHE529dAKvy53p,False,600000000,600000000,0,3
1MpRryXQahJmHbACoXFbKLNi7az1sod8uU,False,32805000000,32805000000,0,2
1VF74BprSzm5qbJeP7pzKqxkCCYjBWCCf,False,9631000000,9631000000,0,2
12BG4zRQije2UPgob8QQfRpoCV6uPAKh4y,False,9626000000,9626000000,0,2
1Hfac8DryuQNEmgFwQ3RfQYYaiKFwEcmeG,False,9621000000,9621000000,0,2
12eK2HGNwh2u7H1ETT1kTZu3QdoTF2UPfN,False,9616000000,9616000000,0,2
1bwQmCMiZT4QBRX4yxMJwZdtRie3HXg5K,False,9611000000,9611000000,0,2
16rHJgcY2Zjm9hpdooDNwgKoFDmPNvMV7r,False,9606000000,9606000000,0,2
1DFa6nqvMjkGmfkBg2s1N4pdJKQ8vEBchq,False,9601000000,9601000000,0,2
1FAkq37WaVH5yCK7E8tKf8BzBpSUFWtNRB,False,9596000000,9596000000,0,2
15gPhhySoLt3VgLWwrvFmXX4gmhdsiQXDt,False,9591000000,9591000000,0,2
154mDrLczv5L8NSqour44LwjNHJsKyqK88,False,9586000000,9586000000,0,2
1FAonKWpRabXazDt43nvEw3amb8PgnaSfZ,False,32800000000,32800000000,0,2
1NJXdeqfxKvu2EKCH4HonxN1zGXjBsB5kH,False,9581000000,9581000000,0,2
1FfC8aL6pxP9kdxn91gHyRZLpWJJupsPFa,False,9576000000,9576000000,0,2
1A7vu83GDTDYU7Hq7LcgHEi45wxbnwUmjU,False,290000000,290000000,0,12
12WSBxifsnPH4S9TGsc2HD9Y6YMUkg7J1j,False,50000000,50000000,0,2
1BmKPgh5afu1BzFddeu4Kj5CwZ2VmB7Wi3,False,90000000,90000000,0,2
1B5JscTpqrd3UvRUB1dnFd77CSL2ZMTHxa,False,32795000000,32795000000,0,2
18zANFoqybSMtAUqj36sUmX39GHri4SDL8,False,75000000,75000000,0,2
1Chikhyyg57dyEdqzpxt5BPMWWjj1wa6e7,False,443000000,443000000,0,2
14H1U2fWFtfkGCGd8ccamz2ijvE5mBBMs9,False,4423000000,4423000000,0,2
1KxFyoANm5ewJ95bwGLdCGN6R5ReipyUvi,False,4104000000,4104000000,0,2
1AZ88VFtixNMd6CB1bNEfbELVRa5KLL4c6,False,4874000000,4874000000,0,2
1B9HdBebwC4DMUFLaSumnX6ffgcA1Sxoaa,False,2969000000,2969000000,0,2
1FAwnhvpmFtnkenw7KkAWZshHQpLLPWAf4,False,2896000000,2896000000,0,2
1PsNJq6YHNf5QRg32tdck273pURmFmjAXV,False,3860000000,3860000000,0,2
1CT7RPbkY5rdLBw4u9MUQFtWokFu7wtfeq,False,4557000000,4557000000,0,2
14XWGWwDp43J29e5GAHhjEd7WX3sxiaiSx,False,4740000000,4740000000,0,2
1DZ2tL3HZatEMdRWCWEtwtsCYJZLzgzK1h,False,318000000,318000000,0,2
1Gom4KqSwM34q8x37vbngwCPekqZ83AZHG,False,2845000000,2845000000,0,2
1JKP8Y8JgC1SKhWvaytKPpAzB7mZispyyE,False,500000000,500000000,0,2
1NYeRLf9VyZsy8cTrW6CihJVWbAv8DeTSd,False,3000000000,3000000000,0,2
1K1FRVno6Bu4CEChVbtn3BCdAwtYDGF2p5,False,32790000000,32790000000,0,2
1Bu94UJEyKnR9q4pv8hzpe9AWWuhnF5e1,False,2802000000,2802000000,0,2
18hJVshMtxNv27omuhHyyoP4cjQBsaNbms,False,212000000,212000000,0,2
185wtD5QVPWT6i23f8fv9kmhADL7CScyrB,False,2762000000,2762000000,0,2
12Hde1FNRvMdbh5e8rSQrhEFFkZNzbs2VW,False,2723000000,2723000000,0,2
1KqLSYFiNvYzQSNydJK5eB1VpEt3yvZ5bn,False,118000000,118000000,0,2
1BXrGKhPk7jnV74UB1VbaxkAzWQgp6z4NF,False,2687000000,2687000000,0,2
1EUpxLW15sbswe31Nje3K9vaVFoodmtTcu,False,2671000000,2671000000,0,2
1MuUyp8hpA1hC8PjJs9m8F1eXbVy9ycFC9,False,2664000000,2664000000,0,2
12DmG9irHvQBoXfPRbr1p4xTP2Lej3TwDG,False,2658000000,2658000000,0,2
1CPpFkKPo7J6H1LByEj7QNgoQ6JzSvwDTQ,False,2652000000,2652000000,0,2
1DhxY5QT4kLkw12ti5HmU3ByoFgUwQT8d4,False,2649000000,2649000000,0,2
1L4UCHDJRHGFxo6mYv23ETcx3qVjzsScTy,False,2647000000,2647000000,0,2
174xjNSkEpLW4ZkMV6mdSMG5iXg9r1ddP8,False,2646000000,2646000000,0,2
1GW5RA2S7q1FvXfUAQ1PYedAd4wsobVspP,False,32785000000,32785000000,0,2
1WaEzYXMjT6gk4wttK2U4MirvZ4Yt43Zp,False,100000000,100000000,0,2
17ukLhfQNVNp9UD2it9a2gkbq3xX3JrgfX,False,0,400000000,400000000,1
1LnSbk4KDx8F2VAhUvoPDvbkdBjMLDF4z5,False,20005000000,20005000000,0,2
12DEyo28biS2Xbm6MuG1ZXJsa2Nz3JfjUy,False,32780000000,32780000000,0,2
1G6E162E4mnubGwDRRGmx7h4LKd2zKhFLp,False,32775000000,32775000000,0,2
19sq2gf3u89xDEE3yCrRkrknmrQP7M9CHc,False,32770000000,32770000000,0,2
1LrstdEaFkpBFUVUTHGFELPFibF1T6Gv6K,False,1270000000,1270000000,0,2
195jX6mgDwEYfHGHAWKH5WG7mBQENYXiXu,False,10000000000,10000000000,0,6
1DbWsbsHxGdusk44wmWKDcckfxvsQJrXVw,False,32765000000,32765000000,0,2
1FaPWHUy9gRuGV7AtkXkX2yrmGYy4x9ccB,False,32760000000,32760000000,0,2
1F9UUHhVSYHcBxZwW3MFUsyg2wDnxNginP,False,34640000000,34640000000,0,26
12rMZfgSjZjECjDtNWaPJLfPbPgwtP72wN,False,398000000,398000000,0,2
17CLY1QfckBwPUr1Xt4djeqXgc3nvRPRCi,False,32755000000,32755000000,0,2
1MTqhJjCunRRHk1UBQkkAJBc1BjRwvHpkD,False,1047000000,1047000000,0,2
1AvCNQRZ862XhNUk3tzcdhBvrqTyShnA54,False,100000000,100000000,0,2
1Lj8ZzoSVkakrt6GkpYChjqea4obaa8Ecr,False,2000000000,2000000000,0,2
19zdcMLDpponGM2iVTdW7fG6yMiSi4Up38,False,32750000000,32750000000,0,2
1Bku2FvBiRKgxDFknyexaNPaHsecUQXXnv,False,32745000000,32745000000,0,2
17CD6YpWsFEvMhUvbzfpW9cvez7M1QADvP,False,4820000000,4820000000,0,2
1BgsWMrG2HJr1rXAc7cr93DRyVSmdHw6mp,False,4693000000,4693000000,0,2
1HiKkAFn8Kzyc9Vx2D2kPZki5Xhm6NfmTj,False,4530000000,4530000000,0,2
1MXHxbzpEvu2AR8eioCj98NSxh9LRDuSEh,False,4224000000,4224000000,0,2
141La2ZtWxX43myQYfJfUyfgjUpCC4gYy4,False,4023000000,4023000000,0,2
14xrpnsftgwDDAjgAVdp14w64mPB4BWNAv,False,2984000000,2984000000,0,2
12eqD2szP6JZcn79wdcH7DTfj4LQFpv77K,False,2714000000,2714000000,0,2
1D7Q3rPyVGio1Wgm8oo1jZXBTMAcGcH2ud,False,112000000,112000000,0,2
15HjzCB68GzF4Zf17ePkgairrSa4RWkRgX,False,2539000000,2539000000,0,2
15t5Fu8nhw4z6iqpMGxXDiD1a8pmx1NRhE,False,2373000000,2373000000,0,2
1FUGtxyVF94KnN8658MrYBwueZNGfRnGcG,False,1579000000,1579000000,0,2
1DywvkKnPAEvQ7W35qyju2mZUm7wAH3Ga5,False,3421000000,3421000000,0,2
13hqpG7Vn9nNt9cBH5RY64yBGxB5axtjMU,False,2231000000,2231000000,0,2
1M3pqBMyivf1yjQmtZUz7XeYFNUDMpVm3n,False,2102000000,2102000000,0,2
1N3Gjo78zsap2chxtSzo8jGsJJU21eCiDu,False,1986000000,1986000000,0,2
1FmtrnvkLf8KcNCVxbt9Vzrsdqrw4Ya3dQ,False,1872000000,1872000000,0,2
1DPcew78MgAaNn2taAt7p9n5PkPpGUswgE,False,1759000000,1759000000,0,2
1BzQzLUzNSBzigVdm3VYnLWqt9UEcy2ezZ,False,1655000000,1655000000,0,2
13tLTpK9AqCy4RgPABzZqWbzVxfJjxG8m2,False,1555000000,1555000000,0,2
15Faj6BX8K82FWAAyxe8LHJmLbUBvoY4DH,False,1475000000,1475000000,0,2
19gtmcPFtzeMnoWBSGeWgkoBfY3CPBHBJ1,False,1421000000,1421000000,0,2
1PWV3RF3htFRsq5qc2uQBa6vdHTkN9vbbm,False,1368000000,1368000000,0,2
181sSptCCSPStMkDmSCBrHM5KNs41g2uJ1,False,502000000,502000000,0,11
14ZtB7sCoiYt3YSU7VYE98Wig14PFsfU6V,False,1323000000,1323000000,0,2
1P71FnB7rqkaL9bUNUqwri7QLHdRUTMWak,False,1288000000,1288000000,0,2
19KCTQpaufn53pe4ej5NJpw1ozGy2LqQMo,False,1255000000,1255000000,0,2
13SCq13mVoAEqP1PfwKeunXGKbML9Wx6Wo,False,1227000000,1227000000,0,2
16JusYzy7QjK2Hz8FCoB7XhXKni2XTd3w3,False,1205000000,1205000000,0,2
15xSM7taq7MLLTzTxs9SiKVKLZUnM5LBBU,False,1190000000,1190000000,0,2
18M6F7JjaV8StR3wvc7T4F4Bb1RrYrPEi5,False,1175000000,1175000000,0,2
18qRbmsjkBAsMrF7ymbBdEtFaXm6GcuNF5,False,1165000000,1165000000,0,2
1LDahS16YVDJmQxocpw4qUqHGBd97k3ugA,False,1156000000,1156000000,0,2
1AANkWyF2BYXghy3NR9KunwZwXBwteAfYo,False,1500000000,1500000000,0,2
1C7oLPipK6brEaxCvcnTiFcT1x1m8zkVpt,False,4400000000,4400000000,0,2
1Js8XS5tQLk4nVCwzfJH1zF9hGU1SGyFMT,False,113544000000,113544000000,0,30
1AuamTRLLJR1cqJMeBDDMUyYskt6jfYnk9,False,1153000000,1153000000,0,2
1K4N8bgpEaaAdHxWFE4wdzv3xwtXr1DSwJ,False,1151000000,1151000000,0,2
1FqztScjibLGKAUzdkMSnUWivLS2ajGepS,False,7440000000,7440000000,0,4
1HdNzy4KJZJTP5QbNnEDhxWqamE7NnUQTf,False,9560000000,9560000000,0,4
1P3EcFggMopZt6kMQKyjswwUSFbwx9XibK,False,32740000000,32740000000,0,2
19FuFSs6pVUsKrqUpnyRbZp5XGYSatpwUD,False,1000000000,1000000000,0,2
1HXHUuiSXkwVR3Yt3jQoH1koRjFAUPRPfK,False,190000000,190000000,0,2
1AMPMeTYWmHSxcswHfUJGJnehnJEoghYEX,False,32735000000,32735000000,0,2
1Kz4N26u7taaAa6SNwXnmnrzTNN3HpDFhZ,False,7474000000,7474000000,0,2
1FBPiLpSKpiYykVpz1c3jwHzp8m9AoCBin,False,1620000000,1620000001,1,3
1BG9PkjREkJCU5J24b7Ap8EULqbC7Lqonb,False,324000000,324000000,0,2
1JQT8s2n9TpAEf2ZrQSW5nQ6Hye2EsBBxH,False,5485000000,5485000000,0,2
16BwtHmCUkUwVTfF3GoKEELow3R6zmP7qv,False,32730000000,32730000000,0,2
17ge1yhumnfBm7UyhdSQTCVDk9Rb2ZGzdu,False,2747000000,2747000000,0,2
1CgdcHacPNgTQsBJqjgyd8YkJzm7m4Ptjg,False,1200000000,1200000000,0,2
1DbDKef9F2YkVAtDHz1KEF9qoKXn2jYcry,False,390000000,390000000,0,2
1HDcd9Cx4aDt6coVZvxWVgSU5tydXULi8K,False,2544000000,2544000000,0,7
1DfrhkZTsKevqyeCmquxMYmv6huPK5UxFk,False,390000000,390000000,0,2
18thRfi7pKSHyqYDkD85dZDxdmmPynjjDq,False,1110000000,1110000000,0,2
13aR1nWATwjq52Fbvipmy9w6TQfmVXxjfK,False,1110000000,1110000000,0,2
16KWimgnLrYShQFXrsu5YZphzUK4hzAFSJ,False,90000000,90000000,0,2
15VmbbyvpZQk7P4Vs7EvzYrGbtKTnW1f27,False,20646000000,20646000000,0,11
1K7usXDYRJjazXWKj7u3TeKvVBo9Ub4DXS,False,4900000000,4900000000,0,2
1LPGGeZhXwZpwbDGSjNEwkMTtNzDLgbijo,False,10000000000,10000000000,0,5
1AvSQVwo5ewNACNaVfNPzUXTYuPZvnVYdX,False,32725000000,32725000000,0,2
1HvF6pgXvFaxE1yL5Vo7QtvGeqC8Vv4BRi,False,1240000000,1240000000,0,2
1AMu5N2emQSiT5ZhadcBeZSsjs9ED2rGCG,False,11452000000,11452000000,0,2
19fArz4KPFs81z9vDrK1QJLqhExHPwDDUE,False,0,641000000,641000000,1
12L7kF59Ek7nY9zrm9JLtxbjWG4M1XrB4u,False,4049000000,4049000000,0,21
1BnNWfpgH8CPTvpaq6Za9c9ngpBkGS3kAL,False,4895000000,4895000000,0,2
17Xbo6UtPaVkkgiXiKfGreCHTvrybSmm8y,False,2000000000,2000000000,0,2
1AtU8hcnswyUQCJCCfZc8BVuQcdvNwqSL2,False,4707000000,4707000000,0,2
1B65WhQAFavQ24CAjhyTNC4guaQkttTesD,False,4565000000,4565000000,0,2
18wKh5keQcw7JsfLMCoL4BZEPTLRGtSkKZ,False,4385000000,4385000000,0,2
1KxpvfQgw1MobiBGhMoYKYCxoZGp7SCKuo,False,4019000000,4019000000,0,2
14bgrxUgkAnrPheFotw6H3qtTMVwEXvp7U,False,3790000000,3790000000,0,2
1DurqTDFDPBoGu2FgbmiWcb7sYVtMJu1dq,False,2471000000,2471000000,0,2
18XhYt5pTeK5eGHbVeQpswKqwGpvVFKbkZ,False,425000000,425000000,0,2
1J1zV88sK91fN39Qt3rmLCjAQhLCTLWYJ,False,2419000000,2419000000,0,2
183vqNNgUSdVj7mkm8TgjVX2pJ4eihtTg4,False,325000000,325000000,0,2
1DCRuAJxWV2YBhtD52mq7XTDsgy6vwwCuS,False,2385000000,2385000000,0,2
16bdHFeuxKaa4KCwk3GMbAbwDEcfS8ytv2,False,235000000,235000000,0,2
12P4W5uN5GhsjMwrSkXCKQ4JWETug6XSxv,False,2353000000,2353000000,0,2
1MqQFjr2GLLUGNPSgWwTmgMoo2tuAPqyWA,False,173000000,173000000,0,2
1DLAi5hxPvJStnCqyZkBx7tsiQCe63nxFg,False,2325000000,2325000000,0,2
15ZFFkcLf98chMGggSSoKSBSHXpzBGNA84,False,113000000,113000000,0,2
17QuSSjoQKiHduy4amaE641GXFBk78JKFF,False,2302000000,2302000000,0,2
15Nk9G6TTrHZEwQT8AoqcSqexYC3E9gmoU,False,20005000000,20005000000,0,2
1MMxgCPrYFaqSYDtTjXu78mBNfTPFBMHSW,False,32720000000,32720000000,0,2
1FRNf3YqW3GetBSxfC5xhdkwV4yWWZE2Sk,False,5161000000,5161000000,0,2
197GvWP6CrC3b9njC6BHiXFJJ3iwd3gsLe,False,324000000,324000000,0,2
1PtxSfk9nSL5j96BxGz2vGKu7KpK7CxDHS,False,2286000000,2286000000,0,2
13h1fMjdGn5Hjh5w5UaPnHEfou9zxdfrfy,False,58000000,58000000,0,2
18Uy5C65wFgsxoPAZ5RRym7Tpxq3rLJFDi,False,2276000000,2276000000,0,2
126bMAWKb9JPt4Rc1gTvtoF9bew1SA8Uzm,False,7131000000,7131000000,0,299
125zsRRaoH3C9BhLsA9GGLCCAeTMRe8Abe,False,2270000000,2270000000,0,2
16ZsvWbksavYCXhr9fnXx55d2ouV8KXpJE,False,32715000000,32715000000,0,2
1FD8MwJxMbvCRMuVQttEUAZrhjW5wALpEN,False,124000000,124000000,0,2
1MY2iYbau9oqKKUvChmM2UjeXEXrDLkLgp,False,93000000,93000000,0,2
1BrzoLjNEhir3kKoJGf4kGstcANZSsxXeE,False,4865000000,4865000000,0,2
121zBDRcKYdYcET1VHzwvpwkTaWHSgscLJ,False,4742000000,4742000000,0,2
1EUxF81a3jyZXvjNs2yEcThhQgejz2WLQB,False,4530000000,4530000000,0,2
15A4vxkLNzvB9CNpVqXP5ATHy8F45VApdU,False,4377000000,4377000000,0,2
1HP3onwLPYbmsrAvUr2ouu43sja2GRnnhE,False,4190000000,4190000000,0,2
1QDE1DVrrcWV7yniJiHHSxowXjJBmLyUrZ,False,3786000000,3786000000,0,2
16uDcEwzZgHVxxd58ic348mPWBBarbpSZ8,False,3250000000,3250000000,0,2
1Dae6wBxRkhy4tCP2VRnwoAaR8YGv71RNE,False,1222000000,1222000000,0,2
1JCu6RxWPQDi7BZt68cZpYqErGnfnd7UPU,False,1101000000,1101000000,0,2
19iCA7mthJrGqqcyZTUTbBYuhnWYYKtv6a,False,32710000000,32710000000,0,2
1LTCskhKek2J2C3RsdDxvhidwDdBBNihAA,False,220000000,220000000,0,2
1NiMMTccL4wTY1txp9b8kxT4BCUBR2Ww12,False,2000000000,2000000000,0,2
1G7cKNWBpUQNMSm9Rg3VqDZbqq88D1T5CD,False,50000000000,50000000000,0,2
1AJ5E2F95VWwMSY7igDxXU8J1166drSxz7,False,50000000,50000000,0,2
1Q6zShYDev5uhK44oNuTsNmUC2DEKHcGvX,False,66250000000,66250000000,0,2
1Mn5p9QBfaWJPsY87fSoKDeKiAcFWUUJEQ,False,199740000000,199740000000,0,2
1HvV8bUgvF2bFv8926CdAiN3VzMx4sJ6RV,False,2600000000,2600000000,0,2
18TEvT7esjhPUAQVyv7NTz9hesua3jMXNJ,False,4900000000,4900000000,0,2
1Lo92FbHF71qPrhqTPz2hU5msxbrz4gC2N,False,4723000000,4723000000,0,2
18ShvDCJAHe7J6vqQowaNSU4GFC6DBwNSA,False,878000000,878000000,0,2
1HdYQRuTAke86gHDvh191ndVdnxoB8aKyg,False,1500000000,1500000000,0,2
1HAbTitaZgNUbApf4rzb9RqZJfsH5FowTe,False,95000000,95000000,0,2
16ttMhGucWUK4boqdMt4XXPy86eHRQwzKW,False,792000000,792000000,0,2
15SmPekZMoLW5EAYH6EAi1oDxbiv3M4Bap,False,10000000000,10000000000,0,2
12mEvnSSL7SZtwf2dUU1RggAUgTsTbWgPb,False,20000000000,20000000000,0,2
1B5F5Xu5Z38QcqBWKm4mDg8H6Ft5B2YR1y,False,4770000000,4770000000,0,2
12yivd5TFCsvk4VQ4dxLVdfCadWcwEnJSR,False,4783000000,4783000000,0,2
17ZCry1eruQU96seUTwyfS9aiDmX8x7fDt,False,4594000000,4594000000,0,2
1Av4H6nDTGoAWQJLVJkGZMyL8x6AD8NKeE,False,4346000000,4346000000,0,2
1L19QmWQ1ZRV9G2dGk5uMmEeCHLDADYSL5,False,4103000000,4103000000,0,2
1B5MRuyQTfx7vai2ak2xYytDuqhSMFruFG,False,3837000000,3837000000,0,2
1KvxS1F5FyNXqQD6kuXFbevdMNJPsRbrbz,False,3582000000,3582000000,0,2
1NgdUNxLQKBEswjLyjqyo7vQCn53LC43Sa,False,1887000000,1887000000,0,2
1DQBUe5kwFLeQ4Erms28X8UoSAfDuKZCxv,False,102352000000,102352000000,0,23
1A6eQHbzmSSZwGE4TabouQiySrQmWLoBJV,False,1710000000,1710000000,0,2
1EvPW623kArWC8bjpDRC19ttAeDxLYSx91,False,730000000,730000000,0,2
1EvdCtHoRhEbjfbqzgFQjuY5umKzpbStvG,False,1536000000,1536000000,0,2
13MVfYYAxP1NbpGLcPLHRqQdnBfHjrDYVU,False,674000000,674000000,0,2
1ExW6CigFdofpZkyQvGXwSrevNhYUuDUJs,False,50100000000,50100000000,0,2
12UYsRw3ifrcMi6ykp4Cx7HQEDWgBDgTwq,False,2769000000,2769000000,0,6
1LxVnP2U2DGyaBHrR4Z18tFjWg6FWDNnCo,False,142000000,142000000,0,2
1LNPLBGZBe1HokbisD72x4dxheGh5hiQcY,False,9341000000,9341000000,0,2
1F3bYgqgYTZHvUNcApWbppxJNoS8swoD7c,False,1365000000,1365000000,0,2
16soZ62X54Pb2pWRoevj89D9UaJefVn9Pa,False,637000000,637000000,0,2
16JGpQY6JkMSzh2YdbeeEHPsYypE1GECPz,False,1195000000,1195000000,0,2
14peogQga7vHeC5yABJBh4mN9Gmx7XnxxD,False,608000000,608000000,0,2
12js2mnr4d2gpbvXxGvBU1ijkhMo619T2o,False,32705000000,32705000000,0,2
14WT2ccyAprZoHqNj1HaEc2qSou58EVW23,False,9336000000,9336000000,0,2
1K3UaoD5biEuSfa4MzC4AjQ1Ro6zPWycCM,False,1057000000,1057000000,0,2
12Jz39NSno3y1hFHQPFymYyQTcT8ScHtJV,False,582000000,582000000,0,2
1BL7ELTVBPL4yx5ARV4aVzDpBKwSHwTwQx,False,933000000,933000000,0,2
1BwfKBumuDtSnpGdV1TqdmgUetBQRerX4D,False,558000000,558000000,0,2
1BhW6FJrmMbdBduoN2NkcGMDckHpbFB6QZ,False,810000000,810000000,0,2
12EhyFnVFGWX9Qmxtfpn4BC9onsMoa3Bps,False,4452000000,4452000000,0,2
1NLmHG4uNwLbS3W4a3xmgE7SCfzffJDtbG,False,9331000000,9331000000,0,2
1LbdV9jZnmJB9TyWneXUXrXz4Wdww8AFj9,False,536000000,536000000,0,2
16VmQgPZNeKStbWsmmPGTLm2yD1tr63hb6,False,694000000,694000000,0,2
1M3FufkQT3tX9zPD7RpTLyvkbFKapwUhwZ,False,521000000,521000000,0,2
1JtvK11fcBxUShcu2wLKjNJjm4xMt9CkBe,False,293000000,293000000,0,20
1MAsmwj8CoFx2EukwA8Kpnman5GCWBkamz,False,584000000,584000000,0,2
1HQAXfmsZYtVn4GgbEDNVH2sjC8WGrZPPZ,False,482000000,482000000,0,2
1F2UabuEAndqVrSK1XiEyzLyfDfp5XJu6r,False,514000000,514000000,0,2
1AUWK9ujiHtNofHeAG1EUxpADkbSuLRLt9,False,419000000,419000000,0,2
1DadFXqjepRg3i295NEr2fGMDh8yJarE6t,False,509000000,509000000,0,2
1D1BpHdUuww9cRKyLNACo4jM6Wjrsw2nZG,False,364000000,364000000,0,2
1CeEfs2MFdx4214RWdPHCMRMhiuPmw1vGY,False,306000000,306000000,0,2
1CSWv3UKQuBLqA7EWQCZJbEiFYW469QfQa,False,325000000,325000000,0,2
16dBpqsErdidc7XUNhBjyYADtEwmhadmzq,False,847552143,1230552143,383000000,22
187HkYJuB66S2Dfvco8mYeq8cy2zs5kwVo,False,293000000,293000000,0,2
1PYt3819VvMJFW5Q1T8kFsLWo4wqzFgCEr,False,262000000,262000000,0,2
1GDqrvWdHRa9XRLH7UFDdseKEeuzsojBjL,False,236000000,236000000,0,2
1Bj6LGAxxeYRJ9CFhczQ9ZiNfoDcbzWykB,False,104000000,104000000,0,2
147JoB2YB8Rqk4oMTN6PKJFeJa9X8df1YN,False,220000000,220000000,0,2
1eptxHfpbJqVBjsu5m9arZrqTAhpy351M,False,204000000,204000000,0,2
14z6uUvuwaktX2FKqMnnX66Uhx9q25kgsk,False,191000000,191000000,0,2
1M7MLUGZz9ZdRyYqAUkjPwD3uvZdRscnk4,False,4881000000,4881000000,0,2
136twYXz1Gb1cm61uqVno1hz9hoWMrQUou,False,4657000000,4657000000,0,2
13H87w3iB5cf1PAbXAkugPqJLAYdZP21zf,False,4640000000,4640000000,0,2
1GiSm61rJiY7DmceoTjnmkyPgAgqa9ooBR,False,4131000000,4131000000,0,2
1KctwjywUaDAfzxSaEe1GDFMXVSYMbKNkT,False,3870000000,3870000000,0,2
1EKp48jUZ9ZgFaV6CPg5Z6YtaRh6mzkaXX,False,3572000000,3572000000,0,2
1Hy2Hb3aEDHFCj7NT2M9LaT1zwoXKU2jNg,False,3059000000,3059000000,0,2
1Hyj31dEabeP1xhECRc52QKkzE28DpArcn,False,120000000,120000000,0,2
1Eckx8qaZdfpT48finHXbZFppMtWaYNdYZ,False,2998000000,2998000000,0,2
1GvkPHW2eMsfuUKUA5PPe5NMHy3NheQa6,False,52000000,52000000,0,2
1JYnLoEsQm9cq1ywNVk6dvQ8MDysY9vxkK,False,2945000000,2945000000,0,2
1KWefAwfxgHHaD9xUZ2nA7jXU3RzwpbB3G,False,2915000000,2915000000,0,2
12fjGuayQGcD6ynVL8LUerLWDhxigV8K9V,False,2891000000,2891000000,0,2
1DwpforQy4UtekqUZHW3ouaYdEqRUPiDmn,False,2867000000,2867000000,0,2
1BST6pA4aCHr9gzzaiJHX9YX7LQkbUbRv,False,2851000000,2851000000,0,2
14gGLt4249jupMN7wJHsf3DTXRP38An1Cz,False,2840000000,2840000000,0,2
1MqA28yVjQPzqf3b4GmnYURvQY727dcGVU,False,2830000000,2830000000,0,2
1AbyW9FuKk2HNBqauFt2Foua5cNxUPWXU2,False,2822000000,2822000000,0,2
1nd8UTg7icifvwcBFhj6QjHVaCo29PjJw,False,2817000000,2817000000,0,2
1HRxFXQ9jLjJc2odUkam4xXamzxLEnW5qh,False,2816000000,2816000000,0,2
15W9ck7EWzMoQmTdezbixGiy13hiTLR95N,False,29764000000,45438003675,15674003675,15
1DNx5RxFg32DeAuqLd4pAzud1KdF3Ekes,False,98061000000,98061000000,0,2
1HSk6Uv1n8MedSuy5tpX4w9mRNccTPZ7g5,False,76388000000,76388000000,0,2
1LY7FETC4bzuBhSNqHeRmgnnQxDgAPgPVS,False,44978000000,44978000000,0,6
1Hzz25wjeDkKXiXAK84GAoK9gsfHuKzUet,False,10000000000,10000000000,0,2
1LEn5CnUiivFGDAYac6UAdyoPYck4nb1oh,False,4000000000,4000000000,0,2
1C4hqpXmBRew94Nk6ckCcNbnf7yB1abt1M,False,22001000000,22001000000,0,2
1FEvreyxiBWaKCtPDhx5HK35brYtv1Z1yz,False,32700000000,32700000000,0,2
1DBGsK94xsKLVRYoypQfwmDe1ZevUjscoD,False,9326000000,9326000000,0,2
1FzRC5Gq9JHGjibCF76B7v5QvwqVo3WAyq,False,2000000000,2000000000,0,2
1A9NNgaDmmzhnd4qkCBXVh7obdMz3Hc4WC,False,400000000,400000000,0,2
1Es3rvtVbRsd5ujBBgwHwAuGPpFdi8YP8Z,False,1506092769,1507193562,1100793,50
16Kgr8gy753MkUhnjFu4ZTmAyKri6SN2MU,False,1247000000,1247000000,0,2
1LFmokVzYuhpz94c8GN6WcAnpuHRt6UFzU,False,9321000000,9321000000,0,2
1BP8n6kA6WmpmuQPyNicxtPMHfezQhFKoh,False,4999000000,4999000000,0,2
17BNvaQeJy3h4K5vavLodrFnTbZ1ZihLQR,False,3435000000,3435000000,0,2
1NDG64h5yYchXtDE7wroJvW6cBG8ANuu33,False,9316000000,9316000000,0,2
1LTDHM9WP8xyXRF37rXz9JgpJxKgPCcN72,False,32695000000,32695000000,0,2
14TGZU5DqL8585CquFEtFAQfbUAk7kxdXy,False,4917000000,4917000000,0,2
1CgtYZoFK1ZoXLwJ2Wqhq6buBoHeftgYRp,False,800000000,800000000,0,12
15V5P5E1dFZxQQA34YYcQeFu8B8qchJ35n,False,4771000000,4771000000,0,2
16Db4a4J8vttd8MxGeLBw6nZcb944v3iEv,False,4519000000,4519000000,0,2
13m1AH3qt4owYGDAUwH41LBmHKGTLXXLrV,False,4536000000,4536000000,0,2
17FbWZQDCuiwCvrvBiHkFfKZEk33TXURoh,False,4330000000,4330000000,0,2
1H9dzJyTRSD2CzNVfb6ihet9sBLT3Trm9M,False,3982000000,3982000000,0,2
19rF8yf9SHisXn8zeqVRofYCRvm8FmkYuV,False,3675000000,3675000000,0,2
13m7kCSnKAsgbkRLBA29NJJWVsQ2mqB6nQ,False,3373000000,3373000000,0,2
1JSiXdtNihFuVp16pGfJeK8DBTAmAVDteV,False,1500000000,1500000000,0,2
17hGXnczQdkvMrtFu5t7ECquYKnDoLbKKS,False,500000000,500000000,0,2
14Kyy3GBsjdqcfCHUR58kJqeK2rn8gGKM7,False,1522000000,1522000000,0,6
1HQrSta9S3vy8TRJ4VNdQNXj5wsyR56Med,False,2591000000,2591000000,0,2
1KXLuTYs1Qfdyr7RJKBAiKeeKq8zNKAqWM,False,2514000000,2514000000,0,2
1N4UWgL9yq3KpFVxtdPraTqzcxCMiPeghX,False,2440000000,2440000000,0,2
17QUWAATsNnkCaCVkWmzzt9EEc451xT5Zf,False,2367000000,2367000000,0,2
16duuWxuiqMZnYpvcqiC5rTrEpxkhTpS3D,False,2305000000,2305000000,0,2
1Bmf2d6zYTNWBgLz9TgrKF4EM2BfAxWhw8,False,2245000000,2245000000,0,2
18ZKkNQ1f8emwqJEuk9MxLL4Lzioyeo4CV,False,2193000000,2193000000,0,2
174xPGrPkVqpZFp1znoRH9v37TvtAEmgPY,False,2143000000,2143000000,0,2
12fihjXXKTmLcy3XUqCBecZHwDYdUmmyeQ,False,2106000000,2106000000,0,2
18zfHuXBHxLHPq3BLwzGMcUvSomS8wuwy4,False,2069000000,2069000000,0,2
1Lbnzage7Xg8saSJk6p14chJZUvtokAo64,False,2038000000,2038000000,0,2
1NaHnpwSocnhC9pDJxLci9HhzxHeXAwKtP,False,2008000000,2008000000,0,2
16Q6tC9yX4boqSeMzmApkYLhqba5uFCtTF,False,1993000000,1993000000,0,2
14HnjKRqLiki2L28NiMWdex3BLUv5ceiJN,False,1979000000,1979000000,0,2
19Pc4utJyYJLSmaFz4o31u4deYaVKmPTvn,False,1967000000,1967000000,0,2
1Kbmsf7RPPdLxedpL3a9gZanYbVfRrEm7i,False,1957000000,1957000000,0,2
1GrXnhUdkefhaA1sEtSzfPxZRnjJaaJeTF,False,1951000000,1951000000,0,2
1gu5pbBhZBCoLX19yYoEdPirtHuVaEWmz,False,355000000,355000000,0,2
14Se3vg3V65jXuLUYpnShkS6cHR7cCh76o,False,645000000,645000000,0,2
14URXjKUC7Fww3MSR7P26Vjv9aM2xYgJuw,False,645000000,645000000,0,2
1LnDyqkFifWupQLaDGdXdX8Jns6QD6ynxJ,False,355000000,355000000,0,2
18pnDgDYFMAKsHTA3ZqyAi6t8q9ztaWWXt,False,106785222934,106785222934,0,26
19d5FAcvErpBksctKo8s5LTPZcSCJni3vB,False,1183000000,1183000000,0,2
1LEToNReyzNT35oF6batCtUTKpxh2mrxmF,False,1000000000,1000000000,0,2
1HnSEFCR8thq2CSGAcTkMPFf9TCdKtNR9H,False,1000000000,1000000000,0,2
1Nm11kdAZurrTioXoJ3d27LMboro41Dt1Z,False,2093839851,2093839851,0,17
13JeU623tubKspDN8DvjVBcVsGPmUbcuGk,False,50000000,50000000,0,2
1FgyqSR5oQqauWSvNAJfx9cyaFJASMFeLJ,False,532000000,532000000,0,18
17FJFKMMFqwcDYoAbJRDPmtJattAtGKsfR,False,100000000,100000000,0,2
1KyPUHrAE9DhWLcQenthLepTZ1qqPo9Cj1,False,9311000000,9311000000,0,2
1Pn85i5ZHWv2qV9kgdWrMGC9NHGVeNpnCp,False,9306000000,9306000000,0,2
1MUtx1kDFL8fwCYqqRkDrVPt2sQqozeM5h,False,9301000000,9301000000,0,2
1J2wf9B2kLHUwfRg7xUK7G5rWffdJ5u1B2,False,4990000000,4990000000,0,2
1A32o9fhGw7xcnuNxCKpTFqgVYMdswdKbs,False,2000000000,2000000000,0,2
16pBmLCDdR1GAVzrxj5BaxzV6co8duy3bN,False,10000000000,10000000000,0,2
15UBb9mhUKtX5x9uK7YdzBxXPPnbMdxJY4,False,1530000000,1530000000,0,2
1M9dMwfMQPhv8dtckXV7togRCxjQt7obog,False,1017000000,1017000000,0,18
132n5PaPorBL4mCgBnaT5X95guvHNvLT3i,False,2980000000,2980000000,0,4
18gtZisKQoRZBQvhRPb78t93PZZMRbE8f,False,32690000000,32690000000,0,2
1P9xGx4oLGs9Nq7wPBz8x1hRTHe5zhmWVy,False,9296000000,9296000000,0,2
1CtSRxZRATMY265RVzQQH7PPsb91zA4erP,False,9291000000,9291000000,0,2
1Mk57apUkUqYg49WRUfweUhRuqg4brc6zg,False,1000000000,1000000000,0,2
1PCfxSkACJxv6kEgugSoPj7VzcfuVfzo1V,False,1500000000,1500000000,0,2
1GW2de5mxJZt6vrUiSXtpZcr4dSmn7VsJB,False,10000000000,10000000000,0,2
1FdzzdB33YhcNDmDgncPr1BoTE9DdCYGAG,False,10000000000,10000000000,0,2
166uAbWYnLN2hwAYHjV77bg8jfHCbxnuTM,False,4809000000,4809000000,0,2
1AcZGUAMJ1kxpGpusDfV9Gywh1b3Q9fHAZ,False,46000000,46000000,0,2
16XxtXCcDExArueghmvu7UrEAsNFLJFJ9J,False,4699000000,4699000000,0,2
1HAKbHtfaN5tM8ueSJAYCs98VPJ8VddKMV,False,4551000000,4551000000,0,2
1NTgLhAjxVcTk1Sv9QV1nvDYoBTT8G7r2w,False,4199000000,4199000000,0,2
13EwNj1LFWkGPg2EuFAoXmYwnaVcrCiriT,False,4299000000,4299000000,0,2
18Whqc7MUjGWkmFnFnifiae4BoyKRAqDX5,False,3887000000,3887000000,0,2
1FqE8Pe4TaWKeqDxiHoaBSvjr5fxmcuEyf,False,3423000000,3423000000,0,2
1DZTe8SSpBxy8pvHRLi6XVpYK1UVXi2Le1,False,32685000000,32685000000,0,2
1CosY8n55uPk8ftKsrwhwpCSq6bLvYv3CL,False,936000000,936000000,0,2
13SBbUQx4gKNycjFD3QiRXRF2i4ikWv6yw,False,30000000000,30000000000,0,2
1Kbvo6MRgCXCcesMrkDEj9cZqqH6wek9g6,False,32680000000,32680000000,0,2
143LJbCAiNwR1fYdtTYcZ7EgGQLTMJQpkk,False,9286000000,9286000000,0,2
1Jnv8JteCzcWD5Uu6EjJeFZBVQ2vhNiRiY,False,4980000000,4980000000,0,2
1NSdd9MeshDSHcWXBfWP45gS2QJX4Q9x6N,False,1990000000,1990000000,0,2
1GvVY387bhz8pRw9HLveUSpMt3YweVqqT9,False,3291000000,3291000000,0,2
1LFvv2mVYvXTMCQWRSdnDw3Xi6mVEg6KRW,False,750000000,750000000,0,2
1QCUESAwv6A6oTjpHnGQ4b7RZTztfps2j9,False,32675000000,32675000000,0,2
1EEcWbdCxaQVkZhjiNMVN1hCiECMHWkpyS,False,9281000000,9281000000,0,2
12meBwBK14pPZyXpTKgRBdbQKKwLdX3oK2,False,3166000000,3166000000,0,2
18L3cYHK9oLByjw4M2mc3bWByb9ZFydrQ6,False,1980000000,1980000000,0,2
1Briu7v1XWuLtdqLerUqxsxvHgxxU6V33V,False,586000000,586000000,0,2
1AtL2fkBrpKC63HbC7V2DXvttj1ovVp4PL,False,3043000000,3043000000,0,2
138R7Pc5QfA9u7xBmxMvY1iYgtDKuNrFxZ,False,432000000,432000000,0,2
1Mka1L9kd2cMLbjNAnNbRuQ2yua6VVcQZV,False,1420000000,1420000000,0,4
18YjBKv3Z3KAWL1RkuZuQjRnsuqkrz28iW,False,9276000000,9276000000,0,2
1CgYkbpYopacZNJSc567ep5Zu7zfvFqdYg,False,14276000000,14276000000,0,305
1FoUfwFTYHXjvgW8cPDnjcEBJJHCZsPfge,False,1970000000,1970000000,0,2
1D2YMJGtWGvySWFvomDgbwXt86cwCACMok,False,2923000000,2923000000,0,2
1C4ZVFvB5K1nQyX3ksbKkyoHxDmG2N3uXm,False,288000000,288000000,0,2
1LZKSEp9ePPojRdtGr3RZ3bNVjcDpj4fk7,False,4970000000,4970000000,0,2
12dfWi8nzE5Do9GVc7keFv21bhRNZqGkD5,False,2818000000,2818000000,0,2
1AJ4Pk8ov34kjBq7rpJeJEdBB7jUJz5VJA,False,1950000000,1950000000,0,2
1NZvbndkobB4q4arSRijQfsHN8WV6ZwMTn,False,152000000,152000000,0,2
1NCPynR3Zz8K5vQtkuTTgV7BWaYqJGyb2q,False,32670000000,32670000000,0,2
1GT5aKHiYnSV55eVUq9Mnt7gGEwvK4QKZq,False,9271000000,9271000000,0,2
15QhFXL72SpXZtUTMwsvHyioeoAbhF3tNs,False,4950000000,4950000000,0,2
1KB8oEESGybjNNZRGHS68Ms9GsosTjx993,False,40000000000,40000000000,0,2
1KGyRVGBPQu8GHLmFtFBABBgMpgfeHcoSu,False,1940000000,1940000000,0,2
1KiXeZcT9Xeq9dJ7CnX1n4HCiYLtFdeomz,False,2714000000,2714000000,0,2
1gx3eo3xQ1J484wD2WNnGsp7jsdkUZtje,False,1920000000,1920000000,0,2
13v4eUoATtn6rGJWjdj3mQaHawyf95bEmj,False,2646000000,2646000000,0,2
1JTQCjD1RtkveJoyy64tD3zSVM2eAh5de,False,1910000000,1910000000,0,2
1B5rnuon2rMzqBtg6fTmSDuTW7baXKi7NP,False,1900000000,1900000000,0,2
1DBVLtvtCDJrWP7sHau7sA764aBEJZdXZY,False,1890000000,1890000000,0,2
1DgErt1CymucPMwBgde8VL3nkdssimSMkt,False,2583000000,2583000000,0,2
1D82atsmTM3eRQZAaMuXYWGz4Bvwt3gVSK,False,2554000000,2554000000,0,2
1MijJhTidFsTJMoYpKB2i29JkgxW5QsDr9,False,1880000000,1880000000,0,2
1DhC6ChNdpRTb5T7vrHBrXHruWkJTiCatp,False,2526000000,2526000000,0,2
19ek8z3ghshnMKVg5pEyiCW8UMGRmHuqdy,False,1870000000,1870000000,0,2
1JxoTC4gxgLzSSPj4ouk1mFvGHyhjC8jNo,False,2514000000,2514000000,0,2
1ErqJgSFJ8sLpsn9A3DondSRZxU1sKPVwH,False,1860000000,1860000000,0,2
18TfuiT7ssnwVHwAbxAUXV8GeWkbw5UhFN,False,1850000000,1850000000,0,2
14C9z8UwePJQQRcu2GYK6HcCbRGKx7MsvY,False,1840000000,1840000000,0,2
1MfXFuaZBgioshWHC2zf6nCr5HVhAqbtPT,False,2503000000,2503000000,0,2
1CkE8Z89oyTQa8mKDhWv7pCX5bKBpMW6Lh,False,2493000000,2493000000,0,2
19YFN8ParPQQN1jzLqqzcJB4S3Ca3fdMCM,False,2483000000,2483000000,0,2
1Crkn7KU9YxEL4LfMtNtSNyqsLGqU23NKa,False,2476000000,2476000000,0,2
1CSFGVoRBGY6VSWD6wAVzkeQsWFCscSuFD,False,1830000000,1830000000,0,2
1JY19p2Mbze4jNMysuLj8U5zfGX3f1wuqx,False,32665000000,32665000000,0,2
16jMmTn8HJrC8P2tRkuM5y5CYvK6AEN3iX,False,9266000000,9266000000,0,2
1AmqjKtd9z1i7u2kBGMYdnmXwMtG7Vmmsg,False,4940000000,4940000000,0,2
1ip6NE7qbGqVS1YCFD7z38s2mmm5zbz2k,False,1820000000,1820000000,0,2
1LzPt5geyFXcHuXCgRbMyfVWZCtmWofA41,False,9261000000,9261000000,0,2
18HvCzsvMMfB76765JSQoEgMswg3eYqAxZ,False,1810000000,1810000000,0,2
1Kg4VWiHKgpcDxCQa7RVnwH53dk5L8uAFN,False,1710000000,1710000000,0,2
1QC6ei4SK76e44m7LsFcZQfx5x7DNcbX68,False,100000000,100000000,0,2
1KLtQefv88G3F2pZkSB9JZ9aiLeyAonQGN,False,4930000000,4930000000,0,2
1KybftHwS7T4ppyRFwFSJTWPaDTi1PACpz,False,1700000000,1700000000,0,2
14d9ojicffZbDtHQMu9pVzaaDrMNnmiw5r,False,1690000000,1690000000,0,2
1GteTNVvwKQs81un9mS5hfTfnUe3iCprjR,False,2400000000,2400000000,0,2
19RqVm38u9WrMmcoPwvZe5CbZ2E6eQQ6Xx,False,2005000000,2005000000,0,4
1GvgmJxaCSpC8396VpR63VzV3CsRiNK5FL,False,9256000000,9256000000,0,2
19ys1ZVG1FnVojmhvLqWpvcLdmVEZctPxU,False,4920000000,4920000000,0,2
1Cr4yMpwfHFxTjwVPFMJvo3BwxmsRvXNtk,False,1680000000,1680000000,0,2
17HkAvy9xtn2YvK18bSCyGwWoSDsR4uW2a,False,1580000000,1580000000,0,2
1HH4iu6PRd9EDzjUhit8e6JjZM6rFrnfMy,False,441000000,441000000,0,12
1MvBXWaLyLAUDSXBFQ4mFubwZ969nYHfcX,False,1480000000,1480000000,0,2
1J5YSwCgrDYA8dNGEi3TFVLBgWLHWoZjkj,False,1348000000,1348000000,0,18
1Kc7bYQRKzSNaJ4ApsjkejvuwfqScbYaP8,False,403000000,403000000,0,14
1LdjSSRTDRGRcYwXTivxAAyHEUp2yM8SsB,False,1380000000,1380000000,0,2
1G25VqLrs13Bh7G12u4FgMJvwzuYXmWEH5,False,1280000000,1280000000,0,2
1CZMAqTTgk6Jfh4pAA2dNkR4vRFTJ78mCR,False,399000000,399000000,0,22
1NV4qJPQ87UAp5WiJkg9pXyC3ACvfLFUW7,False,419000000,419000000,0,20
1B8prFTqdFCQB7MBUhupdkngxUk2As3Jbt,False,1180000000,1180000000,0,2
1JVo1vgm1xe3zeuTevFHVaZxmNDpscaQXZ,False,403000000,403000000,0,14
14dsTsEFzudxr7EgSCKuXRc6RqEf1YUgRG,False,1030000000,1030000000,0,2
17Lsi7GFFuiYmHq14Mr7HdutcJLWcws11Q,False,32660000000,32660000000,0,2
18XiogfTZcVxxuymC9sts5B5DArd2QLXiE,False,9251000000,9251000000,0,2
1KdMphYis8kEjKbGAhCZwxvwza1ygU4qs2,False,4820000000,4820000000,0,2
14fJun12hruQUticyGyRtHy8E2Xp6i5AK5,False,1352000000,1352000000,0,14
1AkidT6j8MTTbxmLE3HktS8jSts18Ghdnr,False,622000000,622000000,0,18
16F4SPriMePeRVncHjkGU3eSeiN73g13r4,False,1900000000,1900000000,0,2
1LGh36M4PbRUGvLehNY4nM1HUryAqdPSYi,False,173000000,173000000,0,12
12cekjqRRv4otU96dTevhdWkRpmexNsHYr,False,930000000,930000000,0,2
1PM6m6mVtzpwPChHTpR3uax2TmMMihtq9U,False,32655000000,32655000000,0,2
18isK4aXePhQACmrjqXx5hwTL1t8yKmRVC,False,9246000000,9246000000,0,2
1GPBJLax8AnvJZmZMbo65hz9ZNhEvPDpmj,False,830000000,830000000,0,2
16cDQPYGCYXGnLibAvVutBktgH3m7wrmEF,False,233000000,233000000,0,14
1B8YxeG4U1ZBSWJFzh7VStQp1sacnSXqSs,False,5000000000,5000000000,0,2
138HYRg6qaZdiVWVYUn9MshSauZMttfwYQ,False,9241000000,9241000000,0,2
16oqvEHwGiopDFzcKp8VZy1UopDa9akB4F,False,4932000000,4932000000,0,2
17TwysueSppsoWEDEEtQdBTM6UNTuswDsv,False,4718000000,4718000000,0,2
189ofCNT81kfk2FVYuE2L1gAPAFaKaWWAJ,False,4595000000,4595000000,0,2
12mwYWFgPQEUMqdDgjqPgUipY1ENf7viEj,False,4433000000,4433000000,0,2
13aP2Mmx98XurzAmW6JjE7dGSVqDxqfGws,False,4144000000,4144000000,0,2
1BuA9U4fJMpVvnYPvrmGYGhiGQXRzRcBBR,False,3997000000,3997000000,0,2
169YtV2UuRk9aeParV39fvTDsz8o7SEAMF,False,3594000000,3594000000,0,2
1Cv8EujeN7CXnV67kW5noZmD4yNW1ruCAT,False,1834000000,1834000000,0,2
1EZiQeNXzj87Wz9N6AMN3u4i5S8snNCyz,False,471000000,471000000,0,16
1eR1s5X6Qsfk32shsMKbqqBoU8nKdtHxi,False,730000000,730000000,0,2
1LFMdh539F42QrQz3GPzcPTqHEMqP37ikU,False,1767000000,1767000000,0,2
19kDefdr3rx2pteiijeW6opoRAmtHRM3gA,False,1713000000,1713000000,0,2
1D3deJssb3pbERz98Q55BZVDZdCqAqSGVc,False,1416427376,7560298224,6143870848,222
1BKkvVUsRxu9QAVB1mRQiNSRi4zdqrR8BD,False,1661000000,1661000000,0,2
1K7N78ytXR7FdPqH8Bibuq6m327mZFLeWS,False,1800000000,1800000000,0,2
18XFvpsqDmNJ1tVv1cwdu3zdhS9AQvh9mR,False,235376000,235376000,0,24
17DvmXV6wiUM515FmzSUftBEVCWTqpSffg,False,1630000000,1630000000,0,2
1CBrBNC6ueHDyBR2MfLwTVTQJwhWBZt9kL,False,448000000,448000000,0,16
12e9zLYpMwjYSTMLc4ppYHeTxpa4ouAZFH,False,630000000,630000000,0,2
13tDhSTwmBaxiGJfAddkefSW2CsGJWhHRC,False,265550000,265550000,0,18
1NrtNsQUeJn5WUecdMPVm36MGBGpwGUien,False,1603000000,1603000000,0,2
19PikKFAyQVoYkY1pdjD51UhCyJzCVEArX,False,4720000000,4720000000,0,2
1CLJB7xwJnqG2KJuoygoki4fd1dtSmyZzj,False,289000000,289000000,0,20
12BHEmidf7zusQiEqAAvqeqNZVvbqsaA1J,False,1579000000,1579000000,0,2
1KzJChkLV3FjEm9HdepqSNQiKFXgFAftJ6,False,290000000,290000000,0,18
1DT3pkfAQF3WhEC6KjTUiKDLN1oTQ8799j,False,530000000,530000000,0,2
1QB2qtHeC8kwLZswvsXtmmmsbXxYsWMBQZ,False,1558000000,1558000000,0,2
1Cg5nf8bxCwvNCx6f2HZutSRRQRv2Pkva6,False,1546000000,1546000000,0,2
1FzTbaDcbHibYX1ujw8WJJUfg83XujnnWy,False,1540000000,1540000000,0,2
1A9vrnLrSfGh26osqHhb5qJgmrTh1ShLPX,False,1537000000,1537000000,0,2
1UN6uPaka5vrT9mvSjMRdKCeFTeDPfrrr,False,9236000000,9236000000,0,2
1XKX3A2QumxBnVR8RewcDzGrGJX5c8oFC,False,317000000,317000000,0,12
14KxnRRXDvwT6btjCnAfxav9WY32fFsZKd,False,1600000000,1600000000,0,2
1K61Rzxj1gew4hRsrW1C6auVX5isvR2vaU,False,330000000,330000000,0,2
17e2LKUcc32sPiL9t1hzkVQFH6ozKB9awb,False,353000000,353000000,0,16
1NSyLLBC9CvKp1wKed44pfjt5hwLKgN4j7,False,473100000,473100000,0,19
1LVqBj9aXjVycnXRBGM1bCyrdo5fqRmTSH,False,9231000000,9231000000,0,2
1Mi7b6eGzmiyhBHAkng3Ez3EsPPbVx4jJi,False,30000000,30000000,0,2
1MAZy9hFCVxDvyuHiXkhgA4wWkBBrgJLzN,False,100000000,100000000,0,4
19eZXege7cCwEsNcCfaGFY7Bs2KogoyZN5,False,9226000000,9226000000,0,2
1JwharbTH8XjbALwuLqs3ZPiUGZip4PL75,False,9221000000,9221000000,0,2
1G1soVjUvBzvrLfmvMe3HZTn1CfeTWPerg,False,4776000000,4776000000,0,2
1nH1F6VsHpjr5roSWefHKqUuNeJ1fuCFY,False,4540000000,4540000000,0,2
1H2YWomM3fNxGGwdsJK9qmXjgpfhvRa2QB,False,4392000000,4392000000,0,2
1M5KD24YpuuauKz36E8icc65y11DJcrAJy,False,4225000000,4225000000,0,2
1AionCF4SHwJWp4NoFWdshuZAFXCkNJuon,False,273414191555,273414191555,0,901
13vRgWoM6d4qzR4irFZ19LYZU8MN26gt4W,False,3935000000,3935000000,0,2
19sPVDdyLPwyqxv5HjsTKXN7xJ1s8GV9dc,False,3464000000,3464000000,0,2
1AA68sb4tUVnGPZR5Wtx7zr6K3dMZXWxtE,False,2580000000,2580000000,0,2
1KcDDzJEYZ1ACUbBcgnmjezvmSShwa3ban,False,9216000000,9216000000,0,2
1E66TvG7JhhRNTNBgU57qmCyzzBb3CMbyV,False,118569986476,118569986476,0,485
1EXAtnffEnz7izRffvbnx1KyVKriVMnqU8,False,486000000,486000000,0,2
1CfvZgNFCHivexSg61oJ6E4XDuPKC9SoNT,False,2508000000,2508000000,0,2
1F8HJ6Q96bTW5kRS8dcvBYJbu1G7yz8XFW,False,352000000,352000000,0,2
1GfDS2MGP55FyVsFtcWWBXssoxXSUhJH2B,False,2446000000,2446000000,0,2
18F8wypx8gnaasis4rN8ho3TGFE8qmCWLN,False,232000000,232000000,0,2
1GQjrVbyUwUH33SFGEak5DveaDEJZKAhy9,False,2388000000,2388000000,0,2
1AmEefqAYBW8Ps2Jv9utHNt9apGgsp3BPC,False,131000000,131000000,0,2
19aAtXJ7BzdXDdrY1yeETjw52a51ePcTeK,False,2346000000,2346000000,0,2
1HbrHMipBsVFWWh3Q9fcNmsfya8C1muevC,False,100000000,100000000,0,2
182CsKSxkPSNH4fTW7smawBQbgzPkAqqUQ,False,40000000,40000000,0,2
1MF73oHcs82x6ZkDTXFVpcWGvcDJs2u5Ty,False,2323000000,2323000000,0,2
1Cgdxzv1dPMzVyrJ4jLu3CAi5jEpuVbnmu,False,2317000000,2317000000,0,2
1FGWaYQBiKyDiXQ4d5YYpJgQNFD27FNfyF,False,2311000000,2311000000,0,2
19B7AatdP5DXuQJUUcuJEm1aJniLJSRb9i,False,32650000000,32650000000,0,2
184A9whsHuxXrZTUZ2Nq4dyN171X5DrSpU,False,4000000000,4000000000,0,2
1HoqAE7VUPmfThpXssyh4gyPn2SfPcBPoN,False,9211000000,9211000000,0,2
1NVcyjtBsTdpdrZhsB4dBYp6hJ7FLEZizf,False,9206000000,9206000000,0,2
1663w8i9KxWQaZnTyXMer7Wr1Qm1esL56k,False,9201000000,9201000000,0,2
1M8ZTKhFvKfNYNzw8A7AwWAUnGM3mpQBYu,False,5020000000,5020000000,0,7
141n6XzBYfC3JKft4sQUP6xurAveS6JJow,False,2500000000,2500000000,0,2
13g8iQHSErBLowyss5Wy3kJiqQoYXTLzsx,False,32645000000,32645000000,0,2
1C9cXgGChYgWk8MxhxmvYUofYpeSGyEWwk,False,9196000000,9196000000,0,2
1MTfMaEoWaxccWVfgrbX9U2Vtb2uLftMud,False,9191000000,9191000000,0,2
1Hb3HJweE6Fxh4v14QYud5Qkji57TwEp11,False,4737000000,4737000000,0,2
12ap27M2rAAnbKL1nSEgXwWNHCMrLSyAxR,False,4679000000,4679000000,0,2
1Kcfv2fc8zs89KQR1k9bHNMpGvvLmB5mTb,False,4646000000,4646000000,0,2
1LKA8eJHqc2ndbbb2RV6QAzgovbmeW9gSF,False,4353000000,4353000000,0,2
1GFsJ9fQmWAzAATXoNKorgM5rSk4wr18Pu,False,4233000000,4233000000,0,2
1251AHq5qCDXptVCqDZJRiE5ujH2FBLfhD,False,3969000000,3969000000,0,2
16jGJStDgj1MD7ytp4v9K7fJeuxvSqm8rk,False,3801000000,3801000000,0,2
1Gpvij9yBg5ZX7ZAwPFSnutitG1emsNMxh,False,3606000000,3606000000,0,2
1FVVMgPomw8ZneoV32oM3bDLfRPBe9pk5h,False,3066000000,3066000000,0,2
19B7WzW4Qag7yJ9DrGWzoi2EGNt9xWo95t,False,2373000000,2373000000,0,2
1PzKHz6zM7WUNAXbbyfXoNxdndhRrkVQY5,False,2927000000,2927000000,0,2
1GEo9vqJ6qFhpQ6PZ3qvC93ebiJdBbKFG7,False,2809000000,2809000000,0,2
15gkC8feSAvsDHaeZEJqp4LHjzqN46r5ha,False,2116000000,2116000000,0,2
13Yh7fitfZ3kU4vFeWa8jE5PfqR68tgYf2,False,2702000000,2702000000,0,2
1EXaPYMBMvRGfBSrcuPSdpDvz3kSQLVWhF,False,1864000000,1864000000,0,2
1LfWjiSCevdLsneM7ePJYhd9kuiE9tG55j,False,2601000000,2601000000,0,2
13nBRkGuUVt8WZ7ePBce2UAN2HySH8Kp4H,False,1650000000,1650000000,0,2
1JgH4Ec8xsuFNMRqanzvnVxXZWr32A33LC,False,2524000000,2524000000,0,2
1MS22SNSHu8xsNQg9ejRxRm7tysJCmYgiP,False,1445000000,1445000000,0,2
1C8HCsUXKoR1TUsuMJCjQhNYT7gkBPvgSW,False,2456000000,2456000000,0,2
1PZ4Y8CYqFBaXrfnMMeEETNmkqrYquGZea,False,1267000000,1267000000,0,2
1LYzoUkcoK5oQ5s3fJ5y5cJwtQtE5ab8YF,False,2424000000,2424000000,0,2
12HHzk7qXefbfagNpy7yh8uiZMzq82tT5P,False,9186000000,9186000000,0,2
1A7oM4iHeHuEZfHx4VJX9Dx9rSchLaz9c9,False,2408000000,2408000000,0,2
196XTcpXQQc2VvkFqKsMPidjRrVjL4ucRy,False,1091000000,1091000000,0,2
1CL6boEWPqqFspc5LNJP8JwbV4GcsefrsS,False,2394000000,2394000000,0,2
114f4QrHD9s4JQjDhvt6nuJm8JmzkLCze9,False,921000000,921000000,0,2
1J95MdAYbE6T2ZkvyKHb5DdeLitCpwbECu,False,2383000000,2383000000,0,2
16pqc2Mo51CfLXdUzYMYGBU6bTTbQF7kun,False,754000000,754000000,0,2
1EAj5e9ytPE4SPMengiQiB6oXFfdLSceXy,False,2375000000,2375000000,0,2
163y5ybc3xZ9VVXwsgf89r39kubSB3cxBJ,False,588000000,588000000,0,2
13YSCvkcL1zq71UDruPxUURvNPuwYsDdzy,False,2367000000,2367000000,0,2
12xj3pdwg7cXFWaWPP8UA9Yh98uv3ytezw,False,424000000,424000000,0,2
1Jf3Q85RWzeKPgo1oghF1C1qZ9sVMoPntU,False,40000000,40000000,0,2
1EARLUiW8SoqKWzAqhiVagD7KmqKsrwCNn,False,9181000000,9181000000,0,2
18FbPucTNyHVEGcCE8kmMNSAqVordAidu3,False,2365000000,2365000000,0,2
1GZeQEVjRyVx9n8kPb1wM35Zdq9wS3imeY,False,266000000,266000000,0,2
1BCw9dD55BcW5PdSzMTzDSy2W3kjop9GeV,False,116000000,116000000,0,2
19aAuE9a2qTjsNiCEX44Hv4VNspeJNshcQ,False,10000000000,10000000000,0,2
1K4wmruK2vjBvK2EhsUiFqgMXfbiPSR3Y,False,5000000000,5000000000,0,2
1DH2LnJKzvLAfieATzrYfRKCqKgNDFHq3n,False,9176000000,9176000000,0,2
1Gr6W6ZbzhQf37fkZxeg18j8Q4YTtCU57z,False,10000000000,10000000000,0,2
1J7kn9Xy2iTm6sscQNG3vjroQf4XHKefxT,False,663537000000,663537000000,0,2
1EonQMYeWwS3ftKJyJKjPgwMWBs3yu8xPN,False,32640000000,32640000000,0,2
19r9bRjrek3xQPU3gfPtHXqRAvsuN4B8ns,False,1500000000,1500000000,0,2
1FiRzBJC9gYqunVH3zP2eaXXcufvtdFVrp,False,52000000,52000000,0,2
17LLNKUWVJ74GegtHmi5cCVVd3FE3CnQjU,False,9171000000,9171000000,0,2
1VY11zzCkW7ZSjDUJdtoCYq9h2L9Dafke,False,4952000000,4952000000,0,2
1P6Duz7qjr4ifAEnWYxLd2vBFXqhhxn9C3,False,48000000,48000000,0,2
17mYSsVYSre2qLPZHdDZrUs3pgXpc5RBEh,False,32635000000,32635000000,0,2
1PTm44BFaERuPLS6WcEcFisUfv6Hqs6XrE,False,9166000000,9166000000,0,2
1KBWKKwWT8BYKApEvqEbMYnZELDH1oeQrk,False,400000000,400000000,0,2
15pG9zgFkegt9m9oEUsAQWSimUUYd84XWM,False,12200000000,12200000000,0,5
12ykDGMF77SgThB2ekjZRbzcSW5eXVwFna,False,32630000000,32630000000,0,2
1AniiEDMamrKr12kei3ANKRmHdM8pagdun,False,9161000000,9161000000,0,2
1Q2qu1Ac4piZfNhNqqL9qDzZnnYTVxszUH,False,9156000000,9156000000,0,2
1EKEppL9xQpvWRzpwjKeSfMX7sX6ZyVZd7,False,4942000000,4942000000,0,2
1LFv3ef5aWY4w3xLPR2aGeWPcmapoagbXt,False,32625000000,32625000000,0,2
1cbTbgNm9he4AWkaxDW27mYvyHw41ekUb,False,4673000000,4673000000,0,2
1AehVWAu19K2QvSV5ra9tzQJFCiNJRb6ND,False,4608000000,4608000000,0,2
1CJ6ntjCQTYFPCPEFCavUZ7oa8aNKJe7X7,False,4557000000,4557000000,0,2
1QKoGy2TyzaDYBe5U2coNb5HRzRuTjxbaz,False,4260000000,4260000000,0,2
1KEnqBfrYtLQDEuozYrecsQfQhVfL6Pu5U,False,4130000000,4130000000,0,2
15ypHZGeLhU4u4zVz7Ej18iUixe7HYP5EC,False,885477156,885477156,0,17
1CemxtbacYggac1T9b6fpmUpQJ9H7jKdtm,False,3842000000,3842000000,0,2
1FXV5ktJ7UU7AFiaGBeWeYQGeTyBm9rJid,False,3597000000,3597000000,0,2
1G3fpgyZfHcTkeNHoaxf5F8TfcMYU8s8mw,False,3305000000,3305000000,0,2
1AkiKke2Gqrwk4xFhyec3QeGVJV141pFst,False,1652000000,1652000000,0,2
1PJ1u45qFC3QTn1uWDsepbNKQL3D6TPZEB,False,9151000000,9151000000,0,2
1MW7gp9MfdadS5qcRJTVyFZ9BQPv6RhgKr,False,280000000000,280000000000,0,12
15yT6qYwLwpN1HvuRNZ4BE9s5axmFJvoKZ,False,200000000,200000000,0,6
18aEM6HDrfcWM7wqQDiWnaf2mXrQxYJ9NQ,False,4902000000,4902000000,0,2
16U5PeSVGCnJ4AbQAFYgCRP1R4DnX54G9Q,False,1000000000,1000000000,0,2
1KsSjFv7oX6kEPBTPYUk8DAvmTVCmfopmk,False,9146000000,9146000000,0,2
1HYYQJLnGXzLTvbzXk9Jovn24Xzb6sb4sG,False,1618000000,1618000000,0,2
1F9yNah3j3pu9Z27cj1k38nYRZZYRmG9jE,False,4852000000,4852000000,0,2
19pFQkou9QZcTz3rB4uFP1JLhwkhcVvAdV,False,1598000000,1598000000,0,2
1L5gGtfbpyesAD81QugfhR1rvyQ5npFwr7,False,4802000000,4802000000,0,2
19sFchZo1b7BVq82yArGh3ffy9RiLVEk1E,False,1579000000,1579000000,0,2
1BUVkNXYhCf7YcMnnGePeL9zfMMQxRAk8u,False,4752000000,4752000000,0,2
1QH7aEdwkyxffKbaT6c5Ztm5LBRsid9RvB,False,1563000000,1563000000,0,2
167zoKXXzJ55x2Ao4DgTa4rJkhxqpvu73S,False,100000000,100000000,0,2
1Fk4n6L2H3speDvVu2yN5H58LrX96tqMsr,False,1550000000,1550000000,0,2
147pybphxQToHFWqkyUD9UkD85KKC4EEep,False,1543000000,1543000000,0,2
16tf5ybaqhWjR2KixQuagYu3uaq2gf3fEY,False,1537000000,1537000000,0,2
1HmDeQpcLqBUiMKeikGt4qmcDn1e3fpcqC,False,1532000000,1532000000,0,2
12P2EsST5fPEPVrjXQiZaCSRDDZrXnzi3K,False,1530000000,1530000000,0,2
1NrFui56cgnmZeqw6E6VihcoehKEX3empP,False,9141000000,9141000000,0,2
1HLn4dW8AR6aGp8t4t9jACtwt6vzb2M2Q4,False,4552000000,4552000000,0,2
12fou6nSik2WSxc9AHXQTwqFkc6yh16AV1,False,200000000,200000000,0,2
1EHZt78ptebSdFXDeNUUgrQVCqX5c8BEa7,False,9136000000,9136000000,0,2
1BediMLw84d9Abfd8ApHCcpa4EMicR4f4U,False,2622000000,2622000000,0,18
1LtXtufzQ9FjH8k8WpGxnGqzmCLpbXothU,False,3400000000,3400000000,0,2
1MeMQ3VRBwz9MHH3FYEdjQ6ttARZtVK7hV,False,32620000000,32620000000,0,2
1M6MTEonq3Q3LU5CU1JdX7V8Wbk2ZJ4ren,False,9131000000,9131000000,0,2
1D9sNMWkEysf9CNhj9i3HvQuz1aLs41HnM,False,286000000,286000000,0,2
1MX7FBwLfeXY8jDnc4k3TQUUjVBSFPuFzx,False,50000000,50000000,0,2
13mUz6VntYZxh35NJ8gq8DkSjtSXiXsr2R,False,150000000,150000000,0,2
1KK5Q48NZThbCrHXMHGp2kqTNe3v6edeTu,False,150000000,150000000,0,2
1AuF2ZLPxBph4giFt4uakg3NDf3LgYEhgv,False,32615000000,32615000000,0,2
1B9x698ytBCwezEX76HaZzqhtzNEzXPuSo,False,9126000000,9126000000,0,2
1GDZhwAZyTiNh2rphKEwMmwDYpBcjRYhZY,False,1970000000,1970000000,0,6
1AJKzygYzCNB2geVivqqsbJ8EV2trVYXiy,False,9121000000,9121000000,0,2
199KKNAbJMGFMebCHnX3EUCEXBboyfdSWA,False,410000000,410000000,0,2
1LUFVQQvBUFapR1xSxVuXHwNAmTATPr9uu,False,4736000000,4736000000,0,2
18fuqNHjtEMZSckPeVxnDJioHT39BUw1aX,False,4714000000,4714000000,0,2
19mrnM6kUKpo9fBRHtG2EBejwzkd7DkHfg,False,4759000000,4759000000,0,2
19CZNBDedyNuKQXWFqBKJQNUrsmwWwiyZn,False,4365000000,4365000000,0,2
18uE124swW5HkbjivzF9kf56vB9DMpV8QN,False,4291000000,4291000000,0,2
1EWQ3TBRA9NG1Lme9XnNJBwAwk3FrLKCiF,False,152000000,152000000,0,2
1P645LYTdb7LWXvNVdBiLgK4GRUBB2acpW,False,3837000000,3837000000,0,2
13qGDezw4YNs2NREbQDHR1iqY5HX8opjAV,False,3589000000,3589000000,0,2
185SzUftNi4PSga8ck1G68PTzwDgmNjNE2,False,3219000000,3219000000,0,2
14K1BciwLhXuCo8L94QzEwb8s5vAhbiXs1,False,2716000000,2716000000,0,2
1MKr9CAAdiZcotajzEn9g7un89fr9pe1na,False,2269000000,2269000000,0,2
14hezew7N3zbEg3dkcRiZErzKZPegVjZYo,False,240000000000,240000000000,0,2
1BmfDV5vPjW6tcSmVpB1hAAKny5G7RRd1V,False,9116000000,9116000000,0,2
1HTZtNQKTnX9tjko1Jkvb8Ju2MJTynwFAQ,False,1000000000,1000000000,0,3
17sb8HdjhdJKo9bZCnAFDFSME3M1Aeu5vU,False,2030000000,2030000000,0,2
146gbM4RtdAa813N5dqdv7tm1TjDCd3Rd5,False,1867000000,1867000000,0,2
17CqGQdRWrKGRebz1qftVZetu2Z1sRxUs8,False,32610000000,32610000000,0,2
1Lqo5zfsChnVRcJEbEyppEAGmzh3yJh61h,False,9111000000,9111000000,0,2
17GEhJCg3YV1GGaBVi18yUVy12SyiRY4Tx,False,1711000000,1711000000,0,2
1g6vEvzSDhW8qpRTGV8zwZfBtK23X6W3V,False,9106000000,9106000000,0,2
19umfpcwTSz6jvVkKd9AwhM1Qhxg5LBE5h,False,9101000000,9101000000,0,2
1DCBG4Pc4RDf6wmFyapEUmhygWyFZfxVbK,False,1560000000,1560000000,0,2
1LKkE11tLmviHSFELDarhNbEu8LCGbKcWs,False,9096000000,9096000000,0,2
1BtenYSv2Br9pJwcZjMMPuEvnfWx3WP1hu,False,1429000000,1429000000,0,2
18LJfUZJuzQarTXh3qcvfz3N4veasvDHAA,False,1300000000,1300000000,0,2
1NYm1FoxS86WqKaRytdYCFbDChuzrGQFNG,False,9091000000,9091000000,0,2
1FVs41pwxAVEnr4Nw6EGUUaxFMRdGbcenB,False,279000000,850000000,571000000,14
1FX5LiRo8mzjgMkGRta3MysumA9BrDHf9q,False,1194000000,1194000000,0,2
15qUV4zrNU4oHEUewnVenTom3p1BD38UQQ,False,1089000000,1089000000,0,2
1NfNWqzYTLzaW1Prxs8mNZewD18YLNj8dx,False,985000000,985000000,0,2
181SKMNjK1M11pMsYP1CJvtauyj9nGQkiQ,False,882000000,882000000,0,2
1N32oLGE3Yp13GsJJxMcQsur5DPAcWsPME,False,4594000000,4594000000,0,70
19RUmtAzGRBR1uuyi9HqnyStLuneznGkTM,False,780000000,780000000,0,2
1A4XDHqKbGsgJQrtrgkFqoksQRNWBpeqHc,False,680000000,680000000,0,2
1JqJENB6U1on6Mqce7BDTjgyFZXrtf64pq,False,602000000,602000000,0,2
1BnqrBfEzxW8yok1FADKY9xTgf56QcGdts,False,533000000,533000000,0,2
15RmXMDWTf9njnXCXGwELpSXsCRQKNPc9Y,False,472000000,472000000,0,2
1PdkiFN4CJW4dmkdU8BCzvcpsU7TXLwR1k,False,452000000,452000000,0,2
1Eju9ivXAgt9dwbZfQ7bs8giwch6FFDaTT,False,433000000,433000000,0,2
13JRnDXkKUZqRcjfqWF7HDuKegbLFvtk9j,False,415000000,415000000,0,2
1LU4QQUUuVvTohpABeomS6ccyuqY1xvNex,False,397000000,397000000,0,2
1PYKQiZWgST5DDYwruRZ2sbfha81pSUyM7,False,389000000,389000000,0,2
1NggcewfTKdBYznhqtzoD2mtyX8Te1k2NN,False,384000000,384000000,0,2
1K6MpvC4sPRVPo82GWzR8c4d8dZ5JmSsrv,False,380000000,380000000,0,2
1Edv4JUGj3cKtXFgCwkf2saheYUam48b6V,False,101000000,101000000,0,2
1HKT4iRSSEbvzmRuvS97uP7LxXyt4ZdNqq,False,9086000000,9086000000,0,2
18j3BnnTB7nqijnM3PxnZcE1WSvybDwALS,False,186000000,186000000,0,2
12wQ9GHcr5Be4nrr59ihG4Fhu5rD6tAqun,False,100100000000,100100000000,0,2
1DMsmV2ewG6Admk5pbxVyJRjNFWq8QxNg,False,558000000,558000000,0,20
1zKDt62KvcTSYGV1iV5yip2oRu8RF5XRe,False,62000000,62000000,0,2
1LADPXdCF6sWNsmvLP44ax7XKuuKSkA6Bi,False,9081000000,9081000000,0,2
12XCGWAN2uCFU7zZTVNGMQPGXmeRL6UjXe,False,494000000,494000000,0,2
15qU5HtAmSCbNpd27kud88ioGrZST83xPE,False,32605000000,32605000000,0,2
1GNuqYZcT9nFfE4AcKomNpoaag1YKEfwKq,False,7590000000,7590000000,0,2
17nk9kFY78nHNoFVvvoa7LhY76W3rc1UJZ,False,18200000000,18200000000,0,10
1MyeBvmWM8cDyj3pSaSPNwWeM68u8nr4BZ,False,9076000000,9076000000,0,2
12PzWPPubBZtjUoEaV9Z1cRx9ZjsXNsG7A,False,4500000000,4500000000,0,2
15k6mrZ4AAcKxrkhrjbWXRdMT2Y7wKnmNP,False,54573000000,54573000000,0,2
1KeGgmXCqXqTf9pGfyKtyVJ9B7gBwHFRkc,False,21815000000,21815000000,0,2
14XqstW9uHoonAdmwdSTXCeJ4QNdx7K3D1,False,9071000000,9071000000,0,2
1N8ar4zMEAXebycipQnSa4dXJquesVvFuu,False,1300000000,1300000000,0,4
1avhgMuEpwgPY9HoQyNqMtdPvgUohyvmG,False,30000000,30000000,0,2
1HmpdLZcpWKgybwQY8C4mmFnGnBSwA5Afd,False,5590000000,5590000000,0,2
1MTSivkzLEjZJ9SJaXihHs3qk2YwQAinn5,False,0,2000002735,2000002735,6
1Har5LCV6CkqCNzmRSy12AYxspXxg9CsXd,False,32600000000,32600000000,0,2
1EZpZd2b3sZ77ynSQutVYRx3V1DZ9TXBfY,False,9066000000,9066000000,0,2
1BVC1dacCj4q7T4VutLwkaSvN5piQQ3Hg5,False,3590000000,3590000000,0,2
14X8euVPpKHu2mEC8SfixEAs865u5QN3Z2,False,2000000000,2000000000,0,2
12LdWQ5KfkUtp4HaRYRyxvwYuJs4sKFSfP,False,240000000000,240000000000,0,2
19TZBEETmnbZCoMvDjeeDzNR5gj4NP8uQg,False,9061000000,9061000000,0,2
1CVQHTwxcSZTgshnJWC99fAbuij3Ke43hx,False,182000000,182000000,0,2
1LAeefviRN2XhQejq7N2EciFMHcwQGhXNW,False,4252000000,4252000000,0,2
18bmv9vQ67Yauu7KHz8vfiyS9RyFfCLvd,False,3600000000,3600000000,0,13
1DR9h4G6mebfmjgC8uS6vDXJCjUHmaS3dd,False,32595000000,32595000000,0,2
13ABjib6YRG9sUsyuv3p1ye925SZDDSpi5,False,4300000000,4300000000,0,2
1P7t5VTE5myJCn6Jky81KFNuhdWFCjX1N,False,150000000,150000000,0,2
1Pu1vQDAQQSVXwW75Pfk9ckcU9TzsGBqc9,False,1588700000,1588700000,0,20
1GabTW3BHyitXj4bKibczeSQ7zKRCYc7Y8,False,1170000000,1170000000,0,18
16wyV5EbC5TLX2hXb3YdqfmbbT5BHrB8MH,False,150000000,150000000,0,2
1HeDrs1XG2LQbE1P9FJeYpsx2wz2H9vs2x,False,403000000,403000000,0,12
1FXqqdw3jFVgp46Pwp4K2nHtPrh24UxTrH,False,100000000,100000000,0,2
1LjmTyRiJnDYgND7h1u8RFMPLKEN3cfWXh,False,9056000000,9056000000,0,2
15tqC8ULsTkeNEgR21FmmYGCvVPuZgu5XP,False,149000000,149000000,0,14
1Mgnn5RrBL7fjJestFvtsESAjUtmvt3rsP,False,50000000,50000000,0,2
1FnJ1hRSvnjp4AEMcdZ8jXQ92ox4pSYTj8,False,350000000,350000000,0,18
1Lr7LCVtJv1tA9WGhn8YUXyNmtPusN5egw,False,366000000,366000000,0,16
1LTYdaLGw4nVvTwogii7HPL3Qp7D2nEvcy,False,2000000000,2000000000,0,2
1PFZ1Je1B9Vp2hyLN5PeCv2zBYsHYaKh4U,False,1590000000,1590000000,0,2
12zK8GApFU9sJuxCNp8kQEbWo95bgDWR33,False,9051000000,9051000000,0,2
1JWvDpbpdgyDUX7SCpHyxuboNW6k8Mb7jt,False,470000000,470000000,0,16
12bEXEqGhevgGfN6eS6kpmBM1WqTVR6wp3,False,146100000,146100000,0,20
18awsuM8E4Hpd6nxV2KX61dZ1LuCW3Abbr,False,3952000000,3952000000,0,2
1DFavRdYdQfGjqwu4qEf5QN5WVdhvDqwHZ,False,444000000,444000000,0,2
17cVeS6E2CH2JvCzQ7EGC4TAKGRYdstAF9,False,289000000,289000000,0,16
1768Zy5A3pz59XQzdVGMdSGxSeH3BKV1Rt,False,3652000000,3652000000,0,2
196WE2NMTnBhUCTjCJS9M95W98dKoT78Fj,False,3352000000,3352000000,0,2
1HcLpPMu3gF7QC3nSZ8ZrtCHqw9k6UoeY9,False,3052000000,3052000000,0,2
1BL1K599RUrsA65XwBRqvgh2awf6oHzWRx,False,240000000000,240000000000,0,2
1MAccovVg8SL5cqEwmqqcrpaxuogrxQAma,False,2752000000,2752000000,0,2
1LWGy1SjqtPxWAp3VMMjooF8Gv4FQXV4Q5,False,2452000000,2452000000,0,2
135bpkUpv4pbcE8NqpC6B5c7neWbBT69N1,False,2152000000,2152000000,0,2
1PGh4B3uEmmJ9xZAjs7nj1MjiMXxdHJ7CB,False,1852000000,1852000000,0,2
1BAgDyNbiFDf9aptf6oTQCeZ4BnZzYfBjF,False,1552000000,1552000000,0,2
1NENByWYbmV7XMXvhgZUECdhoKeaTVVMxy,False,1252000000,1252000000,0,2
1NbS3gvb5fUdKGa6y8PmTeuhjwjMsyaUJc,False,952000000,952000000,0,2
1PWG4fbSEMgpDvrdazeaXqnPksSYz8Dj3q,False,1200000000,1200000000,0,7
1JKUrYBQ13phsWehHQ4NRaVcVpSvuuZSRw,False,4839000000,4839000000,0,2
1LFCKLeBvpqisb5u9NvMFKv2EoFvKhAzmL,False,4857000000,4857000000,0,2
1E3JfrgekWKpUrqakUFJdtCZ74wPqT3VRj,False,4855000000,4855000000,0,2
1HjCWCZBCdQKVmyryNYHWjr4C9fXyZThUL,False,87483007391,87483007391,0,41
124xdjgfxdwBkuJu2DjTe8AazfuXbDX4T2,False,4594000000,4594000000,0,2
128v3ykTq6tf4D5Z3fUNyuQcndKenjHLq5,False,4564000000,4564000000,0,2
1DdsYkj7FtPPkv6cUVsMnUXoDyjYLgSauv,False,4540000000,4540000000,0,2
1DvBu2dDFsKzTsLijEGFQKrjzh6nmKi7cn,False,4166000000,4166000000,0,2
17d9unCNBcmgkRPnZd8mw8tFvZawLDUAtR,False,3900000000,3900000000,0,2
1JHLkDaHcavK4hRVAUAp3jdJh9byALKw74,False,3290000000,3290000000,0,2
13EC29Q6ZEKL3adtGVUsJBk1Q5ZS5GsY7Y,False,2981000000,2981000000,0,2
18y7BPMrdSfLMYZMTm39z5XWZa6ZzZPqXB,False,2543000000,2543000000,0,2
151omnMQYA8ZsfEqqz92vmcM8yxurAt6gY,False,1690000000,1690000000,0,2
1CeACwCAsZgDEjBAgrLrNTAJRi1fD7vbyA,False,20010000000,20010000000,0,11
17KexYGzpCQ6ZEbjRthSnGwsBqdfieLHtg,False,9046000000,9046000000,0,2
15xgSZsVnCdnm5rykUy4AdWkndtEZEUoGh,False,50000000,50000000,0,4
1MC9Xk37FERRBJRDChk9rfXENuTAcCwYcJ,False,1994000000,1994000000,0,2
13pgR9GymNsW52FhGTeiUbVPM6uUXJ65AS,False,110000000,110000000,0,2
18NqW6dwhWptetMigrK3dHfKRaZy5s3ehj,False,652000000,652000000,0,2
1HkHfn5FF6QJBR4h8Z2eSGSSmzxK6Ka4Et,False,1548000000,1548000000,0,2
15ahBvc2SAo4kS1Nkp5yACXoJXYqVJqAV1,False,30000000,30000000,0,2
1JwpkGbkeLo4g1NKnurrjeMyzovVadKdSq,False,9041000000,9041000000,0,2
1Nv1MtsBMY2AGgsgxH1Y6W2mrZ2gNAb2UW,False,1414000000,1414000000,0,2
1DWhrWp6UWg6jv1tXCctF4yM3q1ft32yDF,False,352000000,352000000,0,2
1GkXfZQgpRcb7nLp7ZswEbJptUVwJQDRci,False,1283000000,1283000000,0,2
1JNCd4dY8P3ijfW84s878vsZiHgtB74cSU,False,52000000,52000000,0,2
1Geyp3M6SbStNGFESeSNN4CXVuwpGCswvM,False,1158000000,1158000000,0,2
1GiYrSxfyLiZGpKGBADw1ZZZXQHpQfYtaF,False,1036000000,1036000000,0,2
1Gtfsrea9LX7dviHHnZiTgZBoBRkSxQ9WT,False,920000000,920000000,0,2
1DomYPDpbM4dkc84preJ7Aoey7hUD3drAE,False,200000000,200000000,0,2
17xb7P73Lzvoz1n4J6dC1ZuwFRg5LoYwSp,False,4000000000,4000000000,0,2
1BSK2ygWNSw446wARB2tes2mR5UtBMcEEj,False,863000000,863000000,0,2
16k2khTVRiTSvGYPgkNC48NEY4T2kYv28z,False,807000000,807000000,0,2
1LBY9yTaWm6tX64QGFgGJTgc9GZL5BpAar,False,175000000,175000000,0,2
13uexWKHxf9kAa6JE1eHVTm2omvEeN19jT,False,4847000000,4847000000,0,2
13wG2rBosgQRWcP85HqZxrXekRYNWYaWCN,False,4699000000,4699000000,0,2
1J4NsUPP1mq3BPK2cYPcBB9WbeQfEjrSEt,False,4664000000,4664000000,0,2
19UyHwdwMviMiAKZoSC3Sdq1jChyXvsNKt,False,4690000000,4690000000,0,2
12Ys8wTMGRvFQRkRRcfAvKWMJYRXJj3rxo,False,4414000000,4414000000,0,2
1GAmPYEmobgkpmWgEWRtAFXwoFyXtBfMF4,False,4374000000,4374000000,0,2
19iZidcnThf417dVAWySEx67eYadDXbWDp,False,3787000000,3787000000,0,2
15aMCahPoY5xWMxHeHZJTmYA1XoAt7SHKf,False,3327000000,3327000000,0,2
1MbXhrzx1zdJcftbmdY9oWDQXeQdYm7qR8,False,2530000000,2530000000,0,2
1EBv7ATPpc3PqX8iWZ1XLwdBiVcACcXzPY,False,60000000,60000000,0,2
1LmU6NmFsdmXjxUrwwDQEwXdZwNxf7iysT,False,2486000000,2486000000,0,2
15x2VVbRcB3zZFLP1VdiQPDVtYuw7HoUx4,False,1332000000,1332000000,0,8
1DFv5WqTaD9j3aV4KXv8h47rY4T4mDhaeY,False,776000000,776000000,0,2
18eUtDR5YK7agCY5Y4dhpCch8XVYzYXRdB,False,9036000000,9036000000,0,2
1Js3FQz5uVArFbk1F3Jz7mV1EiojMduDin,False,2463000000,2463000000,0,2
115agzV5jr5jkZv3cQf5aAZxeqZuQ3qHip,False,747000000,747000000,0,2
1Pnwgwa5QPSM4DJ84BCitEcHMFmVXUy7pG,False,3667000000,3667000000,0,2
1JcBCcs4NSSLjmGTL77ZULCemnXvn1KGu3,False,9031000000,9031000000,0,2
1FWPyh1nbe6Wvp6qWTyqFD2pV8c6ZZqePD,False,200000000,200000000,0,2
1QAT2A1RPKyZNP8u4tNScGzf5zpDrAWDs4,False,100000000,100000000,0,2
15PWLcvyZDxZ95fST2irCfyaiB6XW4wUdv,False,200000000,200000000,0,2
1PnGzLtyWhrsFRjx71t4KRrDNLqAfdPnEn,False,100000000,100000000,0,2
1HxQfKYZXMz5g2UvmNNnAymqm1PP1tEKm7,False,2444000000,2444000000,0,2
148e6u1ELTbsxK8aunCKitU5HXm3WFjDw3,False,719000000,719000000,0,2
1Cxd3aPwceCji46gzunj9nHjt9GJKwyCWW,False,150000000,150000000,0,2
12pa7mmW46W4ptfa5UvD99xWFnQrSNw7pr,False,183000000,183000000,0,2
1M4PZU2ggpuBxptNoMPDSxNb5YLXdKEfNL,False,231000000,231000000,0,2
1FLv3gVJ8KAtDPa41LuD6NNXH5bj79xW4J,False,637677361303,637677361303,0,46
1KfEWjtJKDRV1ejSZR3cvK8rtu2a6MQGst,False,3300000000,3300000000,0,2
13cZE4jsSkVJ3nEP9nYzDWA7AGshh8giK3,False,9026000000,9026000000,0,2
1JH84oY7yvUi2raSF7UCto7kohiSiaTL8r,False,3334000000,3334000000,0,2
16BPvtSF2JB6swEn3YqJ5P5dsMK8Pn69HE,False,2428000000,2428000000,0,2
16VVH6ZUHHUDZQG2EwKmrEynbpMyN9KeAC,False,699000000,699000000,0,2
1K2BP7gm8wYC1MoSKCRYPK9TBq2amSV4z8,False,190000000,190000000,0,2
19N7gQuYRREDAVMjcHLq4fTGbhgbuJ477p,False,333000000,333000000,0,2
19FZnvwjy3BNZZnv2rtgJDBsUaHvH8eVQL,False,4889000000,4889000000,0,2
1DuCHVDXS3ujqhJ845iH67seCQiev21WYm,False,200000000,200000000,0,2
15BWHHWyMVQxYqMEiFRfM6Ar6FswBEDGvh,False,4736000000,4736000000,0,2
1GbGvoGaJgGeJsVKCGB82HTtPecXf9sorD,False,4582000000,4582000000,0,2
1CrZVKecYofWkA2cP8UahGyW3EtBz56iid,False,5007004335,5693266815,686262480,20
1A6SqstRD61or4bAWqWZJWctc7pDMM3rdJ,False,4563000000,4563000000,0,2
1Df4kwoGb9ukrnCMVWaeYhVhN2QVGNTTGK,False,4535000000,4535000000,0,2
147qtNDTV6NTAHrAp9y6nTte6rKsjZphhx,False,4210000000,4210000000,0,2
1PYiS1BAHDRL21XVWyLmUFEevMpraA9umB,False,4068000000,4068000000,0,2
12Yw5fgPaTWUexYjLaneysqnZWxmyTrDCT,False,3784000000,3784000000,0,2
1BVhPxMo4BpyR8kwr7UMfS6SpYquZUa8ar,False,3253000000,3253000000,0,2
1FZQWwxxejJFY1qRZv3MM9oWBHpykrgJAh,False,2326000000,2326000000,0,2
1BzS8TKYF8aw28aYgYMeY7rL8CuWZSA2am,False,32590000000,32590000000,0,2
1BXoKoZzUcM7jnsGvLd91zkZn8LgpPehnN,False,9021000000,9021000000,0,2
17BQT6g31FSLyYjRCrLLk4e1hJy1gMU8Fd,False,3001000000,3001000000,0,2
1EaHvoFFUxg4XMhbju1dayZ1k8yU26zZb6,False,3200000000,3200000000,0,2
1tjP6XXeAixMeHtdZ8ZZvqgNhvDQCTD3J,False,1358000000,1358000000,0,14
1wUs5KGhNP164gdBBGUN49FhamTWrSTc3,False,2414000000,2414000000,0,2
18QbqE7aeQ7uWpxXWh7QATE36x9N4JG4z7,False,2230000000,2230000000,0,2
1EFRnnYRERtSfjuStazt7ecQpe5WAxxMgV,False,680000000,680000000,0,2
1ELsYCBZajgkauQzNnKKp5MrH5zWTsoP3D,False,400000000,400000000,0,2
18BG8BBYuHe1uiRf5jGSmSN2gGKZgBhG1G,False,333000000,333000000,0,2
18Z3B8NDcaiXdYStYCmkh5Fqinnm66E2gm,False,523000000,523000000,0,2
19L5BJr5FxrGHft2W3Ji4hci8ibzBpVfHp,False,2153000000,2153000000,0,2
1FxtpkbD2xxExAp3U6kbZPDMewEjK5AzzE,False,9016000000,9016000000,0,2
1GjTEYZVwRcSqWyTWQ2UUeG2VTNrjjJHgS,False,9011000000,9011000000,0,2
1596VwUvsJEUPLKdXAoF28Jj9RZjzuZPZQ,False,46000000,46000000,0,2
1DeiJeNmVwXaM13KYXY4qmQtGcwfBDm2a7,False,285000000,285000000,0,2
1AtCpRSTsebtFDvepyPKTQEKwviRsdHYrK,False,50000000,61000000,11000000,5
1GhKyMgockTdL1EBXAufKKMW5vd7jw2aHK,False,671000000,671000000,0,2
1HsV8cKzCjnm46unCjLnBqdJ6bRhWQq2A,False,2401000000,2401000000,0,2
1HaGzkYhhpsbpwEEcjuVFK4in8Tkpd6Gke,False,439000000,439000000,0,2
15yJEMkgL8BYu9AydbLqSNcypw2jttPoQy,False,2562000000,2562000000,0,2
12mcEeLptDq2xTKxXdDRg52pY7Zsy2AFSg,False,2101000000,2101000000,0,2
1DovxWPKEHswJkVjauZSJMb5YSjBge4zXY,False,32585000000,32585000000,0,2
1XYfVgDKB6keWXL1s5hUbxEGR4dnMaMbQ,False,1929000000,1929000000,0,2
1BYdLmKWJEnaJgLvT7fmVA6uHt9h4ML1P7,False,633000000,633000000,0,2
1G5yAbSuiRZKGzQaZ6qi8ChGsV3ZTjdPrU,False,2053000000,2053000000,0,2
1AJ42YLZZgHtGUSAhPb42FrFRYhbzcQi3W,False,2388000000,2388000000,0,2
19zeMYnnpwQs7tLwf4QJT7C4mcyiAebW3a,False,668000000,668000000,0,2
1B3jqDGQPVv46iqqYaUYjFDeDwZE6dS8T,False,2031000000,2031000000,0,2
1M6hfEjroiF3spXmnCQYHTSgyFUhzLuRqH,False,2011000000,2011000000,0,2
1GggZPBtuGufnMoWfrxaLSikGNi4dfieae,False,2377000000,2377000000,0,2
13LtFCf1LNRroyLrA3p8yjtmHJtKFjTmUG,False,1993000000,1993000000,0,2
1Jh7TrajJxK9pYhQ6gwbkUBdBYznAKYcwZ,False,541000000,541000000,0,2
1MBw8yHigpfw3VZrzDmbmcDm7K6Pr9X3Cu,False,2370000000,2370000000,0,2
1GpJMthcK9nH6YGEkZAVb9f18jR5nvMtAY,False,1975000000,1975000000,0,2
14jPtRNAvMW1RVdxpcVssBbEBT4rWGQmPZ,False,2365000000,2365000000,0,2
12uLG9fpMoFdgqaDnufVGVygMbwHjKPajw,False,419000000,419000000,0,2
1ANiKM96tYrea3qXnVd5f5RKZw5CBJko9d,False,1960000000,1960000000,0,2
19KV3dh8ousF8urB5AE7YH8rytys2cH4HG,False,1952000000,1952000000,0,2
17RyDa9WbxLBHREvtY5FdND3thFsWAcdVK,False,1947000000,1947000000,0,2
1L3x7ypVnQP8Zm2j6twse1fvsFHrjwWEZ1,False,2361000000,2361000000,0,2
1EGapQdeXmHFQC7cZPUaNSuoia8P4KBUf1,False,308000000,308000000,0,2
1CmkhmAKZzjq7SkWpCoWU7PBCEFPbJfZj6,False,200000000,200000000,0,2
1E4e7PTzPirhHYVuMfQASFBrwJFagVzM67,False,1943000000,1943000000,0,2
12kUvwrci6728FSyUCxtHbX62TSi7EvPd9,False,95000000,95000000,0,2
16CrPvMRxCL6hcB9xUDHWRnDYecSsnyJmq,False,52000000,52000000,0,2
1EcvawGQombpDtERhbipsag75t4Ea3sF7V,False,1942000000,1942000000,0,2
1DnaWRkDgM2p7RtQsRKriFJwfHdELxVeMo,False,158034000000,158034000000,0,130
1NbvgZy1DKsV8XUF41CiL9xR4NTT69xqPD,False,96000000,96000000,0,2
1A6rbF4RaYkBJKg3dvdQikMGzqyTnxnfdC,False,100000000,100000000,0,2
1D7bQMu2XP9U9GN2NrD9We5ZvDCEGcwPxR,False,500000000,500000000,0,2
1C3mbNXyPALQgAirEmQVepfzucxLLQXRia,False,270500000000,270500000000,0,2
177DNw78y6YVtAaAMex8yGKiDQUZuftVno,False,32580000000,32580000000,0,2
15LRh49qHT2BJCoRdxh9CzHeeqQQ2ghLbZ,False,9006000000,9006000000,0,2
15ajcGRmbmYdxciX22mCX4UcuJjnJ59UsT,False,3190000000,3190000000,0,2
18QmT2Fm9s1Z8N3LdeeNXJVgobuPi35peE,False,30350000000,30350000000,0,19
1A7HMfKpxXnYbkZ7zreawUADGj2kpEhVgb,False,374000000,374000000,0,2
1K6SYwDfKJytEmE3qij8CCbnWuESj14XCJ,False,969000000,969000000,0,2
1MEffBUvG6w1Zz9xf3eHZn1xkjr3dn69dW,False,4900000000,4900000000,0,2
1G3kS1wzJ6TEFWFv8w8L4xVDaKS27xNiY6,False,3377000000,3377000000,0,2
1MFamoHssjN57DJATvgAAU2NW1V9voMhEN,False,32575000000,32575000000,0,2
1CLAfDS4LFKqWBjftjYmZsZhiJgZmnnCZj,False,8996000000,8996000000,0,2
19aAGmiVsZWSR1zbR5waGX59eGeWhiRrmM,False,2500000000,2500000000,0,2
19t5V4Wcdpvv7yNNHtS4CU4hwdfiTowiox,False,32570000000,32570000000,0,2
1NFMNJckNFYZWJHgSYkKGkvRFriBZMDD7a,False,8991000000,8991000000,0,2
13mZNXxr5aMUdXkYEDJFYL2HJYyx2Uo99j,False,57182080000,57200680000,18600000,96
1CrkUm7mfG28rrTKg1tyvkvudSsLNQZdGP,False,30000000,30000000,0,2
15H4uMwvWg5Gv8U9bHH7JeakLA2g5Fh66j,False,8986000000,8986000000,0,2
13kAAYLagzq6hYG4iByGX5zoKXjYksXxCh,False,8981000000,8981000000,0,2
1FXEF1TTr8KFZ4rLyRAd4Cq5A3me9xcp5V,False,4900000000,4900000000,0,2
14NnggKTkJg9hm4vgiHDyhkmLBSPHVmRSv,False,4789000000,4789000000,0,2
17KZELdVDKuefmh2TunUjrVtZLfYH28BHZ,False,4628000000,4628000000,0,2
16MeNnpnQ1ctGVUQzTVJmH22mUaZC1UmSe,False,4466000000,4466000000,0,2
1HReRjYLpN6P9Ddrag2jo7ALCBjfqkYgUZ,False,4444000000,4444000000,0,2
1Jovrr8mcjyrL7PC13Wzxz22sEUemJJqKy,False,4414000000,4414000000,0,2
1ABGhPzeL9FQhrdZSbdoEqscCmbGYhT61E,False,4064000000,4064000000,0,2
121PHZvCCQM3hwcSroLNPdddYXYpGk8DTx,False,3922000000,3922000000,0,2
1BqJpXyVpVKUC19RH23C1RvJfDQkKS8kZ2,False,3607000000,3607000000,0,2
1CR6rxYLsnBiTKHMknZproiiHhpMHxoaGe,False,655000000,655000000,0,2
1NBhrqzhc1SuC7oQMfMorD6fFvLces542k,False,2068000000,2068000000,0,2
1NFpdjKFL9cNw2QRacgcpMy9z9um4v9usw,False,1379000000,1379000000,0,2
1Mt39hknDLSvdf4dkL8EZkKCLxATBKHbyz,False,2190000000,2190000000,0,2
1KFeQejYrKZTG12xk8qn65mgmqphQV8ryt,False,1505000000,1505000000,0,5
1BURuksv4wvEzW9jQiqNCkivWGo8SQaiD1,False,30000000,30000000,0,2
17WWC4ExkdxEPVuQtWPV7Rw9eP78n1KWck,False,40000000,40000000,0,2
19M6ApoVsCD7oXh1MhgoADqEe5JWUqB9gi,False,14297000000,14297000000,0,11
14SwC1JmPE5bLCMQxVX6vezEADE6TVym44,False,559000000,559000000,0,2
14b4x9A3yjZEjrFrQnRFmsB6jtpm9Jkm9D,False,498000000,498000000,0,2
1FGVVGrq8pHtf1uqXj2FsDc6WK4nhvhLbB,False,439000000,439000000,0,2
1PH9pcwrTtBPqweHKaq5eJpUXd74qwbNLA,False,423000000,423000000,0,2
1Gw8HdaWTRk8Uginkowc4VyAx4HiZh6AmX,False,266000000,266000000,0,2
1Ern5wXDHg5G29VUi7GVZiagVtD7NbYjvG,False,32565000000,32565000000,0,2
16r2pK9zySywLi1beVRqCaRgCtW2rKkucZ,False,2334000000,2334000000,0,2
1NrE7RdtsLACgqaMsn4btePBi5dehAUY31,False,1357000000,1357000000,0,2
1GD8RUz1qGcnCxRVYdNc2Ze1Y7ApV3zAfp,False,1627000000,1627000000,0,4
1H9RqhmR3nyCGudyAbEn5sge648BqQzojF,False,33000000,33000000,0,2
1MTcYAmXxkeLZF4zD36KUPpDjxZ5Nfcdtj,False,708000000,708000000,0,2
1JmmHw647ASqxZDzVavvNdViaPm9SiTteC,False,2578000000,2578000000,0,2
1PTCPiuzYkhL89fAyhmKZVLFJM3G2AnVaP,False,50000000,50000000,0,2
1FNhVyBHyjDZYrtw4B2dsN7mGPmTnMV8LP,False,212000000,212000000,0,18
1C5WqGhmDATETG7vPsmnwiAHC1iLWraL7w,False,345000000,345000000,0,22
1EpN2vbh8czYaHFZk5yS3oiFmGzPnA5zxt,False,50000000,50000000,0,2
1PNPes1xDRmxvzcvXA1tY3eo2Uwkhefpei,False,1230000000,1230000000,0,12
1GXkDTX44MhJrApE1mjqo6NTtiVEiRGSHq,False,50000000,50000000,0,2
15NPrvmsHu25jpqpEBGrzGoN9cGfoGTb9c,False,338000000,338000000,0,16
15zpRRPqPFcsBs6xt27zhaTZ1DtJwoA2Q4,False,203000000,203000000,0,18
18wRXSwPSAtzFihHSMWxjeRZQunfAFCMf9,False,50000000,50000000,0,2
16erqDLsdNjuv4jg7dDNmWQECCe5wMvmb8,False,408000000,408000000,0,2
1Bpo7bm4y5Rm3KjXFEWkNC2xttkthD2zHc,False,233000000,233000000,0,2
1Bxm3xaEfaa9CJtGacoZ3YFdZKWZLRUbwT,False,400000000,400000000,0,2
1FGRiRbNWzatkN3ubuosA6gif9zUPRCbRk,False,1000000000,1000000000,0,2
1KpwGNwyTXHJfkvjy1ZopeeaYp6oDHW2Bf,False,395000000,395000000,0,2
156F1jsLckMimGu2mJp8H4iHmqCbFhKpJK,False,350000000,350000000,0,18
1JemzCbyvmhR6yHiuWXjfdVy9uv5HqN8CS,False,43000000000,43000000000,0,6
12QRRvpymysQexQ1avLcLuTXut74jAao4a,False,387000000,387000000,0,2
1JSEL3vZdXmaLumKXYttRNjUSpNgruFj1a,False,5010000000,5010000000,0,2
1PZc9VbzutdB4NDC3vvMj7HsfHmNnh8D55,False,32560000000,32560000000,0,2
1ASjDFsg4Jo1Kz8q7btqs5nNwnhGohjr9N,False,380000000,380000000,0,2
19aEFfzfs68nQp3tnSsJwWKJuRfTYyJ6bG,False,609000000,609000000,0,2
1KDJqgccVgE8N8NHVMPx8asXP87ztEe5ko,False,385000000,385000000,0,2
1GroYCBxxZP1WWp8PVueBxZVAbZYKtzmbR,False,375000000,375000000,0,2
12wtkZsXA6vtGPhzr8KZci9uDTA5ZuEsZu,False,32555000000,32555000000,0,2
1K5KDiYCfJZLrBxBBUQRk79jpKi16BGsTX,False,1969000000,1969000000,0,2
1G3u1v6LV9hD6sNuQdmnLLtjJ3oZwxoiib,False,609000000,609000000,0,2
14A1CQE2sY8vy1XeHh7KJoAjLpJPZupiZK,False,371000000,371000000,0,2
12tAir4mJbDMH4nS6oT1Sb1vEygMoofcqv,False,367000000,367000000,0,2
1UW9FfWRVgursvBCX4DL5127Ed3EQfarE,False,366000000,366000000,0,2
1h7AtJxz8N2wDWbbcu5Eq7618ZpCCveAu,False,1342000000,1342000000,0,14
1Aa7urLUEj5CTmotjpPM7AZCAZKiJNiikX,False,43000000,43000000,0,2
1LmGRTtmNS4bdi5BH56EuaExNufC4sCeiP,False,10000000000,10000000000,0,2
19bvWEntSbKfB3bxccr2v39c3f1VD5S8VQ,False,8926000000,8926000000,0,2
1N8bg92sjwKDm6Yu38PVqJGzLUaRmz3HjF,False,450000000,450000000,0,2
15Khm16GYt3VoAaZpZgTJdhrWQEB7fF9jE,False,50000000,50000000,0,2
1ALEmj1HRfGwiqKBER9pw21Ayxp6SDBUYD,False,424000000,424000000,0,18
12RAJ8ThFymMXk5fV6MRAq2z4uAXxJDKky,False,1700000000,1700000000,0,2
16Mm1ms9r2DXYXaA45WEeU3zLvqFZR8WUj,False,37000000,37000000,0,2
1LuH2NhmXDjreDD26GtdZa3ACTqUQSB8Yv,False,8921000000,8921000000,0,2
1HwCT7QhEZweXRoBYrQiHqU3SnVTZuMzkQ,False,8916000000,8916000000,0,2
1FdBV3ww2t2jbdYfiei8xncNdiXxMjSs1H,False,1329000000,1329000000,0,2
1Mu3dvYbcL6Vchurv1ZhMkzBYEuWNeTSi5,False,640000000,640000000,0,2
14madHrVGaTTcruPDKDcom91WG16gcwxoC,False,1157000000,1157000000,0,2
1Ge3oqUYhYtsnirnnLyJjFc2DrzA8LBfsw,False,4700000000,4700000000,0,2
1jDfVMcAmDg4n7QuyFADMW7tCertKwdMX,False,280000000,280000000,0,2
1399SNusLktn9tucaUabMbgYe1r8daCN9D,False,3597000000,3597000000,0,6
1MgHNzdUuNsE3N5gym5ojPuHGtPmifbosC,False,1774000000,1774000000,0,2
1PriaZBS4UHYRaABgM45gXZzsK7oUPNbdc,False,4877000000,4877000000,0,2
1A92EyF8yghNm1is5fYj1WivZe4tGTazWx,False,4882000000,4882000000,0,2
14eCb2yJqRzcd1d3g4XD3hMCrtRTVSMFqJ,False,100000000,100000000,0,2
13VFaiAM4EQz8qmPpr3qGgAWjnQAk5UmHL,False,4776000000,4776000000,0,2
18KW8rJgktpQPpiUBsPLF3LzJMfTWyvBEo,False,4665000000,4665000000,0,2
1GkR14Czfq3Y46L76tANNorsUXRnBTHpzJ,False,4482000000,4482000000,0,2
1LqT7zeWX1vw2sotc37fvXaKM7swkVJijR,False,4310000000,4310000000,0,2
1LczTqjsgdKR44hK4aEWzxmC1hJC7AiNUk,False,4281000000,4281000000,0,2
1PmN8ZSy5mhaKuEXZVNpMByNgmGtvQaB9g,False,4245000000,4245000000,0,2
1CCL2Mbd2ey1LCtkEBWiCChse6HVJXqwwT,False,3859000000,3859000000,0,2
1Huah3U5xDaoVTAqTMLfNUwNkW3Agag8fC,False,3704000000,3704000000,0,2
16XpK9StKieW1iKznWe6C426J2QxozA9zT,False,2997000000,2997000000,0,2
17hytyPCDr1Mk2Jg79ehx8PAcTqq2krG3K,False,1335000000,1335000000,0,2
1JWj3K7vNANgypxFjudiNHWQc2TypoMLjq,False,8911000000,8911000000,0,2
1Js3tGCyeYTfM65JZpKQbWprB2ftGsFLcd,False,363000000,363000000,0,2
1F1Gng7YrogYKZft2cr3StGNAhQywCKSaU,False,8906000000,8906000000,0,2
17Ej7etBNia7mMUdnh9VWJAtG4HxbW4C1f,False,369000000,369000000,0,2
1CquoipKHFiBoRaa6TYjuzLx7Y1V6sjKAC,False,960000000,960000000,0,2
1Eg97FrN25vbkvGJdTesXY3QpExD9LHftC,False,960000000,960000000,0,2
16br9BuJNeYpoHfrpUaW8nkd8AFcn3h7kP,False,197000000,197000000,0,2
1CCkZqmJ8ZmqBo1LWfYj2SANZp6gKJC8wT,False,47000000,47000000,0,2
1A4uufNpnUr3f9P3mex3C2qwHdPtQxs6RQ,False,1232000000,1232000000,0,2
1GEyuU21GqDNERZN243sBESvxx8vMAnwx4,False,251000000,251000000,0,2
13rDhb5R5WZBYyi3n5M1meVX94abPVjCjp,False,1129000000,1129000000,0,2
13xSbvvb5zzk3qCwYBrpaCbafxFw8UGAA9,False,1242000000,1242000000,0,15
1Dyihrw4Yt8JEtv6qzvtBmeeGHeXzyXZ4U,False,141000000,141000000,0,2
1PiprDD4hYds2mWRYHgsLGDuVCQ4SLiY2c,False,1028000000,1028000000,0,2
1BMterXkkMeyK7C45uqwYtDjNf75zzSDyc,False,33000000,33000000,0,2
1Hew666eH8gcxrb28uuqa98rW15XGuTpUQ,False,966000000,966000000,0,2
1MGejxyJ4x4FkzDm1odL9bnomRrCbjmF1x,False,919000000,919000000,0,2
1HXBiWmC3ma53hM5PiSTcYJYGw5xd9qPBB,False,894000000,894000000,0,2
1LmhJqt8iQfbNqnhdnnN8zfJcMZuSfhZAN,False,870000000,870000000,0,2
1DXdZBgQyzLZi9WCjfkdxTKUCw7hkw2qUK,False,849000000,849000000,0,2
1AEA7Sw8Q6yNrhsYVa9TWDoWQqj6SmyvN1,False,830000000,830000000,0,2
16EquBA1Nygnh36ZK2t56g7AXBYSJaStu8,False,814000000,814000000,0,2
1M3jTiHUHzNLwbQBdcQSWMgVwoYjo4vpg8,False,803000000,803000000,0,2
1NxR2cThP1ifcN1S6NxdsL94HyWVMTdbMC,False,792000000,792000000,0,2
12LtnG7LDefAD7hPz5WzaZfspSphGoiLwb,False,783000000,783000000,0,2
14ZxEbQNRfp9LGSc4bPKEusr9eZbzYBZhG,False,100000000000,100000000000,0,2
13fpzFMEFU7vnoijtUsaBbagbw8KD1AwiB,False,4867000000,4867000000,0,2
1Mczaqq87u7ipKNwLuEgEJHuTcnnAUYzSJ,False,4876000000,4876000000,0,2
129ramSKipjjN22GDJHAxAhAHUNat8Y9vD,False,32550000000,32550000000,0,2
17c5mW4dvdcULwhumqzEnAfnR5JpKja9pC,False,8901000000,8901000000,0,2
13V9SqqY4STuaT9eaQrTkNdRfVcTgJhBJV,False,4745000000,4745000000,0,2
1C1puUwwNgsC48z8YfxmMA42413J1kV4Eq,False,4625000000,4625000000,0,2
1EtkqZGFzivggsr2rcKJjPJATdDrwYCNQb,False,4454000000,4454000000,0,2
144pz1kZhCEYqoKZK9sAp98JgRYsW8YH2c,False,4266000000,4266000000,0,2
1yeXYYhiBUb1DHXgaJuApFfotw6cviq2A,False,4073000000,4073000000,0,2
1MxrDuBUJGhmujsXvh9KkSjNkgt3FvpvqA,False,3689000000,3689000000,0,2
1HpPqCws5dDrKRR3n8uPzhhMWBvCSWFAUj,False,2804000000,2804000000,0,2
122DB2cNskpH9TB6nEVpNXPGZEo7SdbWcg,False,2640000000,2640000000,0,2
1JGGkveGLtvxbcgKzzpVuT1UvUfRiQg42r,False,160000000,160000000,0,2
1A8ZJyKBActAspir23Xnyrav727WFcra3i,False,8896000000,8896000000,0,2
19eBJdiYDKMNZCT4sSdSRypHV24fLZWKGp,False,2552000000,2552000000,0,2
1Af4npGDg1r2WJvzarzKxSMf8U7cPgAq9v,False,2488000000,2488000000,0,2
1Ap1QKL74ZaegVere3f7K9zYDaF1zvkcJB,False,57000000,57000000,0,2
1PAYqTCRVE2ZKaK7F6w9vYFCsRwGi5AhYj,False,2437000000,2437000000,0,2
1AnL2567dc2neN7TeJbwKh3G3Fm45h2cNx,False,2398000000,2398000000,0,2
1J64a7tdqNWfF8wTk9kbfNtpnJFwNuWy1m,False,2374000000,2374000000,0,2
1EnuABctgYDspytSxXYNTKi8BMmBsZnJvU,False,2353000000,2353000000,0,2
1KRX7CMzW5pV5e2Wtvp7ViNn7E9gcRJuEi,False,2332000000,2332000000,0,2
1NqHxKsutNPNNnFrYsz86VFt6gmtnZaRCs,False,2317000000,2317000000,0,2
15xhEjy8aDbXNSB2F3bwumJapysp2uNAXE,False,2305000000,2305000000,0,2
12xv9pp6w8C5zGnXYuWjW449sjVqyGmktM,False,2297000000,2297000000,0,2
1LF5ac4ENmBojPS3JwotqBtAYGUS7hYJNU,False,2294000000,2294000000,0,2
1GUYAR9J9cJLw6P4kAj7oxsBM73u8CoqnL,False,2291000000,2291000000,0,2
1Fg287hUv9Wh1XddmjvaYwaKNvA9awzZWj,False,8891000000,8891000000,0,2
1Eu6RojUwqjrvuaL8sMVafv2sftVM38AMS,False,828000000,828000000,0,14
1Q4NshQGAWfduczPRzqUDRDfcdaVUgipaH,False,1330000000,1330000000,0,2
17gMorzLa9fgvxjfRxd7ddmLeqpTzSwpDn,False,900000000,900000000,0,20
18wyUDHfpo627TtDwmY1a1izTxyvw2eMWz,False,1010000000,1010000000,0,2
1MNdcE2NAJ58KviHphGzRZjzeU7YZdXGyX,False,5926000000,5926000000,0,6
17EeFDdhN9nyqNJsTaZumDtTcjMRnksw9n,False,50000000,50000000,0,2
17E9BE8HwnPbV1JDFPnUvVWCQo9pBWjdAY,False,405000000,405000000,0,4
1HPQUhEbU4ovUxDmzfLXXiB37h78wMLwzV,False,58000000,58000000,0,2
1HQuB7hhm8fxCEW3Wy5MdFfXGxqWSZAa6a,False,172097152,172097152,0,8
1DysS7MhDzjyGyvCzGfP9gw928iz52P8kt,False,460000000,460000000,0,5
14taagf8XRf5eJjPjpaXxdpYxc8ebANyy5,False,8886000000,8886000000,0,2
1EmURnFZ837UhnwDgGJeEKeUFYNj2uxkTo,False,170000000,170000000,0,2
1BPpVRYioabV4gtVytYnewcEoUFum3a9qs,False,30250000000,30250000000,0,4
15g3DbqWyJ6bFZpGULgVQPnhEpfA4wDpLm,False,3000000000,3000000000,0,2
194pSXDCkJernHvJChnViAnMoQzzD3fwZh,False,1000000000,1000000000,0,2
12R93bxMtsiah6Siaye9FFGRtSsb6MYsUD,False,3000000000,3000000000,0,2
1QBraUKhTPYL1NoVDarNzHfAr1hVcGZeVb,False,240000000,240000000,0,2
15EJh1rr9x4V7ymfRWGiDZU8ceD3nSHhcY,False,32545000000,32545000000,0,2
1KxfKALScekUAzCBz2FgGeAwhfEbdSP5H8,False,8881000000,8881000000,0,2
1CcB6Y7MQigoQEFgMBvz21zNF6ckMA3bxS,False,8876000000,8876000000,0,2
1GMPrg2sWneFhD8VZAeXi3SRqFt5mVDWfv,False,8871000000,8871000000,0,2
15GmAmkYLyNDzXiGB4GYT8WjhMoanDjUD2,False,4906000000,4906000000,0,2
13UP8fcCdZdsWNxN8CphohFoPVQoaDz4x1,False,4756000000,4756000000,0,2
16kogQrf6rB92a7H5oLareSAP6zU4JTWWc,False,4776000000,4776000000,0,2
1AXxdQCCcqYAZxJCfoNqahGPj6Y5n9A1aQ,False,4633000000,4633000000,0,2
15Cp9bqMTNbgpZhRs1ZtU5Hxp8gJbezfjf,False,4509000000,4509000000,0,2
19jShhNKVKuqgJPMhHY21ENndfbHByGgMc,False,4334000000,4334000000,0,2
19FZQmJMP8BhY52dw7N3PKBaYPMF8x1Cts,False,4109000000,4109000000,0,2
1PPEyxWQWKR7wGfs8xA26HVm2VRPf5yNpH,False,3904000000,3904000000,0,2
12DkVAHMnat1SzTHiKskjJhbjRirm5UCEz,False,3504000000,3504000000,0,2
1A5BR7XNYEGmCGyWT3qbQBRSj3nFqLF8nC,False,2506000000,2506000000,0,2
1HABCdfXCMYSoUwQStieqAdLqipZPrshKp,False,1291000000,1291000000,0,2
13ThJTiHF3BvW6TTWtdN5nCEZrrNrnb9o4,False,53751199603,53751199603,0,61
1GUJ9WnJoE2QgeT75Vr9akDQAMMY2PgSpN,False,1206000000,1206000000,0,2
1DmeeKhRAccrU2ieDCzAjQYvJgzj8Yccnf,False,200000000000,200000000000,0,2
12BBcpggF73nSNRf7xkfKU3QW8STX1kW7o,False,25005000000,25005000000,0,6
17wacCWvxPrBuK5VJwZYaSdtGvHw2B3t4e,False,3606544286,3606544286,0,14
15sHmSxT1aC9rX3NuA1i2q9KZfqL1HJ47f,False,2600000000,2600000000,0,2
1bCaG1ZqC92RiBbqah9hs8JHfH56Ykeit,False,32540000000,32540000000,0,2
1Js17WXpUzisxWZrv8taJ3fBHcaKocVDhK,False,8866000000,8866000000,0,2
1HZM2zeEJcSU6GhJ1MEEZEHrfhz3AVLTaN,False,1148000000,1148000000,0,2
15kfw2ZPfjrqpszkd4nWwx1xqra58qEBYL,False,5000000000,5000000000,0,2
1QJKVKRKeEfNyeJyWg5iTYdN2YVE611mtY,False,50000000,50000000,0,2
19yWu7nG9XgoQhZkkYW5Ws9ST2gTdcgqpM,False,149917840,149958920,41080,3
1G6rNJ9hQqdS21Ug3dUEbSoHT797wDavue,False,2005000000,2005000000,0,2
1BfqUQwwP6hr7GpzdvXMN1s9DS4ZCKaBxb,False,1100000000,1100000000,0,2
13vRb6dyP8Lrru7gAc6N8MP9SDee4f3ozq,False,876000000,876000000,0,6
12eVimMCqrfKsE1npvDzTMhiCqvWCnQSHD,False,32535000000,32535000000,0,2
193hpiduWnoV2PoudcSPWnkkFbPaQkVZtk,False,8861000000,8861000000,0,2
1DTXXiqdTQbPMfwAkypZYkrYmC2zhpZm2f,False,1098000000,1098000000,0,2
138GxqvzM2ip2CrPhZZQE6KUCQAGYvJ6D8,False,7374000000,7374000000,0,2
1JKAu8jTdqkXhoh5HGm7T1p6tp1jykz8yp,False,1100000000,1100000000,0,2
17TXxfDJEQp3AbYfdBTpCX6DRVg2v3GYMu,False,4061000000,4061000000,0,2
1FxJKaZ33UzZ1S2rF7gVP37VNwf16GQAvX,False,9899000000,9899000000,0,2
18S6QqqBztM4rzJdQWus2eML2RFohcTnA7,False,200000000,200000000,0,4
1KRCQ97JswSwb8dAf3wCciPeBuSNkZcfRz,False,8856000000,8856000000,0,2
1HxXf7vtwNYP5LVdTdGAqRVHHixo8Apfg1,False,1078000000,1078000000,0,2
1JxJTYJWK5FyQRRapNKQutd2CoA6YptLQA,False,600000000,600000000,0,2
1EwsVRfsPBwST4seU7gUdsUDNhQSZURQrj,False,1300000000,1300000000,0,21
1LihaL3U2iqQBZRjD6heRGzDqu5pxFC3kD,False,600000000,600000000,0,2
1A1eTTb6agiZjLL1Znjuq2Q6mhtB7cdiR9,False,2000000000,2000000000,0,2
1G2chiSMiHGk1ZDKeh77w42AK6xnWwf5ZL,False,1070000000,1070000000,0,2
1ESVzgQJJFcC3WS7HirwdzLTNfnmYZNcFX,False,1063000000,1063000000,0,2
16BTop8hPf3fXNh9GLknyS3bpkp7jLwhAP,False,1057000000,1057000000,0,2
1GQuC7P5fbYDFZKWcvZNeJ33BvtJX1Vrrg,False,1052000000,1052000000,0,2
1CUyimqKY9sR1zsxuoRFLLwaovBYbSb324,False,1051000000,1051000000,0,2
17jxA3V6Q92BfKtdTvr4wfELLaK33KGZuQ,False,8851000000,8851000000,0,2
1CJs3DiNbD2yHs987WEbeazMmug1t2zgfH,False,1182000000,1182000000,0,4
1DEY3nw7vUMXm5SoaVLxMG3rYeY5nPhmc,False,576000000,576000000,0,2
1BuztBNqeXriXwhMyyRHy5j1CfqKEFFqjA,False,8846000000,8846000000,0,2
1JW2t6t87ceG6y7ND1qbiDWcvxTvA2NEEy,False,4943000000,4943000000,0,2
19Mo3Q4eAb7W6xgCLGBHEkbWEYPKA5uykG,False,4919000000,4919000000,0,2
13VGAyL2WhwMrjdb5XHn4Br1nvV114nzTh,False,32530000000,32530000000,0,2
1GtwXQbFSo5eDYCqWqB3765NjRWCX8wwG2,False,4824000000,4824000000,0,2
12etHr8GMbAN6y2Q2rBNwacofmA9oiurQb,False,4675000000,4675000000,0,2
13Akftzi7ekz4a5C6MpZrvUMTgyaqti4ZU,False,4654000000,4654000000,0,2
1BXB8wZ6BpbpCuNLjjAUpGqr4dGDx7GKMo,False,4516000000,4516000000,0,2
1HABcXnv8tAcsBjjyqEs79uAj7vWbxuL2j,False,4383000000,4383000000,0,2
16sGxbFiy575W3QCfA9zkUWJZSbw4UuK7j,False,4201000000,4201000000,0,2
1C87c4aoWh4Wi6g8gXZBPc3xAwKxqgPLBn,False,3947000000,3947000000,0,2
18FnUe744YRaKz9gp3jShXJPH61AAUPVHv,False,3721000000,3721000000,0,2
134ncUuddN6mcqDEG1T4cmHUKMem83TE18,False,3232000000,3232000000,0,2
1zDyt78xQjoKnx5wonKj11jLziqHo4PAZ,False,456000000,456000000,0,2
1LoFWD2QbcS4WcrbVgR3LF38PwMZbbdFeG,False,8841000000,8841000000,0,2
16Rd1V445UeTciP6dYg8hykA3VY48Dxvpr,False,759000000,759000000,0,2
1BYajoUQ2jYoTJ3fGfaS1XkKk6ETg5MtrR,False,436000000,436000000,0,2
127YaFAmTqF5QmYitdLgizNMic4hhdEoYb,False,417000000,417000000,0,2
14oN5xkiM181Z4nNu1v2dgFgHC6jJg3njv,False,401000000,401000000,0,2
1HbdeLUxid3LfNPz9DqmYGtQovBEDtX1sA,False,389000000,389000000,0,2
1AU1npAnGE4fHN14rbDqvQeQV9mk5fZe35,False,384000000,384000000,0,2
1NCv5pPbc854LAgtWFNeK4GRfv5a1u8W8c,False,381000000,381000000,0,2
198W5xto23wXq3GknwMZMS7hxpJiBqqTRb,False,378000000,378000000,0,2
17L5MLqgdgZVzxYwQrwj97eKSaRTCmPuB4,False,377000000,377000000,0,2
1rXx56Gzn4mLK3PsHhQKEsrqq3YHTLE49,False,376000000,376000000,0,2
19nHtswfCfw5UGHDtE2NVKEx7KFp9xwT3C,False,900000000,900000000,0,2
18sJMJ23mWUxB5B1KpBDBE726u1APYo7C2,False,175000000,175000000,0,6
18EdpZSWKf3TYdVEgRjYA72kJZEADeTTe3,False,8836000000,8836000000,0,2
1B3e87Mq114UoYnWUtxRe4ua5oARYNSi4C,False,213136656956,213198469134,61812178,92
13YCPTqVHY9VDJbpSEXJ3kvwhwBv8YAhhv,False,90000000,90000000,0,2
1GmMPPMFavPeqjxq58gaJQnJ2MCU9wHfZQ,False,150000000,150000000,0,4
1zZgK2Hvn4wkVBLsL9mtgWMkC6yMtDnag,False,50000000,50000000,0,2
1L2VYVt4Cw9mFphJuxyCLQBUwmeHYep4Fp,False,8831000000,8831000000,0,2
1JLVQAk35bBY9L8UQhdGnbwjx5Nr9EVTxY,False,40000000000,40000000000,0,2
1AX68anpiLHCxEbmEpufBPjWFjzRMMobW5,False,4862000000,4862000000,0,2
17v9fi6FYatg7YkxFBw9jmPqmZ2GqsTZwc,False,4789000000,4789000000,0,2
1Cih9t7QDUN8JrGMundFh1Ru6GNKKodfP9,False,4759000000,4759000000,0,2
1HrVeFcoZKxFpkNJnCaj9kfSu4s97XeiU9,False,4652000000,4652000000,0,2
13yEvxLQN1KaZFjX1J2YgE7uMbP9xD5Luy,False,4485000000,4485000000,0,2
1CJfZfjDn4VLjZM19KuGVyPFs6q2DS5e9y,False,4436000000,4436000000,0,2
13bRo3xrBtNXv4oHSYbnUaZnYZoAZx4AWY,False,4268000000,4268000000,0,2
1BPxuHUMnL8teXitNNewJxqyaogMGk7o9c,False,4081000000,4081000000,0,2
158YS5NBVHPXft8sxh2uUVtcBTDJbfUXZe,False,3671000000,3671000000,0,2
13182LN5pEVCyQUGdax4rqrMZEnPz48EDb,False,3369000000,3369000000,0,2
1LW32nET3jCzs3GwuDBN5oLMWWFKWB7PgD,False,2975000000,2975000000,0,2
1FC1UMtZiKmJctXmvLoitYZFj9EyznH5Ht,False,458000000,458000000,0,2
1LcTv7UBnZd7UT7mwJ33PNGaHSCdXxrxP7,False,2865000000,2865000000,0,2
1CevfXCP8snMNc8JrvoYUEPDD57ZSYApQJ,False,321000000,321000000,0,2
129TCfBEeAH3D2kighqCMwR5bTZYqzuy8e,False,130000000,130000000,0,2
17yFaRMvmvCpjEzuujAGacvDV33E8L7PjN,False,196000000,196000000,0,2
1Q4oRZ866JuHbW6oUFEzgad462HDaLxoL8,False,8826000000,8826000000,0,2
1AB5MGj7NKNbjM8czEoUwZgX42qB64xCnv,False,2759000000,2759000000,0,2
1dwYEtYASuREGHsV3dPvjUdg9xsTgZr8D,False,2657000000,2657000000,0,2
19kgvL6dwayu15cQKSZEGKVDNGQoT2vYRx,False,76000000,76000000,0,2
1PgyFDXwQ7QHKUyj3nmb1NA2cLtSWHPxDJ,False,2557000000,2557000000,0,2
17UDUthRQGrS464XzbQoG5N7Q1X5uRbnup,False,2510000000,2510000000,0,2
19vmXE482Jj5Vj2uEnR91eDSQkBSdtoZ2r,False,2499000000,2499000000,0,2
1C2cajtxmtiLhoAiApqzdG522XTzxVdafd,False,2489000000,2489000000,0,2
154ty7YQZfr3q8F2ZnKvkFPELo1KxaE9cM,False,2479000000,2479000000,0,2
16Gqm9bc3sANRvJYqNUdod79tGs4Y3JrfB,False,2475000000,2475000000,0,2
1AbeBky95hoGKbQ6BVUkJRJkZ7oXxTAYM,False,2474000000,2474000000,0,2
19qUARYGYEGDhXzfhgWmG3YtH78UST1sCG,False,32525000000,32525000000,0,2
1NwgNwjf4pGr944Cwmc19iVPQHuR237LoB,False,8821000000,8821000000,0,2
1HJLweJoSSZ9QLj5dhgJ6QdEXcesFwraPm,False,230000000,230000000,0,2
18Rqrqn6bJRSKHhXcXdhJcgwgPFmCEMPwX,False,115000000,115000000,0,14
1NBvqXwZE6LesmLSebss4jb9nyVzT3CsVw,False,80000000,80000000,0,2
1MRXrpxCe8ujQoNPQosKWj5Emy4vXJXsgz,False,220000000,220000000,0,2
1AhwnckVReeQ4ZVMWjqREzASgBVv4eRkxj,False,8816000000,8816000000,0,2
1GKiFhk8ek4CyXGJhLvewzxxn6AXKb6yxi,False,210000000,210000000,0,2
1AuW1568z3TVVpwdfm4uYCkqYvMMteRwHu,False,35001000000,35001000000,0,10
1GMQRckp7pwdfkicJjGQ83qGgffweudsqM,False,4851000000,4851000000,0,2
1BPyUiDjtNwuYgVnEPgrkHCEDD7GDMPaKr,False,4851000000,4851000000,0,2
16qbNYidvEkfMj7SRTjYF3o3YWNjqUcWR,False,4706000000,4706000000,0,2
17enZ91SPWAdRTvj3fZwBpwfTcmH9Cb3zq,False,4617000000,4617000000,0,2
1Jt5SaCoydBkppt5hcr9kHDx4ZjcsWikLz,False,4573000000,4573000000,0,2
13QFTwW7h3LHBibNrqkUUhtN3GKNPBdUg1,False,4441000000,4441000000,0,2
13DHkKtSw6DebeiCMJ89hCMnTmQAbbipT8,False,4240000000,4240000000,0,2
1GTgfsikuDToT46qTCJK69qbJ7J8fcuJRf,False,4191000000,4191000000,0,2
1FxxgbqwdKpYXUoj2KoNPyMVePRqCJDebH,False,3733000000,3733000000,0,2
168YWRMPJV9xfWLcZz6vmexv8Yz9mq2nT7,False,3500000000,3500000000,0,2
1KXVdDiRFnFm8waiHLM1hFRkTMVWFfaPKB,False,3087000000,3087000000,0,2
1DPAEf1E63xmnqNFeocBG7pbCKVsPcHTkC,False,2750000000,2750000000,0,2
191pXsqWw4NiX7ZZHpF1cy9TGHK5TVjHu,False,1808000000,1808000000,0,2
1F62GWgpzbBDsyc1UUiLQoJPj2bC56R2fQ,False,8811000000,8811000000,0,2
1PJtL5Y6BsbQu5nKkpeeKAR1k8ZZ1APRTE,False,1679000000,1679000000,0,2
1Aw35LmUBQxMvVw3iaKL63zarNEiWuzkeD,False,200000000,200000000,0,2
1DDxkAwhqz3pgjjuU29CqAKVcdfkHVZTDo,False,1554000000,1554000000,0,2
1Gi2CWkyDrf7thLYwihBQrCmDXPisWMtiY,False,190000000,190000000,0,2
1DhacPfa3wFEqCJUwaP8pj1PeLKXUkNNvS,False,1437000000,1437000000,0,2
15gEi5zp8KJUxKxkTopahoNXwEoA3YGR1u,False,1321000000,1321000000,0,2
1DCjSwg18UYbg5dDZHKKn2oEHoJwZ91ya8,False,1206000000,1206000000,0,2
19ubQUCJgbT6PYDGGnoqAC7fj4iV4RQh6y,False,1096000000,1096000000,0,2
1qP6TyMSi1hN8A25Grw9YP844L1gJAtAn,False,991000000,991000000,0,2
1H1KZ5uLDDKuUV4wfgN29MXSbY7xKDocUd,False,886000000,886000000,0,2
189AoRLcU3n7A6zgsrhMnyNPEhpwU3Bna5,False,783000000,783000000,0,2
129joUCtsvquRd2QjKGP33CF5LHYFKoRNs,False,180000000,180000000,0,2
1FF6Az25R1X5ZeDKBWAgdGCEVfxwesomBK,False,681000000,681000000,0,2
1qZGQG5Ls66oBbtLt3wPMa6zfq7CJ7f12,False,504048576,504048576,0,12
1JTbFKjnms6bxpLE6qZ8zFpP8oAbti7Bdi,False,170000000,170000000,0,2
18u7nQHPTRRXeEFEAP8i3aQWJbEmGTHABy,False,615000000,615000000,0,2
1Mfn8YueoeQw1m3M1ot6Ex6cEEKmmEiFsw,False,575000000,575000000,0,2
12uHAFn4JzyoG4keru5X9Y46i7dBzkwD2V,False,542000000,542000000,0,2
14YNxfw5Hi7u6n68yLhYGgg9Se8izmY4Ze,False,515000000,515000000,0,2
19TpPCGpYbBuMR1a96h53DgGWpEzVVQw3z,False,499000000,499000000,0,2
1MhXirifvfoi1Rsxiu5dE7AZ9QrjX4AEtz,False,483000000,483000000,0,2
1PJxzKRUT7vsi2YhnSiZUZoQNVijrAwVcC,False,471000000,471000000,0,2
13a9dPHpXu1RNCxBQcbRhtriEWVHZJZfgD,False,34000000,34000000,0,2
1LrjpPJqPVNNdX8qquEmAkdQ7ZnkR85r51,False,1824000000,1824000000,0,2
1AKqF4kpaiHy3AycUC9GkrjPxdSbaGC6vz,False,8806000000,8806000000,0,2
1PNWRZtkFkMomNKRhbvJgr5bXh7VJWPDHk,False,459000000,459000000,0,2
12zYgyEc9ckv35m8f4rrzveTi2UrAgxZZQ,False,449000000,449000000,0,2
1HnPH3jfp2t3egyDVLGZQcAbWwJtaJAQiu,False,442000000,442000000,0,2
1JfNFj4fpb5i7xNuRCeET3eoRWfWjYP8Pf,False,436000000,436000000,0,2
1LmEVVmA351PjPH1kQWRGmvNbEzHEd4FNk,False,431000000,431000000,0,2
151xxKyszYK3eaNdVZ2VVWuxpDDvosGc5P,False,427000000,427000000,0,2
1LQbmo791mwv9ybAcYAXq924rq1roz7ebh,False,425000000,425000000,0,2
1BLPuViDssfDA5mtZehNufRvkyArGvFmdu,False,184000000,184000000,0,2
188ts8Pe6dTGNhEh72iRJL6puXT5gXV4rW,False,1000000000,1000000000,0,2
1BoKHbAkXdVUhCjiVXA7GQ256izF4u7Yhw,False,160000000,160000000,0,2
1yKT8wxkEXmyjjWVj4W9hZfUATL4859pT,False,150000000,150000000,0,2
1EokjXWFm2L99sedAefhuTCmc6zaYJPN25,False,1900000000,1900000000,0,2
1ENtsVvNy8Hdk2ujRyhoqXefC6ABGSsgFn,False,54000000000,54000000000,0,6
1AKTxxbPKpPmNZwE9QvNT6o2LccLTvjf1F,False,7000000000,7000000000,0,2
1AX2UYmjV79cqZrhzdtBdAcvdgV3d3rJaG,False,8801000000,8801000000,0,2
1E5PfUkf5VjfR8gLnoZovXKqpXgA7hxMJe,False,48000000,48000000,0,2
15xazFxPePHRu2CTNYV3rgFfRk5ZdFr2Er,False,65000000000,65000000000,0,13
1Eby3FJdS25dgb8JFzWcGbbvoWX8NUBbmP,False,32520000000,32520000000,0,2
1EhPyhiFS32zCz6FBwJMVpWRsto7jW6DmD,False,8796000000,8796000000,0,2
1C7CEMP45xQXzuQavRy75UvxL7ak9dBi3r,False,8791000000,8791000000,0,2
1JXHhsqz1XJowt69XeAdMW3xGQYNbUAdvY,False,0,80000000,80000000,2
1MQjDz5N2xf6W81sTQvkj1jcRFU4bqMumy,False,140000000,140000000,0,2
17QCBjoQ3CmwUjgUzfStBMAPUm8a2azje5,False,25000000000,25000000000,0,2
1F417eczAAbh41V4oLGNf3DqXLY72hsM73,False,20667400000,20667400000,0,11
18Fu5D6qy71Mx2WgW3YLvgqMvACeNqXpUD,False,33000000,33000000,0,2
1MeBd421khtzrQoN2Nr6jayaejZmpc2nLy,False,8786000000,8786000000,0,2
1DyVgWEG377TS1oiQpvBzTCMj5sJL9Eq5q,False,406000000,406000000,0,2
1DTre3WecyyzeLwzq5rg7JuEmgqaefVpZ7,False,8781000000,8781000000,0,2
16kpzFi6pkYJvY3m2CwtH6ZfMm3yxstPkm,False,1116000000,1116000000,0,2
1MmpjcRtrnznFmSQuioBxumzHycLyd5r2V,False,32515000000,32515000000,0,2
17M1jX7UFMR1oDUpDc94jkruW4Q8PsnDPQ,False,2500000000,2500000000,0,2
132A8s7zy3qgAFM4XxAynDvesTxUvgSBbb,False,8776000000,8776000000,0,2
1GKYZCsk6KQiLg4pUEhyZ5J6HNFSVNBm57,False,100000000000,100000000000,0,2
1EwbBb9b82AqLYBfJ7L4ynZAdrekDNiFZ7,False,950000000,950000000,0,2
1DrMcmS8ApbHc5UmdJkQsKpzM7i1PKdeAJ,False,2769000000,2769000000,0,2
15jXrrJtaa4ckRejK3uhCcsN9AJ4yMtSFC,False,46865000000,46865000000,0,8
1LrEKZmwp4zKbrSyCSEErqkxhLkB2WfutP,False,4700000000,4700000000,0,2
1MPALfJ3MaYdizLneZNabjGSYPSBeAQDPJ,False,41000000,41000000,0,2
1N5MVQ1H7cAsFV3vkuL8JbaMw57ksbKq9h,False,9000000000,9000000000,0,2
13ySPA8swfJy8FvhzPjzgYNbZCer9icHop,False,1000000000,1000000000,0,2
1Ean98WHsVxYLDPK1tgKbkBhgnjs9tdfHD,False,4888000000,4888000000,0,2
17W2gsCffrAfQFtzJ6b3Sa31zri3zXZTi6,False,4891000000,4891000000,0,2
16bCZnsaTbZU6rzL5ybErKPPn5vzLCsQrJ,False,4890000000,4890000000,0,2
17uqUK7g3kTvEt1c2n6ZVBZsuyVFSiqn3n,False,4733000000,4733000000,0,2
1PKxM3iSUbkpvn4NYHmNnyepocUCzzRaMc,False,4739000000,4739000000,0,2
1NgEjb4Z5QXKkZAPVoQJzUG4DmX3WTa8H6,False,4588000000,4588000000,0,2
1DGeWfvLY9LKWrAQGjFjPTUHduEAt8zFSx,False,4486000000,4486000000,0,2
17EYNFxNJj5ZqWeSfiti75SgAmrDS9oSHC,False,4407000000,4407000000,0,2
14cqNaCc7RCiqapb7gfDYszKxhh7Stpy3K,False,4273000000,4273000000,0,2
18Ed2xaL4zzo25JqRKzhi4wBXXnZKnjQuF,False,4060000000,4060000000,0,2
1K5oA5WW38s1ECcbqLu9WYXUpFJkhquRX1,False,4003000000,4003000000,0,2
1DPBJ19dPFK8qTnjm7G7kjXJGcwCxcwhPM,False,3540000000,3540000000,0,2
13Hyi6UXCkoXhBLD2VtFRT1qyntWBMDUdL,False,8771000000,8771000000,0,2
15L2NBmdh6g2jhhTVBDNat5hn5D2NaD4xR,False,3288000000,3288000000,0,2
1HYnV6S9MR4LuxpCpAdgKnjxm5CgVsHWgy,False,2841000000,2841000000,0,2
1EPK8D3jzR4n2qwJpajbAT2WPeSER6YQN9,False,2175000000,2175000000,0,2
1CQw7uz4ZS52D3gPgmhRVbkDrpL3CuinRm,False,13286000000,13286000000,0,6
1KXxdTbURFGvezpJEAN3Gu9eRoDYWPc2BF,False,31000000,31000000,0,2
18aF7XEPhcEoQoFvJ8QZVHDFeexSHYFzHk,False,2071000000,2071000000,0,2
13rgdqmgJ2n2MiHeaPeFLJXXTQWZGdC8pv,False,23768000000,23768000000,0,61
1C34yxbn3GqGacz36AvJX4hZeo5DoR6Vmt,False,2007000000,2007000000,0,2
18zks5D28zuVGziBQHbKht8gvb6KMv5EUk,False,1957000000,1957000000,0,2
1AZMMgDuDcVKmSHyLuMkajSzvZn5QE2f18,False,1909000000,1909000000,0,2
1DVzt7NTZ3Z4UwY1VVHM7STDmfMGH1m2Rc,False,1886000000,1886000000,0,2
1EnRi6Y9g6kykwN7gsxDFSGsgZf8uvza5n,False,1864000000,1864000000,0,2
1Kd4XHmbGnqcge2Tn5m4fALKQRbmrE65uR,False,1844000000,1844000000,0,2
1BTgHJyyGJ68B7WnUD28at97TopL95Sx7w,False,1831000000,1831000000,0,2
134UMCT1VeNBD9C2vsNsoaLrZYYLfs5BGY,False,1822000000,1822000000,0,2
1NChvnum6AfUBW3KjT9rZGwXyGGoFJMk4M,False,1816000000,1816000000,0,2
161GFxwt2ED4L6Ngxi8zq947KQwsPNqYMe,False,1811000000,1811000000,0,2
1MH9Zss5F1tFUS7BtTpiPkRuJZdXLdjTTj,False,1807000000,1807000000,0,2
12NcKibR7ZLLeFUV6PYtFB3fXo8A5SFubU,False,1803000000,1803000000,0,2
1GnbWdUZ2RTe2grefhhv3UDbb2aQsjDgCd,False,1801000000,1801000000,0,2
146CuZqwXm4GYzU9LWWrFCMtzBPrh5QVDh,False,1799000000,1799000000,0,2
13uf67mxbWxhqdk8RCi9zQ2uewR4kV4BEe,False,8766000000,8766000000,0,2
16YKoAPHrYyEodT8YcWbshvB3ctE5jvWkg,False,5000000000,5000000000,0,2
14RuA24Et4d9L3pQWos1nUF17VvnjWyk5M,False,8761000000,8761000000,0,2
1NK5HTYgTAxhaczs8UMxgxyqAfKJs22yQ5,False,8756000000,8756000000,0,2
14nyor6Gv9q9RryYVBGGxN53kTPfS2kqTA,False,4825000000,4825000000,0,2
192ckZR71KZaykqmMMmBRqjU7LP51xgskC,False,4797000000,4797000000,0,2
1MArSQ1W7mNLEFQCv2ahBFFh8boYHREqS2,False,4816000000,4816000000,0,2
1MSoY6Y1WWuppWoYHgnrJGXH6qgqyeDFrb,False,4645000000,4645000000,0,2
1JxcB8GCzpfPCy3WufYzAURRUmBc1t9NcW,False,4630000000,4630000000,0,2
1PsFs1drDJCKeuipneVu1nso5Qdd2Bb1Bw,False,4480000000,4480000000,0,2
1B7fAYr6HcNSGtVaTuCfLkGMet5LrN8GEh,False,4367000000,4367000000,0,2
1Bm1rwsdMDfLXtuhecJSvQYcNGohwVirhn,False,4127000000,4127000000,0,2
1P3Ev9sRVFqqusTeoSqEv5Lkk1sCcNUo55,False,3810000000,3810000000,0,2
1QJuNoJE9x4BGC3Em3hB4tHSXRnyDqqQdG,False,3258000000,3258000000,0,2
1Ha6nBynzbXkEELH4DvVu3Xvr1SHzsQWYQ,False,2763000000,2763000000,0,2
1LDEmHakvkdTqd4rFhJ4Snag7WKsowjGiM,False,2216000000,2216000000,0,2
1MCuyriT5sgFmhMV15eqxEU6Kh7ZHMTFLp,False,32510000000,32510000000,0,2
124LktmshgNWPYhqcLgrNkE8ZUJWHk4hSL,False,8751000000,8751000000,0,2
1kVdLWPS7eZRBF7bN65RGNXqxHpE3c92T,False,2183000000,2183000000,0,2
19127o27J1xco6P65Wz9cZkibtgroDWCdS,False,2167000000,2167000000,0,2
1HRoF8XaakvfhXe7UiSYC8ykrFEtWDpt6P,False,2152000000,2152000000,0,2
1PxK6y3Jf6qfMxbMgr8B9mA3R9RUjXZtDh,False,2138000000,2138000000,0,2
1Bscp1ZsitFgsd2LQwgq3rkkcRRT9qcLHH,False,2129000000,2129000000,0,2
1C7FeTBUiVMmvPEFB2pQwbb3gxtcioyBSy,False,2122000000,2122000000,0,2
1Lj99YwMUJNsa3Dt1nDSDix3VvFUmUa5H5,False,2116000000,2116000000,0,2
1NppcTAHT26kUFZxzJEMnvamt1S6gXAreX,False,2111000000,2111000000,0,2
1JZRAZV6Reng1WTK6wwoT7sAUBYXRoEnkG,False,2109000000,2109000000,0,2
1HzwW9nuPeuJTB3CmTqoae3naxoc5HVxi3,False,2107000000,2107000000,0,2
1Kc5AcBoV311eMZwvnYRik6gNBti3t2z75,False,2106000000,2106000000,0,2
114vcFQVQDhjmwmysE2ehFA7JnExjaUe3R,False,32505000000,32505000000,0,2
135nWmJU4H5ziCBuuaT4V1eMkMqLx4c3yX,False,8746000000,8746000000,0,2
1QLRneVSUAP1CyPTq5WTkCe2wi4ae8csFv,False,8741000000,8741000000,0,2
1FEtMzLHnDtLMexZZeXpqtu79bSY2MBFQG,False,2500000000,2500000000,0,2
1K2SmjgrD7rCX3JewN25XGRik8VFAT2SaT,False,1625000000,1625000000,0,2
1EBp9WxfZzTL1TWRDKUQgrGwAcNWGvv18J,False,3375000000,3375000000,0,2
1Tub61yqfsbdrhaWVRkpt4JZxUAVaKo6v,False,8736000000,8736000000,0,2
1GXUnpZ81QAwMjct9abs7MSQYdmaM2cp8V,False,625000000,625000000,0,2
1LBmGaqFLGDAz67jcYnHJZWtyWtrURYAfH,False,32500000000,32500000000,0,2
1Az9KSLAaLf5UmuxtgKMQGWGm44nGkkg73,False,8731000000,8731000000,0,2
1BsWpwZxuyLM2PZypTg1GP3mRCSWF2t5nm,False,1750000000,1750000000,0,2
19u1npE2g6UvZNsG8CP4KeBWMehSKfEdVd,False,1625000000,1625000000,0,2
12NBXEMhe3CohKNNhKtRb7pbbSMDtXJJjV,False,2500000000,2500000000,0,2
1Mt5JL6hQr3xGMdBjXoqxsXHw9Zn4iKK9g,False,8726000000,8726000000,0,2
1Q9Nvq5VuSS18LWyLRtHEyzUmAvNV9ppHf,False,68488000000,68488000000,0,6
13pqrAgyxE38TPpki2xoXo6FgowcahiNzJ,False,4897000000,4897000000,0,2
16gzBD4TDL1GXqxC39twM9NRwv8gP5ByQD,False,2500000000,2500000000,0,2
1688WgDGy5G8AQqmd9LyWQ7bXBN6uG3xAw,False,435000000,435000000,0,2
1DS1hHsJ9L7xXCKCn9hTzy6sVvvs1uw7W1,False,4722000000,4722000000,0,2
1JCfGeNjtWDionDpbCMZpqpffQhSvbQQFQ,False,4711000000,4711000000,0,2
1Lx4jivLAqMrgM3mPXTwm8w1fhAB1xZZ2e,False,4687000000,4687000000,0,2
1NqXu33psduAKJTsKDntWk9GsaVmCLB4Lk,False,4529000000,4529000000,0,2
16DZc4MxLG9ud8ZQGZ93JpZYD7tpg3LWB4,False,4513000000,4513000000,0,2
1MbkLntBKL4Qw9c8TZUtrNzMigYJdjXeR5,False,4361000000,4361000000,0,2
15aqqqzt7ZLnDajkSSrEp18kKWuwPBFdTA,False,4238000000,4238000000,0,2
1J8TTZXHb5HxbULGKGqxAWgiktFHjkL5mZ,False,3998000000,3998000000,0,2
129cxinAWFYkWhywURQAC6Cr6RJdFmXyB8,False,3661000000,3661000000,0,2
1A6EzhQso9Z2A64aC7kbPqs6gssWKiaF9d,False,3062000000,3062000000,0,2
1MgHV2TCMcAgDP91KZQANYUjsfd3dgjNuV,False,2240000000,2240000000,0,2
17Cagk3cBndPZ8cNsSVRWK7ELmkKpjQga,False,8721000000,8721000000,0,2
1C1VbAmqeEaC7BubaRbDSsxxecVbUYnFC8,False,1572000000,1572000000,0,2
1Lrw9nSxbehmaHkt1Pop8R62shn4bqaWJT,False,8716000000,8716000000,0,2
1hn3opwJsxUZb4QmNG1gnqC4cDDcpEpqY,False,1469000000,1469000000,0,2
1ELz4wphsuuQkjtiRoN6BuqqDi3T7uQdXL,False,1371000000,1371000000,0,2
1NUhd8hkmzY8juV3SLH8W8P9LBReQYJrqm,False,1318000000,1318000000,0,2
17eLDS7FdbiSTJiy3WeiWBAotbaYiWKQ9Q,False,1291000000,1291000000,0,2
15UazCbEzxXWBPfxAEkpfb3f9Eh3TKHLeB,False,1269000000,1269000000,0,2
1LHFYhQ2pbm9MQ7nFh5Wn9FBtjcvyS4AtH,False,1248000000,1248000000,0,2
1KyuNVGpUL95n411k5YBUHPmPiN93NWPKx,False,1238000000,1238000000,0,2
1Asw1BazeE9kHY7izXjS2kuodhNG3DPm8D,False,1231000000,1231000000,0,2
1NLDUzX51s6iF2FxS1VKXh9QMnkjfy3mb,False,1224000000,1224000000,0,2
1PzCYDGcjGh96GpLn2Eu7GPYz46s95cFah,False,1218000000,1218000000,0,2
1MSdT4pipdidr3R7yor78mqNSnpBq5EE4p,False,1212000000,1212000000,0,2
15QWVwfoJ2NqQYDGr1f5SXmAfFoh7jfF5g,False,1208000000,1208000000,0,2
1DwjpMFR6F1H8vkrMMuUwzgJbfQnrJft6N,False,1205000000,1205000000,0,2
1BkpYSVQRY2Ey18Di9rG9B7yADWWXbKCTL,False,8711000000,8711000000,0,2
1A8ejkDqU4jUtgHDom5xApGiQkoyScWxWJ,False,4898000000,4898000000,0,2
15vH8ksR8dh2CfJcLLQUnpwSF9NPiv874F,False,5000000000,5000000000,0,2
1JbrfAga2yVnnKq2LdKW1L3vNz4duEQPYm,False,174000000,174000000,0,18
12nca1Tg4fVhqcVk6ZnEtNfcCvPA4SihxD,False,68574000000,68574000000,0,8
155Ayw3fXFpEh9WK5fWD7T6UTwJnK2LRL9,False,4797000000,4797000000,0,2
1FZ7izQ4yPvb1jrFNvpZi9BVzFB6ukHgWt,False,130000000,130000000,0,2
1Fg82N6jhumP6wECB1ypk77noTPPwS1N8G,False,1000000000,1000000000,0,2
1CTjmLqjbbQns6xSPbuBMDof2MWVGnYHqV,False,4858000000,4858000000,0,2
1B73ZdVxqNj7CoJW4VydLk1ScWPEkUCLMV,False,4856000000,4856000000,0,2
1LyUY1TwLNMG3ekBXBm5jcc3ohczYSSdzY,False,4753000000,4753000000,0,2
12TGU9TTk6eUBuV1wksbJGBu2mX36LZS4G,False,8706000000,8706000000,0,2
1PzZ2NYYGmFdtLUSfP44EsqgYnc8ZWtx3Y,False,4529000000,4529000000,0,2
1NDUeEjt1B1FnLJJ3bCFrWLoL97TmzDFoC,False,4569000000,4569000000,0,2
1LSSXgnyxJ9K9U58zrdPbu5KQ3FiCPavqM,False,4474000000,4474000000,0,2
16rTV6gsy14QpLxxXXgVFusDejWm22zWnA,False,4300000000,4300000000,0,2
15cjbDEYzQemEQtD5JyJoo8VcLtHtE6ZF8,False,4098000000,4098000000,0,2
1EeBWhHCLjQmNy7GMLvsmgRsn7SJSX6pzf,False,3851000000,3851000000,0,2
1J4yK8xsTTXfHLg6q778E14kGFFk996ej1,False,3469000000,3469000000,0,2
1QH9p8MwcWj4moTtWKGT2igDzksQAYgn4v,False,3093000000,3093000000,0,2
1Jpgw8UY4eJJqixu4fhcwQEevYbB8KU44V,False,441000000,441000000,0,2
14q1yaFK4VjETaJ4wyUBUfCAC6AijYvkab,False,1997000000,1997000000,0,2
1ChTkf6mx2aiHKYD9wR8KhN9LEz4jarbPo,False,1062000000,1062000000,0,2
13sd1mndcRAE4ioJduXmTBqcrWffgtLUS4,False,950000000,950000000,0,2
17LdjYAqPZmM6yZgtUhbKFAJahNCdQTKkM,False,299000000,299000000,0,2
1NcVDMFjyuQz4vWwXx69TTQUQ7YDeGyKTs,False,120000000,120000000,0,2
17Vp5V8DrB2HN2XF1xuDidGdYwWTNatzBe,False,842000000,842000000,0,2
197QYc8ZfmuoDpUSLyABkAUoMQKyd1xs7S,False,162000000,162000000,0,2
1Kz8EKL2KkGfLVnuFkadDVDJajqSzWJm9e,False,110000000,110000000,0,2
1EUxh7CUB7TCpcBWj8s4JMfEGCEgNyCxze,False,30000000,30000000,0,2
18AvVSNhBSZChp4uS9PyCgHYDR32612JW7,False,736000000,736000000,0,2
1EzegHj2JBM4MoaypdfcSwncD2D9YFDJmY,False,32000000,32000000,0,2
13WcYwuq1QK8wzyYc8XesHPCKjoSQYZPRw,False,640000000,640000000,0,2
1AGjSxPW9qxZuUcjAVxHancJKU87DmYvbL,False,8701000000,8701000000,0,2
1HAqJTNEM5ZJBqDYSNQiXTVq35sbwUksoS,False,581000000,581000000,0,2
1MHsCuxFrus6fjkVuChSVnyJucGX4rxBTt,False,526000000,526000000,0,2
1DGZw3DhrqJYNnNCdsNwHnnBdnLvwqcFm,False,472000000,472000000,0,2
1FAQw5jwSGpuCM76frbhZjnwVG1j5dFdGE,False,419000000,419000000,0,2
135qSLycTRsAg4V6AsjqLEg5dh64fPMrcw,False,399000000,399000000,0,2
125NdwAHzrkvEZu2NDZJKWdQjJfYorEkYA,False,389000000,389000000,0,2
14eRt6GsmnYQKg2ZChKF7efhREd2nqDBhB,False,380000000,380000000,0,2
1HTpiqKMBxoKqYpMG8mt2TfSFLdyD8HgZs,False,375000000,375000000,0,2
19oekeB2mLi6xzRFMHTjo9VHBY3BkUXfC8,False,5000000000,5000000000,0,2
19sbb9geWZnoRC8ZBE9iUPrj1PGNF8m46z,False,0,50000000,50000000,1
12Mdk2qQrPHC8cTprUa1fUuqw42wJ1WHsM,False,32495000000,32495000000,0,2
1HurMpCcrPfMLUdPWxAFQvhwxLa3ELfZA1,False,100000000,100000000,0,2
13R7iKd1SYiBGpfjvGiTfzcncc7Cq5o1mq,False,8696000000,8696000000,0,2
1CWEzCMYpsLKuzQftK9jdzKr6Zi6hUP8Pp,False,100000000,100000000,0,2
1C421XVkgUomMr5gZAuumQmKf5WdMnHK8X,False,90000000,90000000,0,2
1JxxDaspYrsGSDojeQPEV2C9v3QM7yARSE,False,5005000000,5005000000,0,4
1MMxnzPvCh7MdhA9mUxEmqrvFshWdGs6i4,False,32490000000,32490000000,0,2
1i7FGiGc2LzX1o5Gzdr95RC1yLRskPYMb,False,8691000000,8691000000,0,2
1F2W8jUM9vGeApZNvqDumu8mbzRTHiGVr4,False,782000000,782000000,0,2
1KsqMocTbNvdCVa1PDjZzvTJ2FXXX57uA7,False,318000000,318000000,0,2
1tZD3KCtdrnPxXdaXBZv3ewQWbxrxMjWw,False,318000000,318000000,0,2
1ET5RhwTvqwXN86mYXY1K7EWeRn8KfdDBX,False,8686000000,8686000000,0,2
1P9n8FqXYoEXJfiNrCgQzf2rcXmUBrXi9H,False,4995000000,4995000000,0,2
1CqKsEZajQnZJtnRDfw1QfkXLg1rKykJZR,False,5000000000,5000000000,0,2
12SpaauZRFVKWkqh7vkrguUun6EbPt7NXS,False,4845000000,4845000000,0,2
1FrXyPXgby4tFvnNgxnuCqvK5BdT5ugW2n,False,4850000000,4850000000,0,2
1MmTYeU4aiRsgqMnY3iH6LLggmuNxWutn1,False,4741000000,4741000000,0,2
15uhqkR13p6zo476zDqzrhyAwqdk5iJKXW,False,4546000000,4546000000,0,2
19Kjo2FBeXA2FotxrWkGgKGNTeaoBM48pG,False,4473000000,4473000000,0,2
16972ZvhT2v5JZC4GhUXBawHer6ZifB4cS,False,4376000000,4376000000,0,2
15fEfygbAcbNAKMfh9ztbxQSq6uaXF15Rz,False,4200000000,4200000000,0,2
1D1wyMKZmcNj4eq32HfW7fC4VX9jSEwKJb,False,15114000000,15114000000,0,91
1Gz5bv7CevRnSDa16wG7Uob5sy1Tei7C8Z,False,3994000000,3994000000,0,2
12MmJdPDYa8mhxcvoj7jmcaCLBvnekXJrC,False,3727000000,3727000000,0,2
1MePPqDVNdhStAaNMadW6fyWUv4m3JZEzN,False,3257000000,3257000000,0,2
15KMLA1wZ1cuQ1KTwXc79rihCc7c4MjcGQ,False,587000000,587000000,0,2
1NnLqKkwi8GMRXAHachEsRM8A9uH8dK9ZX,False,793000000,793000000,0,2
1Pt1hSXfxBTMTR2NrLGBR26Kx7fU9GTo3p,False,8681000000,8681000000,0,2
14wd1E4aFR3NZjN2kchxf2qboynXNTxX75,False,145000000,145000000,0,2
1A39e9c3gckZ199tqNEH6Xz3KRQexvshg9,False,142000000,142000000,0,2
15wi55BER89hhPMGPJPBbKPLhzbsJEsUEU,False,140000000,140000000,0,2
1GGQfLPew2g8SSMr2FJnc5mjekKA1wDLa,False,139000000,139000000,0,2
16Fec7nJfFrcPNu9Jc4u6WELrPNaEfcDTh,False,32485000000,32485000000,0,2
1BiP9SvJU7EBN4oufdwR9oDGUAir9vhZxf,False,8676000000,8676000000,0,2
1LtWzRTj9tpwuWav54V22ZP2xLx423Tpfs,False,2499000000,2499000000,0,2
1Jeq53htw7yoAexPV4hju9GqEjCugCw5EJ,False,74000000,74000000,0,2
1K4ZGzyb7FX3pGGYX6ZwhW32aRFigynKXw,False,8671000000,8671000000,0,2
1GAjXgH5UCrGutUHjYpga9wePKD6TUj1iQ,False,5000000000,5000000000,0,2
1FrSGNCWFbCq1EjEo91Hg3oijQntPpH6E8,False,4833000000,4833000000,0,2
15AxqX5EKZRUPm2jUdpk8g31oxJjhiw4h2,False,4863000000,4863000000,0,2
1HNQojuAkCiHzh5dZdvYGuiQcQhQMhYi7u,False,4867000000,4867000000,0,2
1FFvRK84A5MJf2hLQDwjbhPqhXVa16hZsU,False,32480000000,32480000000,0,2
1CKdhhvMmEeWeh5Pq6XKB5dsfWtPVgiZRf,False,4828000000,4828000000,0,2
1GVP9czyPyqfGtXRPWfbr5R74TW3Esqhtu,False,4673000000,4673000000,0,2
1PJtoComPciSuKVaG7CDG3xywewKK2dmdr,False,4365000000,4365000000,0,2
18XGTd6d6UKZM9FcVV1qJwtEceC8mGLt4H,False,4285000000,4285000000,0,2
13whmatFnqzdetQXySPiiPBFpgVrWtPE5X,False,4173000000,4173000000,0,2
1GWJKsu216awUKDKZH5jerwQcGRC8R55mB,False,3970000000,3970000000,0,2
18Ki6wZWtqQ63hPVGXyhYsQK7o8wWud9bY,False,3556000000,3556000000,0,2
15F5T9g51zibhuv53TNQsYfZAYiqc39ZV1,False,3218000000,3218000000,0,2
164NRpZvQZnNmLPShDnAVxXuuF6xXbp5am,False,8666000000,8666000000,0,2
1A1V7U3AKN8jVtB2fy7urytqGR6StM3dpi,False,80985000000,80985000000,0,16
1EsNr16Wo4BC6bqoVMR8Fp4xvQDgCPxu4c,False,2628000000,2628000000,0,2
162xk3mCMuxbd97e8s9wHhwUj2chjWNP3B,False,1886000000,1886000000,0,2
1QKTLp28uyM3a4UJ7r7Uix4aFhtvckKxXA,False,75000000,75000000,0,2
1EyUdPVzxwyXBN2gbqf87hUKKrRCVPyy7e,False,2501000000,2501000000,0,2
1EqKewGNUZcTzcMZcKizgmnJvUMVjjsBsG,False,2376000000,2376000000,0,2
1Bw2MeyRCMFyb3J115TExLcVeYVy4zR2z,False,141432000000,141432000000,0,297
1FhnfBmKgptyc8DLg7a2CJChcvV12ZKics,False,2252000000,2252000000,0,2
1NVsCrNDGsRfvfVkVxCpCvdJs619Y7axJr,False,2132000000,2132000000,0,2
1Dmg99hSbcnJcxD7SsTBCaebbo3UUbEDd4,False,2019000000,2019000000,0,2
1NeJ52SMLukeRhvoZaemFeLxkb1Kj6XokC,False,1908000000,1908000000,0,2
1HTP2kw82HVnfd81nXsMaEbo31u1T4SadP,False,1804000000,1804000000,0,2
12FuucCZJCVvaE6DaNq18uCpBR3ZT5qupV,False,1708000000,1708000000,0,2
1Aqvg7L5hg4z3BBWaXycT12UEuFnDZam5g,False,1672000000,1672000000,0,2
13TQyEnwKx22QAxDwfmhhBWrW8mU1hUfuA,False,1650000000,1650000000,0,2
1B9usMSnBsCwAL4YLsBWzHWJhLU9nqsxZr,False,1631000000,1631000000,0,2
19FswFd1MfuqDCyAVT2ufTeyi9pWwZozMq,False,1617000000,1617000000,0,2
1893kouZ9DQnc8cwSib9E27AyNMtHW76Ct,False,1605000000,1605000000,0,2
1Chg4V7HxqWbjz3KFmdyG22xL11Ygt3MWs,False,1595000000,1595000000,0,2
1DytYBEAUriZo83pV4hZd8CrxDSUsi9yfK,False,1585000000,1585000000,0,2
1LQitM9xK54s6qkTrfEgjnXCmAaPKpvykj,False,1579000000,1579000000,0,2
1BcBTdDhfi2qPwrRqpZyWb3awLBCP3Mfsq,False,1574000000,1574000000,0,2
1AdiS1AnjCRyL8WLprE9ZMEuCvbhL8wRdQ,False,1569000000,1569000000,0,2
18HKGMhYcWLw4hVepgr6JeWWjocn4e85UY,False,230000000,230000000,0,14
14ZwCyGDk13poRHJfKDGt75mgZ8kaxHWnF,False,8661000000,8661000000,0,2
133knvc1iX5sYCYVmk9FwNB4Pg1Mbetk1h,False,90000000,90000000,0,2
1DQfAMvav2EV3oaYMmZgGttNasS4aiCaRT,False,50000000,50000000,0,2
1MxSLPBUBPynKwanuTpudqNcQBih8uznyT,False,8656000000,8656000000,0,2
1CRiAr6ayoHjKyYZk2f4g8bMmBjkx7GfgJ,False,200000000,200000000,0,8
1LbdS6AufhHWnGe6QMZnpgm2QPZ6nedYQT,False,4856000000,4856000000,0,2
154CxigPTL61PTuR1cMk3Q6KMod6zzFxJN,False,32475000000,32475000000,0,2
16z9szndtdMBL7BD8eECVSwyjX64hg4QjM,False,4717000000,4717000000,0,2
1FaMr3H1qU5oaFFzhBGrQExEj5Qu4i4Cgc,False,4704000000,4704000000,0,2
179BKKRfBdSt4GQo3ht5PuZmFt6yeoz15w,False,4595000000,4595000000,0,2
12BSRXkJjqkGnef8EM4WDc47yeLUXHtqR8,False,4665000000,4665000000,0,2
1BNxXeJdwPeor75FRZY43YfJs5T83eGv5g,False,4401000000,4401000000,0,2
1NWkyokTE3sVzy5zUckxWqQmbYfBz9BEJY,False,4069000000,4069000000,0,2
1MVA8EFiZWsu7w493uvUtCSHGccJ7wK8AC,False,3756000000,3756000000,0,2
19hyAe88PP5TDLbvxPKh6pZKpGrZvvcJoK,False,3607000000,3607000000,0,2
1G5xx1muC9WUACzfiz4bmCATDet3zDoBop,False,3364000000,3364000000,0,2
1Fj2hFE1KCUNKssHaDYBj832AeacaNrqpq,False,2447000000,2447000000,0,2
1AVhMsjzdaCmzaSudGZeYsjJ8CYaKP82YQ,False,112000000,112000000,0,2
1M34yaH1n9x3MJbsGCwv7kJv147PBfaZfV,False,225000000,225000000,0,6
12Vt4zibcPBVZP8NQekKGuZHukwBRkaJEs,False,4990000000,4990000000,0,2
1KNstAoSGF2kuGNA5DZSMfzsP6zp6NvXeW,False,8651000000,8651000000,0,2
18Nftc9EZ3KaZKReZWZ8Yscz9Zs3VwtLwx,False,492000000,492000000,0,16
1CbWocVaFyXaE6ZR8b1SzQuc1x554oQNQJ,False,352000000,352000000,0,2
19m6kBx3Vh6ChQYo9WtkgsKi1AganzTK8m,False,2341000000,2341000000,0,2
1Hq5mAma6pyj4RyQErYSYAX1QgEND9MyEN,False,0,111000000,111000000,2
1GFrW6R285jAhc2AzSgy4AhqK6PkXjRRtL,False,231000000,231000000,0,2
1NhLzVgycrmaTDYfNJNb6BqAc7cAyfMjPx,False,2236000000,2236000000,0,2
1KM1kQJk8Aa2n2EZ7iBhuv2oiRRN4TodHb,False,113000000,113000000,0,2
1DvBj7dZ2NV8j565g93G3nuax8SeZisDyR,False,2132000000,2132000000,0,2
1PrpPr7q5yGTcbyBH5ix8D9WWFs5bbnxt6,False,2029000000,2029000000,0,2
1MpARvXUdiegv3j39awQAMyyk2L6VW9L6c,False,1927000000,1927000000,0,2
1B1ZoMtUu1QBCA8aEER3Bw8paasQibxYju,False,7480009884,7480009884,0,29
1LBpA1CfCbz7dWDcV9bzJGnkHNpf62mUXt,False,1832000000,1832000000,0,2
13qNaT3g1rdQWxyqcp7ifbMqHPKaPToE7g,False,1807000000,1807000000,0,2
1AtBhHnMpUUEuNzp5rcFHaCAdMc3cn8YHE,False,1783000000,1783000000,0,2
14uGGwELBW2LbYLxRJnXJMeLLA4zihjKSN,False,1764000000,1764000000,0,2
135zyiZ188Mo3iRzJskbBNqCdRpifCM6Nd,False,1747000000,1747000000,0,2
1FHhypUQJjrFQ17vDdqVGqgsiQvEQfmeY6,False,1742000000,1742000000,0,2
1LyxxmQjgf1vsETZrnfLswGerJTE2sMsv2,False,1737000000,1737000000,0,2
1EfHjZvh5CofsxTPEvhVn7fZrX6yQtfYgB,False,1734000000,1734000000,0,2
1L652GVSZPShCYfh1zU3zyTYs5QkzYo9Y1,False,1732000000,1732000000,0,2
1GJPnxpwy8QPBLj4CHZ41iYdmVzhRMCGqZ,False,4911000000,4911000000,0,2
12Y35FvA2uvJdigutZVcwfVx8VhNxttA6h,False,5000000000,5000000000,0,2
1FHqWZEJGQraoJxVSu2fAQ9FwXVAHfoX8V,False,32470000000,32470000000,0,2
12VvoAasSf7cGkqSs8CHCh9ETCCFaCqA8b,False,8646000000,8646000000,0,2
19j2czitwvVk4LLADRnv7RnHWyqS5oXAEi,False,4761000000,4761000000,0,2
1HTN7StPihQGiwRsts5E1LVCzkokVWYHtN,False,4616000000,4616000000,0,2
1G4hdRA53o6zqV5y6mrHz8brQCj9MXbDjs,False,4586000000,4586000000,0,2
15LjyjD5JMUKVhKJ8mhrtzWCHP479FixnL,False,4543000000,4543000000,0,2
17j8hpEdsc9zPJsKNaJb9oewAB6QGFdRiF,False,4213000000,4213000000,0,2
17fvVG35PoHjqK7R9WPZGzL8Y7fuKQ8Pxh,False,3462000000,3462000000,0,2
1Fj5WNNyMmZ6wrQDbwE2wdz36jLzjBSLc,False,3298000000,3298000000,0,2
1PFcLncsaMunFvmFS8RvemgSKaRCcf2Vxe,False,2317000000,2317000000,0,2
1PoxMTKm7SeJ27HHkwZybkHkWobidDyRJ6,False,8641000000,8641000000,0,2
1F8drzfb5xQUcdXfXDs35vQ44q5Q6zzxjG,False,2257000000,2257000000,0,2
13PKsZrkrPvdu8QUAxCKiVQLfh2d4dirtS,False,8636000000,8636000000,0,2
1Dt1x7SkKQcyrqhggSgjdjvZshxe8hmU4S,False,2202000000,2202000000,0,2
14jTefiAzVP3uGLFhDp3AkdqVqgjsaU91Y,False,8631000000,8631000000,0,2
16HMJTjb1e83eaFgv3bYZrvezy5epDjMvD,False,2150000000,2150000000,0,2
14DSk5kdHAWUDao6GdSYxMjcyvsw6oEQMn,False,745980952,745980952,0,18
17G52u3bgj3uuKL3k9jcNr1dhDZPSzJeHx,False,8626000000,8626000000,0,2
12J5SfUA6Nwf6YqVPV53PwWoAwNzJ8tzvU,False,32465000000,32465000000,0,2
17DA16CiGRZ7dXVeaCKXv7CLYfUmc6FA8p,False,2138000000,2138000000,0,2
1L5yWS4BkrHoNqP7xyZUn7B1M9hM8gEuyy,False,2134000000,2134000000,0,2
1KarjAMaTtti47xNeP9uuyowEiy8KrQVGM,False,2131000000,2131000000,0,2
1JCnk2f972cyukdrBkrWfLaWTkuHDwB3iW,False,2129000000,2129000000,0,2
1PoMYVQgEMov12UXgZWLbs5hHWXpNKmHbS,False,2128000000,2128000000,0,2
18RdgnGSD9YBigyf6UuVGeZdb3Mxrn8WNQ,False,250000000,250000000,0,8
1HyfJtRjtN2MmGEGxWfkEJNeok7wMmsVZz,False,3754000000,3754000000,0,2
19zxpEWtYEEpRHmjRS6Ki7QXp2RBeuwKhE,False,3543000000,3543000000,0,2
1ECoMTVQ3JRvdZBKQ1u34SNKmRaDFwf4uR,False,442000000,442000000,0,2
1Ki5zkr4BhxwqX6mHiEZXbPRTZDe9Lo9Tm,False,3312000000,3312000000,0,2
1JyE8ucQ8AzP4SuNat97z3EJF1xMmiXsSR,False,32460000000,32460000000,0,2
1KecknktSXyw7UsE9vGrS5FYyhNa85H3yH,False,8621000000,8621000000,0,2
1Am26fTYidqPtjPSqXMjd3LbbVenw59tQe,False,3145000000,3145000000,0,2
1EDoQ3WMh1XGmPjdAXzgc34kWaZFBSJLfU,False,4355000000,4355000000,0,2
15iuWptNf9LPsMfsbyW6CjcySnSLC2vvpx,False,4500000000,4500000000,0,2
18r8xuB9a1JpNUdRYwJCz3nPCfZNiyxzYL,False,50000000,50000000,0,2
1E5xYYDjssrUrvbWYSuv1YwAS9hSUX5JTr,False,3543000000,3543000000,0,4
15Y9cCHoKhaAF31EvpPxUB6bUWt5bPvR76,False,103000000,103000000,0,2
13kLXKQ1KSwjeYxJCkdDdNXad6fp8ECw4K,False,32455000000,32455000000,0,2
1FDE8BjgsQvg2wmCs7r9a7c3tot712q6s9,False,354000000,354000000,0,2
189Ku1PrVG8ktt1vTwnKQ6JC23aP5s59Zb,False,3550000000,3550000000,0,2
1DsfcXJrxVLuzrgvoNAgucLgAqqcKRrTxN,False,115000000,115000000,0,4
13FSAnbortdjSYVFNaMqWQKjJvbjgN2cYF,False,8616000000,8616000000,0,2
1NCevWJCUdWBvesi9AcWxVGwK24e14JRP6,False,149500000000,149500000000,0,2
1Pb3qRFUPXwE5USgtfg32rG9WC1hKkUsYA,False,1200000000,1200000000,0,2
1NkV8JvKnpUG7Uj7ECLHsz5R51VTXUCbBb,False,350000000,350000000,0,2
1BnrZNM6MP1tYhhw6ubqMbvWYpF2dwcja7,False,8611000000,8611000000,0,2
14mUbbjtDPMUUz2YbLTrZ5wnuUv3RJVwEH,False,4990000000,4990000000,0,2
1DeaCeW8m5i1QYCASSj1Ki1AuRzohv8zm5,False,4980000000,4980000000,0,2
1Pf7VsreA4woPcVepMTReoGoeXQmtMaREf,False,4970000000,4970000000,0,2
1CEmCpdQcsV9o4qwn6ZTvdCTLFxozHEyk7,False,4960000000,4960000000,0,2
1GKbrZSuVwJsTYDTfFrHAfZVQq5ZAPFyJA,False,8606000000,8606000000,0,2
1JLZ6knkobGd7z9RaKFsymo2SCx8sAtP1s,False,4914000000,4914000000,0,2
12ggS6Xd5pMSPErz32tThPsB83uSBWqT4S,False,4085000000,4085000000,0,79
1AmJZkZdovufEiUtu7PtPCJ9zNSdey2vge,False,4868000000,4868000000,0,2
19EJBn6uKfvV4taWvfyZDcbdqTWpYXeQY3,False,4822000000,4822000000,0,2
19MJgZsF49c522AT6JCMpGScg3R66Wn4C4,False,33345000000,33345000000,0,2
1Ea6fZtS7jwmMJpDk22cbPAkAprAESybmn,False,150000000,150000000,0,4
1NoE9tQT3qCoAMLERJzxtCNgGNJqCfETNn,False,258000000,258000000,0,2
17asVKkzRGTFvvGH9dMGQaHe78xzfvgSSA,False,196533835008,196533835008,0,36
1FBafANyRwALtK29LgNQjKC1MQtpdR2sAF,False,8601000000,8601000000,0,2
1HJgaB74RRuk9JEx44oDfGJtyMWdrZYwHy,False,32450000000,32450000000,0,2
1CLMqDKsx3CmP2yF6C42Are641ce4pvQjJ,False,8596000000,8596000000,0,2
1BDk6yt7KtmAfyxyaM1GWkgkofF6gbSzSz,False,8591000000,8591000000,0,2
1HWqUS2icpGZdrWFumDyvSyzgrEhUa7j96,False,33000000,33000000,0,2
19ZwP3gz8NPWr8dB3vjPe1PrAeBXGGEfQA,False,327655000000,327655000000,0,4
16L9b7SyLJGHEJSD1RxmoccNcNzzY5rwL5,False,2036000000,2036000000,0,2
1PfxGp7jGUybFyhcRTLXkGBQiHTxeRZwJZ,False,4820000000,4820000000,0,2
1BDVy9iVV4fz7p5hXyGWeFPWXSDA7wGSxe,False,129896000000,129896000000,0,13
1PMYnhi5nUJPdGsRQQtEZavYUBZ8HQjryT,False,13344000000,13344000000,0,2
1DU4vJUiPv8RevYTbPJQpmiAW6VCBy7CTw,False,100000000,100000000,0,2
18Zjcp2zoDYhQ17P1C8HVfzsxMXpcTUqX8,False,50000000,50000000,0,2
16rmXtCVQwgLFjrxQdQCDjwKs1JYNhMmw1,False,8586000000,8586000000,0,2
15JJp9t8EdxL9uNE8CjchuHn5jQk1x4LR1,False,4818000000,4818000000,0,2
1BteW1uy7zNXMNqhFdvFafbJLd1HcHVPLx,False,4984567071,4984579071,12000,40
1c5JYTKHrtyGSsCt64iRANNhx1PB86GV8,False,4816000000,4816000000,0,2
18ds5gdnnZHgDAQv497y9sXySyJfMz4LmA,False,2500000000,2500000000,0,2
178MVtySaNaHVUWYHH9w9dcRdrNa8NxsN8,False,4814000000,4814000000,0,2
1KpuuTb9FKgADUX6Df35v7Zg2frMAtUHKi,False,4768000000,4768000000,0,2
1FjgVKvAsoPNj1V1vYBVHNxsKxfNPafagQ,False,4722000000,4722000000,0,2
19vH2yQSs874fgiHBZdruL5C34zxPgR85p,False,4676000000,4676000000,0,2
1NrJ58dLwmKhRijLNXsko9qx5RzukGpkTw,False,922000000,922000000,0,2
1459X1R13Fea98fohVbcJuJjyEpkBZrUc4,False,4674000000,4674000000,0,2
15Tr4B8RDd393MNpQ1jCoi8grzsoYSYJdN,False,5000000000,5000000000,0,2
1N5RhkYTodkTXjetBMt2rviC2BauWCke7P,False,8581000000,8581000000,0,2
16pXqwaQ5euKs9ZN2Kzd4gTG8R7YayVnNh,False,4628000000,4628000000,0,2
1Q2WUKmzeVRrxmbcVMwtVuec4wh2H8YEEY,False,1362000000,1362000000,0,21
1W5My2mh4WA5Fsa8yoNVJm7PxFZWqFwbK,False,1425143000000,1425143000000,0,16
15bUCBJC88Fk45J8G8ADHc4qShnNbdDUsv,False,153000000,153000000,0,2
193kMQHcKMaV5kRWhCA44BA3mU43CDrsjU,False,10769000000,10769000000,0,2
18cCiM7D8naUwRTq5NoXrVXu23tJP8a1Rx,False,32445000000,32445000000,0,2
17pEMiFBbVYF8MtK8Wb5gLchBzQLaeDrm,False,296000000,296000000,0,2
18LBVpzieqzc3ypmtKRDkadcrCxxxSAFgG,False,18345000000,18345000000,0,11
1Npye4yGV6iKQnrgfPJkkPRiS4rfM1LW7z,False,8576000000,8576000000,0,2
14c8na6Lux7NmrrpiuTDra9PJbYJbQfpx2,False,8571000000,8571000000,0,2
114HVQbtH8zczn7NWe3r4fnq4NfybiY8am,False,8566000000,8566000000,0,2
1DGrGFcwECUJsPxEiqiiH3DghvXAvGnaue,False,11389270000,11389270000,0,12
1Q4iVExXxWcAQ9KuH7Nn7pxXsYk5Bf48if,False,26896000000,26896000000,0,2
12iWcqL3JUWzwujkvk75N2a2sLjZbH6LvJ,False,8561000000,8561000000,0,2
1k2VAbcprhq2uYtqLEK7EzUzcETHD3maH,False,1220000000,1220000000,0,14
1PJRmt5fypPp4qpHmU5pUvjcWvNLyjUPPh,False,300000000,300000000,0,2
12SNE4UaiWKSzTKTBVRYPRmtwKWFUQ7LdJ,False,200000000,200000000,0,6
1MwfZYttWjX18WtuQJwuEt66dkzVUWnByu,False,1900000000,1900000000,0,2
17EyBB91JLp7rMkmXxrHUm2LBSWp9TFQBv,False,4891000000,4891000000,0,2
1LTpa7mHHPSJyysnPiPX1LRatXsbKvD89Z,False,4801000000,4801000000,0,2
1F2km2aPHULiW9Qb9N494BSYLkGZXjTmsm,False,4651000000,4651000000,0,2
1D81ALBSDqQ16djXruRRfUGX8rkBbgJXVK,False,4491000000,4491000000,0,2
1Jzs2UTNLHF4ewYL5KAnS3oTdNTD2ww8W6,False,4455000000,4455000000,0,2
1Ji5Jk57d2cmrs9BF3GHndEsiBxnSXMNT5,False,4392000000,4392000000,0,2
14EzScccFXqWXZLEm2t1kaoF7DWaxmW4xM,False,4052000000,4052000000,0,2
1NAFyKcW5CdjMit8AGx1Pdn7bfNpmTXzfz,False,3202000000,3202000000,0,2
18kksHpLEUyt7R8dCDdHvCi2beZd4v54M,False,2989000000,2989000000,0,2
13p64GTVeJ34wNvJTcgm29FkCghWWNmn4w,False,113000000,113000000,0,2
1GEcwVXnDGyYHE5zJT47sBwj2XbSLZrPNJ,False,350000000,350000000,0,12
1GCr4JmoTWEpizAyd1cqR4cAx4QQtrfpzo,False,50000000,50000000,0,2
1G1Ku3GhgVFXMn1VUqv3vJrbspRMZxq2ZJ,False,2897000000,2897000000,0,2
1KHSre5nVKZwJvALigYhSAyvb7XA1AD7mn,False,47000000,47000000,0,2
1ENGD4TpUq1S6DVYHafzGBBDjyimoAeHZY,False,106000000,106000000,0,2
1HxrFqEBBZ2EtQ5EC4ASETimzNE9aTquBa,False,2806000000,2806000000,0,2
1Bc68uEWpc8N8o53fszKQcwxo8GnzKE7TS,False,8556000000,8556000000,0,2
1N7VeVH1gg8UtQayYQh8vx9bEzRNN1ntTs,False,2745000000,2745000000,0,2
1DGFPr4TpmCgahEU4BTNcHifLC18TMW4ow,False,2728000000,2728000000,0,2
1C6TRWp4c3g8oL48A3fEZ9vTEMjsCas2AS,False,2715000000,2715000000,0,2
1MEwRybs6ZLhvjGYXpgSxnyrPBqtU1dSYK,False,2706000000,2706000000,0,2
16aNXWTrJwds7zxDi4TNzhoDkVeHhpQpGE,False,2697000000,2697000000,0,2
15tvH9tFFezsvViB8tLeRwNayk3sMxDRkk,False,2690000000,2690000000,0,2
1JnFD9ddUW5MGbMLLMwnrYPMTU3X4nYfAV,False,2685000000,2685000000,0,2
13HUzGRCFbriRddxPQ7wdytLwg7FSU7zgM,False,2680000000,2680000000,0,2
14KFhM4z5X1CxmjiBu2BK2kCs1s2NjNvfL,False,2676000000,2676000000,0,2
18aMYwjYJE7VpBHpCSMfUW5PUTBrKDN2Xx,False,550000000,550000000,0,2
1Cm4U1d9wpKKpyASGyDnQYrSxNapYiENRL,False,100000000,100000000,0,2
1PxqEs5d5bZjqH1CuWSDRmNkeNE4a6qEbi,False,2672000000,2672000000,0,2
1Pso4S2yLhBU5uWiTzT7z5NapN4LEpvqsY,False,72000000,72000000,0,2
14rRma3ogpWupnYyTZyvBCCc6o4Yr5sWDj,False,928000000,928000000,0,2
1KcphmLJ8Td6rsxS6xKAQVbod8EZa2842i,False,300000000,300000000,0,14
1Q32RcwuYg16mvGijA6eceWd2iuvR9sc1U,False,50000000,50000000,0,2
1PwovEPRN2yru1Gb1RQ5GfjtEhH45CCaZr,False,2210000000,2210000000,0,2
17c1KxyFB7NEPgwutzjZjSBjcdtkseoFB6,False,161000000,161000000,0,2
1K57UQhHEG5wNtn1mzA2byN9zoxSidkMEg,False,8551000000,8551000000,0,2
1BymPxbHfxckDYZAUEDB46VrAb1KduAZwj,False,1478950000,1478950000,0,18
1H32B2txdBH4hrCgEtUWGBUR2aSTCAToKm,False,8546000000,8546000000,0,2
1MpxsMV5jxmznWoTpBCzwEMwMAXkvGM7EC,False,20000000000,20000000000,0,2
1KnBkh2FJUZ8jmeAHqiVHPp3MyxSAwFUiZ,False,50000000000,50000000000,0,2
19rBaachMnNUkKQLeFHWvgqxuYbPEbT1Qz,False,3476000000,3476000000,0,2
1EhRnpxWJgRJniLtLpmQBX5uaNr1T9hton,False,8541000000,8541000000,0,2
1D8eHY3gqeN5PpincJSCLVC8iNT6F3TUR7,False,65500000000,65500000000,0,2
15G1pmoL52maPpCQjxL8MopwG9GqMXbZc3,False,50000000000,50000000000,0,2
1CCaJLNoQ4U9CbwJ3xWbsbze1niN81fFVo,False,5267000000,5267000000,0,2
18maNfdFuyGgbKYdRNfgjUefdoS3TzgK7Q,False,1769000000,1769000000,0,2
1GrhqWVz4u5PNXHcCWz8Xd2L4budzMF5LD,False,2106000000,2106000000,0,2
15ERusqyQfy1SzYs5aeo3kXnvXEyVYNjYH,False,4918000000,4918000000,0,2
1DGd6hM3bAc3DDzrQGhV5Bv5dkTVMG14gC,False,4800000000,4800000000,0,2
1JQ66G1wKfGDvtjW6ZuZ1YG3oM4enTRySu,False,4707000000,4707000000,0,2
1LPXZceRZSyF2hDubBRzyvBqrRwsPsCLjU,False,1382956972,1395694121,12737149,72
1M196SKLnEkUJAUt4hnDYeveszEbMmS3BC,False,4551000000,4551000000,0,2
1NEuGv6QdULmGbC5HrM7zhroDHXEaTDg8i,False,4390000000,4390000000,0,2
12tLQTSnkF75DZPEQhSYDmEM5drhrgvVKR,False,4327000000,4327000000,0,2
16YeezF5119VvAA49CvNcdBiByBdVw6xen,False,4252000000,4252000000,0,2
18B6zxdXw5rKaWM6dBoFxy3ZdfFatfqgmY,False,3900000000,3900000000,0,2
19uc4U92SGFRUd6u5Jm5cLSTNFCWsKEUg4,False,2897000000,2897000000,0,2
1KdgR42pntiPUazd8FYjaKZEg15QJoc488,False,2142000000,2142000000,0,2
19eprGjxmyMSPag6n8LPcJUrAaC9tEC5L8,False,10804988013,10804988013,0,29
1PNn4TmzFg536NfDj7gDkA6yN5dyRjFbND,False,210464000000,210464000000,0,2
1F8v5xUVR8pdFi2YYHPEu5qNYDUT2hxcQd,False,2112000000,2112000000,0,12
1Dcq5HzqxHRSEftnEWL2gBjTFmA7LVMgue,False,993000000,993000000,0,20
12r12J6ZFozvCgttYFT4rkT2xyKowuUKzJ,False,4269000000,4269000000,0,12
15D6QfzGckKVAYMgqYx75EWVF5retgX4T9,False,2088000000,2088000000,0,2
18PGVGTXL7wSKQbkfKVsx1sHgKLhc7LtoK,False,2036000000,2036000000,0,2
14u6QYwy8CqkNQoMDusknaNtxWTCtKBrjf,False,8536000000,8536000000,0,2
1FsFfco4cKB5857512PzTuR1ahnsKMSxvr,False,2007000000,2007000000,0,2
1CuWeuPTRNDS5UQZhP88xmHGepMrhAGjnt,False,1985000000,1985000000,0,2
1PbKUGk8XcasfZVtPsJ13VLZXjAuHnMKkL,False,1966000000,1966000000,0,2
1LtF8RxXLR5yPtvAnJaC3BSeZJqXqRUQHt,False,1955000000,1955000000,0,2
1KJ27L8GjkwVVkgAzHFA9Xm4wcdeS9iS3b,False,1948000000,1948000000,0,2
1MWZ47WRbgUi2nY35P8yYxHLB1SrVHN764,False,32440000000,32440000000,0,2
1JoqorkSHyvpbeJ7dnBAxyvP39chmAFNUD,False,4894000000,4894000000,0,2
1GqUGrLuWRHEne56jCq2KEjxVjBWrkHyXP,False,8531000000,8531000000,0,2
12eZXrJikcK1GSzkcw8ckZZrKkaVRpx9VS,False,4806000000,4806000000,0,2
1Mqp9ddm9TFUZpqRkGPexYXsznx4cawLJ7,False,4687000000,4687000000,0,2
1K3MeuQvvDtfEhj6Ee2gayLW5HPikQ43QF,False,4586000000,4586000000,0,2
1JGj5vzoazPEWArLKdQ7wKuMQr2Nx3FNwR,False,4420000000,4420000000,0,2
1LTRY846JErzetuJCsNN5HS5DW2K2JHqot,False,4248000000,4248000000,0,2
1CsuNNxUneCPKBtviH9EHthNayrRUEWuQu,False,4178000000,4178000000,0,2
1H4FKtdfYZRTEzzB1U1KWpC4JKREwJd7Fz,False,4052000000,4052000000,0,2
1MP3a6LzizGvmJFpbGmm1h9SCBun9uzP8i,False,3614000000,3614000000,0,2
14nwfUcpu12QyqW6hZUT2sW4TcE1UmdTGU,False,2169000000,2169000000,0,2
12XV31wrLtGz7vg3ZFM3xJsbo5bKPco5Cs,False,32435000000,32435000000,0,2
1Q3QnZ7HC7jwxVt6cTDijj68yPrLBJkDpE,False,8526000000,8526000000,0,2
182NcAb4gXGQzBqUHwAMfMZTEeUzq7wDuu,False,1943000000,1943000000,0,2
1LiNN3wyS6aSXTZbkSpu3AstEBKRJ6oZWA,False,1941000000,1941000000,0,2
149pFSXAXMhv4xXhKp2t2XKfaJ8Z9LDnGd,False,32430000000,32430000000,0,2
1BWSM2pdx9hCus3RbSkdtzMRvbqQV4YaAa,False,8521000000,8521000000,0,2
16q4kFbVd1X4svPbV6kTCYBD2kgE9CTYV4,False,1939000000,1939000000,0,2
1F7z2HEmWTk7iVEZ1b9BQRcvFsNHk2qUxs,False,8516000000,8516000000,0,2
12hECqQ4YRhh8yf7BYQoKBUVkF7ey7cogN,False,1938000000,1938000000,0,2
1PbGvi7qVSpcjsyLdEjF9P3kTkbZRbiB3W,False,1937000000,1937000000,0,2
1G6YNKhXYrDrMxPHbzp62CU7wKiWUm4Fyv,False,1836000000,1836000000,0,2
16eGhExv6YQhvfkj3o5ALhjCwzL9Ugcnbp,False,1740000000,1740000000,0,2
1BA78U1vKwghygCtPdGWi2mcVj96LKKezf,False,1654000000,1654000000,0,2
1Ka7r5kbwToFhoMxcvBmYwHJMLiuxXzaBZ,False,1570000000,1570000000,0,2
1PKkSi8UcRukoRS6tE2PWgRGVeg6n1c2J7,False,1515000000,1515000000,0,2
19CojZq16fgQzg8wfate4TtKX8kn6AHQyv,False,8511000000,8511000000,0,2
1M6CUwDwVfriPwDeWFax7zYT2LNxseLqec,False,1461000000,1461000000,0,2
1MwAZqBobmZnCYEZMZ4mNtFUxHZuRPSmcV,False,1436000000,1436000000,0,2
19yCXNnLp7Xp2yusbRL8UTUcv6aXMcRvQo,False,1418000000,1418000000,0,2
18RK1bfPuYg24XVDDVf5f9yFN59KxwjBM6,False,1407000000,1407000000,0,2
1PVbdrRMMiSzLFAXRU4cuug8S1oSJjMUVW,False,1396000000,1396000000,0,2
1Cjt39SfZAfZrtZXQcif4kwqMtPKFugakT,False,1386000000,1386000000,0,2
1zuUcZV661gitxLDPK5Qr24kUXrMqEuXc,False,1376000000,1376000000,0,2
1G8hPXwL78zwHRD8UbpZ7bWiSEFofLNeRr,False,1371000000,1371000000,0,2
13yn5a2qWRBeox195rPwX1B8wzp95VbQSa,False,1367000000,1367000000,0,2
189GkhL1z1cmmt4E6uuxtqrJDdSQiNB8Ga,False,1365000000,1365000000,0,2
19GfgxBA88g4xRmejwfMe8YMTynmdKu2cy,False,8506000000,8506000000,0,2
17cGCENFb6VP8PKYzEyUvQMDzqRUiJSoN1,False,1364000000,1364000000,0,2
1FkwirEMhMFLsNdqsEtPp4DTd4ndA2jHAp,False,1363000000,1363000000,0,2
1BSXhcroc9jBsiP8eCTqZPh64FQRBxy2XX,False,32425000000,32425000000,0,2
1JhakJAAkQAVRbjN9F5xoFAzYWiFEfQRb8,False,8501000000,8501000000,0,2
1EGQwksapp4w6J9ra6p1RiXUuqh8Z3pHvU,False,352000000,352000000,0,2
125yfYqPwaiL4vMNg1mwQYit68FAz5AZgt,False,490000000,490000000,0,2
1FPkMWSAwoM7MP7G48oUcJo59wD8Xq8X5m,False,1000000000,1000000000,0,2
17Dk1cugCynTaNdmQihF7tproJgyKyWiwr,False,313243081,313253081,10000,17
1MYNhr5Hse7vLVsqQyTU4Uv6yewHMz2u2h,False,387000000,387000000,0,2
1GrSac66Nv9TRCUPct441kmokd8kaEUZhD,False,61000000,61000000,0,2
15JUg3nzNaBrzXj5Jxrg9BgbaVfNKeZagb,False,3764000000,3764000000,0,2
1BEozEwukL3BC2JVGvP8rbWEo2BDKYjfJS,False,1928500000,1928500000,0,18
1DANLgAoF2b2YdDBpjpFv4FJUU3bLJzYjo,False,32420000000,32420000000,0,2
13o7KHNTWxw8m9QMsv3CLRsdELsvzHDP3m,False,8496000000,8496000000,0,2
19CiYPR5iUNM2oEyEjUwyEifFbt7dXQ2Kb,False,268000000,268000000,0,19
1LZx1QL2xjfzHxRAomUAfMu1LTzhQZK5nZ,False,8491000000,8491000000,0,2
17cqHvkx4QJkoaNtgsZENW968PegDndLP8,False,1000000000,1000000000,0,2
15AEK9ocwPfQwFK1ZfUGMohmgcWKBdXkbt,False,225600000000,225600000000,0,16
186gzsR5freZQj7qgd1TWJRcA5UqNwcAnE,False,32415000000,32415000000,0,2
134Fy39mSVonGaj6dYhxvt7HZW1sT7y3bA,False,3828000000,3828000000,0,2
1HqFw7vgafEyGqn2tHkJByocej6FERkoQQ,False,3317000000,3317000000,0,2
1FPLd2EjCbuNsk94PE9WigqpHX8biY6vJB,False,8486000000,8486000000,0,2
1KErv6kNJVHAd5tmKxEm4otnoVfJuZdbRy,False,8481000000,8481000000,0,2
1F94hPAgHPcJVdWPKnt3TsRCd2JUuUrj4T,False,4872000000,4872000000,0,2
15hRh5gAVnxeCtu72ATZGLsgKYwS6vttQH,False,4866000000,4866000000,0,2
1CeC9gxyH2g7RtdGhcgEAHA1BEm47qqnjH,False,4934000000,4934000000,0,2
1wkyQmRW6Ha9sTSqVvu5WrAsqfUzT5ypt,False,2693000000,2693000000,0,2
1Lawh9egMjNXPEUPHrWSxKLGRF3KbuPmjR,False,452000000,452000000,0,2
1KKaUdrvj6wDSQexGx4sUF5oCmF9C3GAc4,False,4752000000,4752000000,0,2
1A4AGMGpREvtC6ohmFPq5PzGNZ1uyLRbmp,False,4653000000,4653000000,0,2
1DBTcXGoB87PgZpSLcWj9w892jjDuZvheF,False,4529000000,4529000000,0,2
1G1uoADHfRqPkXGBYGBg3XUnEzcNQgVTno,False,4425000000,4425000000,0,2
19k2UxQQYMqPX5X36pqdrF4mVcvMe4epWA,False,4247000000,4247000000,0,2
14VmXBPGmM5eACrX7BtBdUyv23SxjUcCci,False,4065000000,4065000000,0,2
1AbLHWP46WSMyutBikaoX5sqLEBAEJqmLb,False,3988000000,3988000000,0,2
1GtE3HA7QzPbjMfAwb1KvS3DxWRMYpzKfZ,False,32410000000,32410000000,0,2
1LVFp3WdbVE1JYPj4rr61XHPVSro8w7iE,False,1812000000,1812000000,0,2
1CFKufz56pd4kGok8XCt8hH4PZY1KXZJ4p,False,32405000000,32405000000,0,2
1AhzbZKLt66pVqwTZy9xRdmHGRdRiYjzzC,False,8476000000,8476000000,0,2
1A4GBUSCnEYY1Xc8Q2unKrrhKQYVwzjTVc,False,736000000,736000000,0,2
1B4Xi5Gtf6W9E65CjPGeQMaKmaEiyWBFZC,False,2554580984,2554580984,0,19
14E5S974zeUFR4TW6B4m7swwA27E1UCrE8,False,1709000000,1709000000,0,2
12HEQdxxUoCtRCXK18RtFucuxwsTAjRrA4,False,8471000000,8471000000,0,2
1NTBZeSswJzsiPNnLDZufLghNxpd74mcQV,False,4325000000,4325000000,0,2
1MtEu79dNxWMwZCs9W5vUAKE27H7YD2pAQ,False,4773000000,4773000000,0,2
14mvyhNfMWEhBhSKnanwPuNAVAHUEpGJad,False,8466000000,8466000000,0,2
12HA4XLZFFM83gkEZzkkHTjE5wYdZDXdA4,False,1606000000,1606000000,0,2
15Z4vEW8urfTCw7fD9G3MCdiJdLHYA2VFZ,False,603000000,603000000,0,2
1J2HGdPRK9zrkMjH7Ybpk4xWmUTQwwmS9D,False,169000000,169000000,0,2
1BzZXmW58KcRxnaPGFU3czAeA8MLiCwhzP,False,4265000000,4265000000,0,2
13C5tuwe1Tv857RWPjmf5MxDhfPZmEFFfc,False,7000000000,7000000000,0,6
1N6PrDTyYctbAugKvk8B5fLNwakgVMTMnL,False,1504000000,1504000000,0,2
1C3nbXjHVHq1X4PKmHovrvQppCG6uoFv5q,False,473000000,473000000,0,2
1Ln2WCoTDAcwnzWzNjpmQbBbway14fKrLr,False,1403000000,1403000000,0,2
16mRg5zaK3xiqaAou8ja81iwn4WKRJWhGB,False,355000000,355000000,0,2
17sPdDr57QKZCjDfTSwKJ8SVhhFpVruGtB,False,1303000000,1303000000,0,2
1P3qEFrBkNpnDy8JKkZUiYkYcn7wqqazpS,False,245000000,245000000,0,2
1E8f5G6LGvnc8yWpX1xiz3PnVdoS4Prjnr,False,4999000000,4999000000,0,2
1FxkKaLm8P2ticCYktX6VZfrBdtZZNWhW3,False,32400000000,32400000000,0,2
1F3GmvTRP4HK55xcNT438WysJGZ3LdGUVK,False,8461000000,8461000000,0,2
1PB7qK6tuuD37CDLHMogr5RoFA139Z7vFL,False,1251000000,1251000000,0,2
14rZ9DauAQcWbKj3wDL2w5eDQetGqb8GCv,False,140000000,140000000,0,2
1GU6LoKsmCpDZRkCupyU4VKfVkti8viKhR,False,8456000000,8456000000,0,2
1CaWrbvQ5LFFrtxgkYSbW2ph5ZjoYx2fET,False,1201000000,1201000000,0,2
17Tiab2eig4NykUQRbM1YVf2JxKbMZeHFE,False,36000000,36000000,0,2
1Lokdx4vwHanLXP5hPWBCBWpHKCT1MQYV8,False,1154000000,1154000000,0,2
1G2dAaH6zJgyboa66WQT5b67kgrcsGMSLc,False,1128000000,1128000000,0,2
1HmMaxbRTb1ZBsEA9gkfehgcJfF4x1FkVV,False,1112000000,1112000000,0,2
1JmtkLhgSaQgJwHLSR6ELcem8oH44bzPsC,False,1096000000,1096000000,0,2
19QsobhNQ8hVq6t4JTaC37rKCw3Whr5jyK,False,1081000000,1081000000,0,2
16zWkEFD29AP5GKDYkeGiCXhaoBeXH2M1Y,False,1069000000,1069000000,0,2
1Mk3GTsZiB2Hmm9miXDmqyDtp25SnYZxBA,False,1060000000,1060000000,0,2
1QLF6ySY3FVCkmF2NHXYpWaea96WdUvsBU,False,1058000000,1058000000,0,2
1KJn5q1dYr6ZZvqAdPwd9n8LAb29o7Azbr,False,1057000000,1057000000,0,2
178bBvwQg2nrGQbv3MXv5SGNGWbwxrNYJc,False,8451000000,8451000000,0,2
1CmzvLjxDKKNxZFgC6BPXVmRrj4t7vXtwW,False,439000000,439000000,0,2
1AnLwSUM4aZuYAE9wPju6mzCfnvN48yU3Y,False,51122000000,51122000000,0,3
1N9DZMEzhB548RTcRnXS6nAZeYkQKvy2u9,False,8446000000,8446000000,0,2
1PEh2ykkiLjfkxHBeES8nMDWrQTaiB9dK4,False,32500000000,32500000000,0,10
1LfAdEon4q4gz3Q4tT3K7WPsnACoHBg3HD,False,8441000000,8441000000,0,2
1GHdYASaJaFbzezPpKVAStNEgXM1m9tsqt,False,357000000,357000000,0,2
14NKcz5wCNYv87Bqz9QApnfdPzDQzunA5E,False,12000000000,12000000000,0,2
1PfTw4E5xuNuMXRWvSyZPjz6heFtsQnKRG,False,3896000000,3896000000,0,2
152ygyP6f5v2ojRrJ9b5gnRcWVi6pPms4P,False,8436000000,8436000000,0,2
18dCiyFg7jcAgd5PRH9LTer8aZNjTaXuC4,False,100000000,100000000,0,2
1C3wvMXThbZBHNNj3kPVB278g9tZdpePVL,False,32395000000,32395000000,0,2
1KqZriYox2R3Qs1kYD1NymZYYS1N1K4WUT,False,319000000,319000000,0,2
1Aappi5MZ5FzwjgdnwnADBnmBssavp5JQL,False,4813000000,4813000000,0,2
18MLphWtxyMHRUmwqjYbCsB8UNubRmZ5cs,False,4565000000,4565000000,0,2
17MgAg5YVcVLuMSBpfBYvoLiZSUbSRpBny,False,4437000000,4437000000,0,2
1KVoqeVuhrv5keSUn3mFkvjUrSc7Z3gnZZ,False,3954000000,3954000000,0,2
1MwYsFuZF71JtWnCAmwPEuKV8V725MkT7U,False,4325000000,4325000000,0,2
1Hhpd2jPYKZL1UVgqEurxnLuDPipVi4e7K,False,4136000000,4136000000,0,2
19J84qNSVzR1PkPF6K7DCV9pHReVVZ7qfp,False,8431000000,8431000000,0,2
1PDJUgWmmkJR6aQSCmmfE363PiPQCwYfi4,False,4845000000,4845000000,0,2
1PsV9SDAMn8H5ga22tqyBYYfb1p3dWbWw,False,545000000,545000000,0,2
186HLed2GRtY7NHEfEu819hs7Znf2QcZuh,False,3642000000,3642000000,0,2
1Bo18Bus1pZ9tkgJ6Ep8UgkbqtCCC7scMM,False,4976000000,4976000000,0,2
1NwpfaczBT7wkBowvdofMeemDzT443QcSR,False,123000000,123000000,0,2
1GmQFYyTN9TevJqLbrqngzF9m4Q7rQxeun,False,4696000000,4696000000,0,2
1eu9ue4LWDY3jfTBM7XhXYRXZtW4WYTo4,False,534000000,534000000,0,2
1NpcKd2MwRFVgAa2dXwadQKGQND9k2LXBB,False,3858000000,3858000000,0,2
1KWZVzLmdC9kEDPPVKeiPWnLDpYJtcQUE4,False,3037000000,3037000000,0,2
1GVSEwLLGGUsxpNGfTY7KRaiDbjKX8ArVt,False,530000000,530000000,0,2
1AwbLRmtqnu1dAZhoXrUEkYf6gwGUN78yr,False,8426000000,8426000000,0,2
18hHFV6SWfyknxSKwyD2aHG2PiohweSRkb,False,528000000,528000000,0,2
1Ad48KeKD9ESC6oRAsLfp3sAojvMsAkpR,False,526000000,526000000,0,2
1NA1ibrfmkogWnpn5y8fZb6azUSJR9H59A,False,525000000,525000000,0,2
1J6PVE7E5aZP32trnGs39XU39cRxxpkq3Q,False,8421000000,8421000000,0,2
1ALNeJPDj2RWMjmX3gsytBHnsG2SEMTVUp,False,524000000,524000000,0,2
1MArYvACT4LDcwJPfuDYxwwed6jtAaba5P,False,8416000000,8416000000,0,2
1CyPTez73fVn7KwXPCu3Li15e78eag1aMY,False,298684021000,298684031000,10000,6
1AvsUWpw5rKf7MdZwGGZ8USr9mehWi2a7j,False,32390000000,32390000000,0,2
1JsvCLuqPYXfVCkqhWVRC3YZnh4PkCJ4fY,False,8411000000,8411000000,0,2
1E4PXB35Dn67fXecyiZ4S5ydpfSKFUcL98,False,8406000000,8406000000,0,2
1JCXHCBPGojHvqMTviagi5FSroRdW5wKRn,False,2500000000,2500000000,0,2
1J7kmS3sp482qHXuEaCr6qLUcKvbkTvYHR,False,32385000000,32385000000,0,2
1NK1c7s5X3QvRMDS8U9bCsbQiaFvEnBFsA,False,8401000000,8401000000,0,2
1Kn9mXUjKXAdpqMY8nTMyoFFVWNrYh7dRp,False,4810000000,4810000000,0,2
188aZHnAFWZCwwpNswLbJrcrNg5W28BDR1,False,4833000000,4833000000,0,2
1G81kxcTEEmD11y7xJnSxizvmQtjSSyXAt,False,4773000000,4773000000,0,2
15W2pKAkBZWazUYRPYE9KrM3t9mVgvhYpU,False,4628000000,4628000000,0,2
14vCWrNCpwmo8PWV7t1TSVg8w1JDa8qLVK,False,4592000000,4592000000,0,2
14WjxLoW1Vm9CdHw1xxS8UUZBgXbiw1wSP,False,4448000000,4448000000,0,2
1BBq1rNaVugZp2sMEin2r1nFBgkVjPdqzG,False,4207000000,4207000000,0,2
1NhvPFAPb6owr9yLd4M26Xrhkc983G6zVN,False,4076000000,4076000000,0,2
1LKhheftS1RLZsK6B7WmZ4vK7Z3sQPMcSG,False,3797000000,3797000000,0,2
1P3rVU925JWGUNa4ke2zcKVTYzaqWUg3Ne,False,3594000000,3594000000,0,2
1QAaZcRKNzEVyAhJtWw3XvwnxHLw3aPze3,False,3311000000,3311000000,0,2
1LJCC2EPzi1XQtjxQTdXVRkEe1AbRknHFZ,False,3211000000,3211000000,0,2
1CPLEpUuNGcwzBKCg1LLNJD6Ur9nuR9s52,False,2994000000,2994000000,0,2
16TWPsCLYBHgqtyijA2HY7k1cQvR6ABnNg,False,1000000000,1000000000,0,2
1EdHjyvdH8xnL1riBGTAUdvSr3BtbRBCB6,False,600000000,600000000,0,2
1HyBdgbD2hLLEhzFrssihHjLPRXWCqc8fn,False,520000000,520000000,0,2
1CKAMwUnLvLHY2rAsgkoVSSEfCQ25p5EGc,False,2846000000,2846000000,0,2
16wFQikL8ouKXsbeUA26S5hhpAgMfBfnSZ,False,55623000000,55623000000,0,4
17sgH6DLd3Ak8vedrQ1331UDeTNm5MV594,False,32380000000,32380000000,0,2
1P1BD9jpGYTCMJAokoov7mSGQkxiqHN74h,False,8396000000,8396000000,0,2
1Bsz48yHwnxBvkuAq4KEfteAYtxV37TJZz,False,2708000000,2708000000,0,2
16SmG569mXAcc8BQr87VJfBqVfSBxH9RGu,False,368000000,368000000,0,2
154RuLLbPrd3gSDMczbF73WUmF5wHR8QAw,False,32375000000,32375000000,0,2
1LVRYaDzAuqd4ZjEhfnynBiFb4iYqBTgK4,False,8391000000,8391000000,0,2
13QhWofZcrsaAZXECX5aaiStfLqqWjBvN3,False,2578000000,2578000000,0,2
1LwkKTHSURKSHcTffvo4NrrzF4JeRq995y,False,216000000,216000000,0,2
1DAF5q733vXJxkV4XxPYTtDqaKWQzg61au,False,32370000000,32370000000,0,2
1Q88iBJiud9XA6nNs4HaRG4ocb8bT4eoVA,False,8386000000,8386000000,0,2
1qTghjRi9ptUmepMAn7qdMqai9SNmrKKr,False,2454000000,2454000000,0,2
195p3MAp2LTvHhbLo4GgY1GX3QnrUbc9DX,False,40000000,40000000,0,2
1LvN8LJ65aa7Sayq5LBiNujzq1VHTUwvyD,False,66000000,66000000,0,2
1ERRzSdZBtDCRBhejGDMBMFVW3mFL8bSxZ,False,1322500000,1322500000,0,14
12RGwnP1hTXMrUv7pnLoMSjq7y29ztyj6k,False,32365000000,32365000000,0,2
16K4ceTWEcS7vsgmoZAmFvsZ9TWjJmxsP2,False,8381000000,8381000000,0,2
1Kxx1Vn8Nc5Tx2CH48mvGLdvzJoiA22SNG,False,2333000000,2333000000,0,2
132xnKmwr7yRgKWvQsTxWLepreGsBb24cy,False,32360000000,32360000000,0,2
1AxDEwy5GABKjBrRDcVw4qqz8tjT22tZUG,False,8376000000,8376000000,0,2
1KRMGFmuws1GueJAg6eGvAeNJWm5t1JbVd,False,2213000000,2213000000,0,2
1YQEArdchAq3nEynXXeSBaMmtYkY6WtBJ,False,8371000000,8371000000,0,2
1P6Ddup1fmjhwj7hMyVjqT5TvvooHdQGbP,False,8366000000,8366000000,0,2
1EcSrM5hmvHAaN8ikdjETppr2MyA1WUxFz,False,8361000000,8361000000,0,2
14tNnzhzDNcEN5JBENN2py2W5oFHQz3Sav,False,541000000,541000000,0,2
1Pg3whP677PyrfvpSTgQAREdREWBVoXe6D,False,2103000000,2103000000,0,2
1MXeREHDqLEzXx7w6KR7hqzTz2N6YUbDee,False,2003000000,2003000000,0,2
16uyhvQS6AyeqAJhw6GS7f8fA9np3hwsXq,False,32355000000,32355000000,0,2
1FPX1JM2FHmGPJxGcah3Pe4wUeKNexkYf5,False,1973000000,1973000000,0,2
185dc1rbkG4z14jQA3aRSgdXsSnLaR2Wyg,False,8356000000,8356000000,0,2
155ZepenVjUDW8uagvnWG8VGH29Y7ULC7f,False,8351000000,8351000000,0,2
1M52zqUmiyX3ZjL49nxHKYNGC5SJkSAHF6,False,1946000000,1946000000,0,2
1Nv34sW5eqcbsCS8QBTmvbf64av7Ffngui,False,1940000000,1940000000,0,2
1DGasnLibSgdnV4LdAaHcDMo6tXesJX7cH,False,1934000000,1934000000,0,2
168FM6nwaRmFjtqXadEErHws6gDBp9qBvB,False,4995000000,4995000000,0,2
12SbJ4T3eGnwUps2m1aYHpcgetyixqTBkq,False,423000000,423000000,0,2
12MZDyK1bg2ievohwc4VWN4Sw8MqkBE7z9,False,544000000,544000000,0,2
1GvqMAoKNB5392cwXvJfSpHuua4kvW3wKD,False,32350000000,32350000000,0,2
14QfekDrwCBRt1Q2T8X41hgDAufavnwCqR,False,8346000000,8346000000,0,2
12CfsZ8PPfnJSmmajq1ewKayywA9QRpfa3,False,39000000,39000000,0,2
1AAJXhvy8M3pD5dP4DCDpXYTpaAcys64WE,False,666000000,666000000,0,4
13P5tyLsNVDjRoTJLLEtvmStiAqNFSwE8M,False,11100000000,11100000000,0,4
1PfFRJGq6gWiW56e4FpyPLPRG2XPMKF8gn,False,4951000000,4951000000,0,2
18ympvttPXVtuZbBAzxki7VMzMKYporEdA,False,4975000000,4975000000,0,2
143Sb7AQLyLSAgAozjonAZWPcUQxRfBWKQ,False,1400000000,1400000000,0,2
14nF7D4qatdPdPr1Kwz4Szk9YU9vp7mrHF,False,32345000000,32345000000,0,2
16TjCbZ5dCYRhQdvccE39ySfc2NoMWRFLi,False,4741000000,4741000000,0,2
14TgbGyLp9rLhonPyRNbtH1Am3r8v1YFxc,False,4718000000,4718000000,0,2
1GiS2gVi8iRrsNjzYrtNMVFv8nNsVu1hM,False,4676000000,4676000000,0,2
14XGyRZsv9pwBCbS31cdo1RN1AmKxSkUzX,False,4526000000,4526000000,0,2
1MYuDPBrqdFPnTZuMKapunbuNsUdwfq2Cd,False,4484000000,4484000000,0,2
15PoFDEpoEi51HTXHk4itg9rhkxDeCSZKr,False,4090000000,4090000000,0,2
1MiqMWHZasc8bhgRqzdwdX6gL7wUPk5wGK,False,115000000,115000000,0,2
1ZdQvzqxuN32kGSXtYhMWZxZ5WkUzsi4U,False,3620000000,3620000000,0,2
1QEVsHofWfs79UxQJwSR6p1XmdQhQEguWF,False,3403000000,3403000000,0,2
1Bv9QgmRMnrsGyDZyhiTKSXPPiUgaWEYZR,False,3120000000,3120000000,0,2
1B1updSwdLfnmexmXjYfqzSWPHLFzieDSs,False,8341000000,8341000000,0,2
19ewsVrM86zfYiT8JWVo5Qb8uGH2kRrW8j,False,2510000000000,2510000000000,0,11
1GzTau855X1uPeDS3JkdXjhBULdxSLuamx,False,32340000000,32340000000,0,2
1HvUWXGozmVznGgk2qvbUbF5Y5HwPDaKeN,False,8336000000,8336000000,0,2
1KeUfQp4d8nKny4SFCdJMG11TD7QG8b9fT,False,95000000,95000000,0,2
18o4XhyeqoG9oW4pmJf9YxTeGj283EWoTG,False,8331000000,8331000000,0,2
1CurYCGf3t1XZnej5wumpboVzKeFZnLcC7,False,84000000,84000000,0,2
1oXVC7uKgF8MDMceYh9zu5nqK4i8iZGAm,False,8326000000,8326000000,0,2
1GZxinzujscz4jHjkv1CheQEc3rzS7d5cB,False,80000000,80000000,0,2
1Pn8sRPaFrh6nCu3hdRJorj8xbwq3JmiYC,False,8321000000,8321000000,0,2
15YyV4aU224YBBwxg1GHF1vgV45skPo1di,False,78000000,78000000,0,2
1GEtSuBSF5i67qddWRoQUT7bc15HCbZYA5,False,76000000,76000000,0,2
1BWuTh9oCv5192QHum4xmN3wZiqNpNdNAA,False,4896000000,4896000000,0,2
16SVxcnw79A2eaShJtt1t1PUHXtc7s1pRt,False,4624000000,4624000000,0,2
1L4uTqSTMqPXrrNFmwX3U4XaRrJ2zRC6vE,False,32335000000,32335000000,0,2
1JAr1Xs1zc2Mk74mM6ndhg4aGEzSAe3P1V,False,4870000000,4870000000,0,2
159bRyk9TxwJcNGqzMvQFkmyFafZ5qyBUz,False,4846000000,4846000000,0,2
15WDZbeoXfZG1KNonh5ffEbbm8u72xsJ7v,False,4632000000,4632000000,0,2
15Y67mR6ShxKcW36FPqAWJtrQSvd2eP89h,False,4595000000,4595000000,0,2
1KzibjtEWpmQd8KStEEL9pvfDQqPg85u3u,False,4550000000,4550000000,0,2
14enW8mX5QFGFgKHqihvfpcjHWRU6UiJg7,False,4396000000,4396000000,0,2
1Q6KFc2K27AtNdJaLkeMj2gNMqwCb7fmw3,False,4349000000,4349000000,0,2
1ABtKpwXcCFXUVoP6ovubodjBoCRevoSKf,False,8316000000,8316000000,0,2
1H8Heyv49XpW88CSxm1iH9QixAWnypXCyp,False,3929000000,3929000000,0,2
1AZ5odzUBfQ6ANmpu2o1qAvaGhczQujawf,False,3439000000,3439000000,0,2
1CpWdn1ErUs98YttihNFTab9DcwgDDAR3N,False,3198000000,3198000000,0,2
16B8vTFRigKcV4rx9j6md8uRtNPShxzyk8,False,509000000,509000000,0,2
18JkTXsuh98XWUiFqbU3NTU5JyRZWCECQg,False,2611000000,2611000000,0,2
1BSHJPhcq6TemvzDuhBpZX2wUfCv8PKr8i,False,1199000000,1199000000,0,2
1MHJxJd3uiTCKLnnzyFtLCzYnAXqJgXgvC,False,8311000000,8311000000,0,2
1M9q499QU51Hp6813m611y9JGzheSEieLe,False,100000000,100000000,0,2
1P3YfNC45LuvLEurPgNkLwTVUGKYzzMdA2,False,119000000,119000000,0,2
13gWJrNS57Mz5oX1SXTVFyt2cG4LhFee7z,False,191000000,191000000,0,2
1NM5tJFA8odLaHJgVhTKAbXvF2wzQ1B1XV,False,1096000000,1096000000,0,2
14GpASy8XHZm7Jfy5JHxHkTr8vdf5VpuQh,False,32330000000,32330000000,0,2
1FQMWLze847tmfKAYXtz9pTGCp1pUL1TFB,False,8306000000,8306000000,0,2
1K3ZjRw6dZj2EheKJZE2vD5XJ19t8yQbnn,False,550000000,550000000,0,3
1LKmf496qQy684wTKC2VZDFYn5qZcWNwZ9,False,1001000000,1001000000,0,2
1BvqVxNmdGGLw844Px19ErLZ7uRB5J2z2F,False,115000000,115000000,0,2
1C1xajUbsDzd4PaYLUh9noLeBKrfDRyE6e,False,111000000,111000000,0,2
1FFj3cKYzHB1Jbprmkqe79rkFbgENG3WR5,False,107000000,107000000,0,2
17d9NGcRFKqpVEYxyoUA6aL6P3eaxUnKXH,False,103000000,103000000,0,2
1Pyh6GAEb9UhYW766HaA1vbZtFB8ZVKAsC,False,99000000,99000000,0,2
1DU5uLxoxVAeHu7pheniVgnvGkkjAiiquR,False,95000000,95000000,0,2
1H3pM1zZZDbaWpRwDpskaf7bAp5MHbTLGo,False,91000000,91000000,0,2
1Hje5JuvsXr7qoyy42ru1zzQL1599SAH2U,False,87000000,87000000,0,2
1LhP4pGRSQ3RjgEX6Wjja4sjJ6zUeoQmCT,False,8301000000,8301000000,0,2
1JGqWMzTLs5iogMbEiSKRPeUVD4sqin65n,False,4713000000,4713000000,0,2
1E1KSZV9HhFx3XBpE6Sa49x4tP7mDJUGdE,False,910000000,910000000,0,2
1EitegCn1d2u4bFmzYdiYAEnpz2SBCLGCt,False,8296000000,8296000000,0,2
1415Xyrt1RY6fwtqnYqTEjjbwb4zgboy41,False,858000000,858000000,0,2
15yWrAsxzKkxyFcVsWNRdf1JC1iBTH8Ciz,False,829000000,829000000,0,2
1JTxp3A8PEnybeV2UhYFJx5ftRzj4DyHb5,False,805000000,805000000,0,2
1NtcAUH7THbjANRwU4JPdnCC1xwDPhvBPJ,False,804000000,804000000,0,2
137WjYeten8TcBixo52xRFsx9YRAfSYaMA,False,2106010000,2106010000,0,4
15V1FG6AzMF5SXAvNast8ii5L8sNeQaTtf,False,32325000000,32325000000,0,2
1CS5rZvhzqbUysS2Bebs6FLn47CBotMGni,False,4845000000,4845000000,0,2
1JVWYYEiFUesrPRkdRZWHMZa2eUTrDYHg9,False,4789000000,4789000000,0,2
1HanvtWCgAssRjF79AVF2LZaAqwSEC9yPz,False,4818000000,4818000000,0,2
15meSiVrsfQ68UvJfc8TskDqX14rdftMMV,False,4554000000,4554000000,0,2
1KvjyDH9ekeWtwAhSwHvfUmsQcZ6KHksS7,False,4506000000,4506000000,0,2
1GRQipR2Xiv6fnrEPdg7F4NiiFF8niLCPB,False,4450000000,4450000000,0,2
15opWNJbBBmAGejGuWoQcTZfNPKVgUvm9R,False,4296000000,4296000000,0,2
15TpWKaeysSCjJBfGvGWaALhQSAxykoyve,False,4246000000,4246000000,0,2
17qma3Sw66D3wXMPDa2QVTygetiWRpfo3a,False,3819000000,3819000000,0,2
1DmkptpGfiuHvgrbNAt9rDv7BipuYbRqxD,False,8291000000,8291000000,0,2
12RR3b95mf1rw3y8RGPRn5ats2g58nr7fG,False,3328000000,3328000000,0,2
19GEWp6QSHneSyre1q8Qu1EvF4XoNU7iAS,False,3082000000,3082000000,0,2
1DwLwczU56FJKB6DaeqoSysxcuu7wdftMy,False,2460000000,2460000000,0,2
19MJczJbhHH8Ur7EDjFQNeDZnHpqHF4HjG,False,8286000000,8286000000,0,2
1CmSAnzCVRMd1SoGRcGSij7fMyk5wMZjPU,False,462000000,462000000,0,2
1EjrNVjPxYWZ5TKfMfE2aYbYn95e932gSv,False,439000000,439000000,0,2
1HJ4v1C8m7vAkC8Kp1hEUbgSvnHmtW1bBa,False,419000000,419000000,0,2
1LtivNWBfagmCGjb6nrxdY5RWYxqrZye4p,False,407000000,407000000,0,2
15QJjXywDLvjczGbf7eGqVCj9VUY9k2Wf4,False,397000000,397000000,0,2
1FfpmPHV47kR6Bx2ZfR4zmLJt6QxySuPX6,False,388000000,388000000,0,2
1H1RAPYirYapc4oqBDMWjxWMQBeKXXPTtF,False,385000000,385000000,0,2
1GEofCMCZCVKJCQFEJND3wy7vgLs5NcYWL,False,383000000,383000000,0,2
1EZ1hMEW6yDG11iJkvVdnKQFCEGh4ZYrUr,False,382000000,382000000,0,2
1CcABiPPKZ66Pg7VgZcCu1hTci7wcPuvE,False,19901000000,19901000000,0,2
177AS8rnFwsAR4T8tUFW6a5Pn3J1T77VPx,False,2100000000,2100000000,0,2
15kDhRAcpgsugmh6mQsTcCHdvbsuYncEEV,False,8548000000,10463006815,1915006815,21
1Er2znumVxozAzk5m45jVzPDrxAfz2zmTg,False,32320000000,32320000000,0,2
1QEKWaGsd1sxVaR6M6ffh1oSWPEKmNkNaC,False,8281000000,8281000000,0,2
1HpQp7Fd1tK6PrrtbWRcvsPszLmLsaAvN,False,32315000000,32315000000,0,2
16BTwwA9mH86mn2sp15RJipFWncb7eNnkb,False,8276000000,8276000000,0,2
1C9pwJfDqvk8cJvpmYtqYHNRN33GpSiFKw,False,305000000,305000000,0,2
1QChNxMYw7HVFjwGQ1k4iNQUdrSVZA6o9j,False,32310000000,32310000000,0,2
17TH44RcEYaA1VdAPKN1DBC1orE6WLnMvi,False,8271000000,8271000000,0,2
13vty5FTe4UzcwFeRqeXH8xDTzvSRHVkWj,False,8266000000,8266000000,0,2
14D351fbMwL7G2RSt2Chrx4KPWbovoH94w,False,4711000000,4711000000,0,2
14bBAvedy9mwtAGpGstXMLRiWe38QPWxcF,False,4709000000,4709000000,0,2
1MF81FypFGQhZpHcxuzempmjR6fVvCt8vH,False,8261000000,8261000000,0,2
1F7qEYEEh25Ak6kixCuJ3L3QSv5oKB8Q2v,False,4519000000,4519000000,0,2
122jCaJtAhgaTCGpLNxB2qdzKDE97W2SLW,False,1520000000,1520000000,0,11
1KZbCB7spcGCBnUDuuwrXDY4P7qTT1myKo,False,175000000,175000000,0,2
12BCrp58taEtZGkxfxJQowVNmtjnGmdpVS,False,100000000,100000000,0,2
18G9G2gJYBF9JiM6iWdXTGaNpGfcbDTUun,False,4329000000,4329000000,0,2
1KhBRi5Et4KN7zBsEApn29cVrTqGCZTbqc,False,4139000000,4139000000,0,2
14kGgg3sX1fpAG7Kg1yTaSFTwis5UDfajx,False,3949000000,3949000000,0,2
146qPSYxRQEPfX1oyxsktTh3QWsDdLuTTW,False,3759000000,3759000000,0,2
1JACnoDQmwNfQdeWeZfTNZTdXm7r5NFVBe,False,3569000000,3569000000,0,2
1NBZQtP9i3h98mzruXmoF2JXn9CbRBNBhz,False,3379000000,3379000000,0,2
1MMB8XoczmkjFPNJZXk1E9dSeHA6aV8ogs,False,3189000000,3189000000,0,2
1NfurFBQC2ubdFP7K4XpK8VwxmqwZSZr3u,False,32305000000,32305000000,0,2
1PDqzbpsBRGkTDR9HwkSi1LmfQj3m1gXGS,False,8256000000,8256000000,0,2
1mVZ4iYo8WRtLKP84rfk1urbiQpNsvcBm,False,8251000000,8251000000,0,2
1FN8bib6Ui7eDRNg3MjAGPFbimQUrh8JDK,False,8246000000,8246000000,0,2
1NAN3DndyzPFFL1ArjpwsJoePnmhFfduV4,False,50826000000,50826000000,0,2
13vcTST4kuBdnWeQEEzRGor4t6RaLbaRDy,False,2500000000,2500000000,0,2
1BiY2yz37aZY9zVV45LVfwHPhmJrFymZUX,False,32300000000,32300000000,0,2
183R8xwFHPbvhBjbyiCPmu3BNYyskjrdQo,False,8241000000,8241000000,0,2
1M8Fsev96U7uC1A3MN6PYACYMNCKVKqoaV,False,821000000,821000000,0,2
1SYCxVcaqUttDdqZt4d8Wj8TUz5iLVmcQ,False,2368000000,2368000000,0,2
1GrS7aZNEKLLy93sSL69VuyxDdWaRtyYdq,False,432000000,432000000,0,2
1Q4GHBL2JX5vXq8MHq6zYCpoFrFaYvHQ75,False,123000000,123000000,0,2
1Nhv9HkW7zJowrtD1Va5cHPDPBdP6scPTV,False,37700000000,37700000000,0,2
19F1FsGt2vdwGiQVZk5z4q8EPBGX1SaBYo,False,4000000000,4000000000,0,4
1Q9K7LrMp3Q3ycyMMv142UfmiGGzSFMGdG,False,32295000000,32295000000,0,2
17UsA7DSbK4TWBbAejafmRhc2EHv7yRtTE,False,8236000000,8236000000,0,2
18xj6i5n427sPUmyaLHBDWcJXHMYw4XdUY,False,2083000000,2083000000,0,2
1GRLYdjP6kwgGXTS2Z1tfPDStwEqrh8nWq,False,285000000,285000000,0,2
12cDc7iQ7SfcX2ZWJGFTagVipTQXyjFg7H,False,32290000000,32290000000,0,2
142FhQpPikrXFDJao8Vx7vtqfxSkZxZict,False,8231000000,8231000000,0,2
1F7AhjsEonusw658dLWeU5oi9nSTemiJDf,False,115000000,115000000,0,2
1AeLgf1KmMjwj5AoGJcTDGzBRkaZxCU8FT,False,455000000,455000000,0,2
1C9G7faKrxvG1SevN3b6Vrajuaz65f5ULq,False,150000000,150000000,0,2
132V58BuqbuVY69AMkvZcDR2TjMenjBKC8,False,32285000000,32285000000,0,2
1Kr3zv3difpR1KSaAf3GnATzKdshGtkoG5,False,1218000000,1218000000,0,2
18NZEyneFy3K5LuDdeWdD3HUFKb4jDjTMx,False,865000000,865000000,0,2
1JRHyAMYfRVMqKdH4hZvEexWSy8gtTNrV5,False,1800000000,1800000000,0,2
1HzXzoM3vMNWQJVyAUUqwWtLnAj5Nd7gyh,False,2500000000,2500000000,0,2
18YdDBkrhJ3NmPJ5pTLKgxnkeTNQPVhKYK,False,32280000000,32280000000,0,2
1JRmvVNyDtVDfepcUx8fmx5cT9TRyePbHk,False,860000000,860000000,0,2
16itXze8LviuLxJTgsCC1YudatfKTawW1X,False,1634000000,1634000000,0,2
18KiH4iBn5VjtiwGyjgAFsEBLn1A8qTauh,False,290543000000,290543000000,0,59
15oCtt4tujaUQr1JicBqePsTg5Mz7AN3Ma,False,3510150000000,3510150000000,0,19
14WnQ4jELM3xiT3THiBzHA4vJ3yCDBbKNH,False,100000000,100000000,0,2
125BXKDEw8L1wkbWxM71NjdAxyXqUe9zHF,False,1534000000,1534000000,0,2
1B3AazjLqgwwvQ1tGsYB9terEp2SiRfttq,False,1334000000,1334000000,0,2
1H5tgJpTtvn4o4d87zEX4d4kbo2NT7xE4P,False,200000000,200000000,0,2
178fwDBLTjnGphSffzsWWWwE5B7XR2D2Kk,False,300000000,300000000,0,2
13LTirMeDp8Wn2ydhkX12s37ZabGqfX6cj,False,1034000000,1034000000,0,2
1DD9wqmAQMHpdEziQjDudzP7LEDNWdHYAx,False,400000000,400000000,0,2
1KCYEkGQjuAFpiRHUhRNJvozzq628fTZeC,False,634000000,634000000,0,2
15NLgmRFQ9Xiaimnwy3sXcGGgHSLAuLasg,False,500000000,500000000,0,2
1EK7RiX5LXUbAuS1A3A4T3XEj3a1GhbHf6,False,134000000,134000000,0,2
1FEUMKxPt3BwB6Ykbji1rNHLBJeusVrGnr,False,141000000,141000000,0,2
1MCobfAscoNLN6xCyLnr983FrCipiRyrgF,False,1980000000,1980000000,0,2
1HY4XJWH8eS1xEjeKuKEWLnsPTr1m3LRr4,False,32275000000,32275000000,0,2
1PRrVoYNbCHNceYY8k1NtzrAvaDUpJM2yy,False,211000000,211000000,0,2
1LwYhpFV7g9zBhgK8RdwFSvZkpRMC6Vpsy,False,300000000,300000000,0,2
11Nyikxg65yKf2t9Tof5n4dHbn3hsJQd1,False,6000000000,6000000000,0,6
1qXGn3xPrW6Wjqq11v7ZYzHXsAcuSMisf,False,35700000000,35700000000,0,2
18dDpXyXMX9rUMax8NwRcixL84nxYdEsxh,False,60000000,60000000,0,2
1Lq2wCVYwrP3RhbHHyjuJ3qyqUZFZaKVEa,False,190000000,190000000,0,2
184XkJ3JMXJHi4VhM4u3QCnoTEQ6yXFnr5,False,4834000000,4834000000,0,2
14P6hEiogDWiTvjMFMA6CZFrUi48gaq51f,False,4951000000,4951000000,0,2
1DdXHpkcSA9quN669cQeQUGtbCSQscAALB,False,4767000000,4767000000,0,2
1Akq6bTUCc5isYvBuMjegZxHxhqjt5ANuW,False,4729000000,4729000000,0,2
1NeVSddkysRL2usGAEaPYzUravUTKc8rWy,False,4694000000,4694000000,0,2
13JMqLaj3CDD3mkRLUAkzm1jzh7MCmVFNM,False,4448000000,4448000000,0,2
19T3NfHbrQM4eMUWUrfYA21ncjq8apMeT9,False,4398000000,4398000000,0,2
15YMpwBkzPVpTyzXBnWNeZZi3frDhSTNTd,False,4331000000,4331000000,0,2
1JaWYiSuBszT8X25WUkqumrgxuJ4nVAcAm,False,4162000000,4162000000,0,2
1NchKmYoyChqMaMu9U6Y4veAUkD3QSnS9n,False,4109000000,4109000000,0,2
16DyerpwywnrQ8yfGGeccWXvS6qbWMEv1W,False,3673000000,3673000000,0,2
1GaKJKPY3ifdCrJTSELBhz4JdsmsNnKLWk,False,32270000000,32270000000,0,2
13qjSsaLmxN2i3UUie7cdFReDEs4PWangF,False,3179000000,3179000000,0,2
1CfoSsCXHDwk8kBKnXQMPDcTygE2L9xM28,False,2576000000,2576000000,0,2
1JxFimbGCmnJW5N867GMWpkNNVxRDyUQ6B,False,1953000000,1953000000,0,2
1JVBUpeL92c2ckYpwD8hLM5QGXDk37fM3Z,False,225000000,225000000,0,2
17u69F5pREytgokbqzc5gVh2P2xkp4qLZk,False,4634000000,4634000000,0,2
1KBtwMCLA1gjCsVqBH1dMkaW5cRs47Vrf2,False,200000000,200000000,0,2
19nTSsFvEYbpeiPGStTNRLUg3jdmuScynK,False,100000000,100000000,0,2
1GFUcz3rgsNEMETrC6qpeHY8bVEwzW58NM,False,90000000,90000000,0,2
1A95t99uccxp3qAYh78e76Mux1oS8164Br,False,196000000,196000000,0,2
15y4n1DpFhmyNgDSuQhtGWERQiEr1CjiC3,False,300000000,300000000,0,2
15sYW9kFoKyKk9RNAHYW1Wh3CK564xNVey,False,4334000000,4334000000,0,2
1Ex91EvEjroJv1mXJf7CWMi9tfJsrU1L8R,False,173000000,173000000,0,2
198PM3NJAXzQF1bBhyzpjNzZYX7TuZVKbC,False,1000000000,1000000000,0,2
1LLfRnF1ctHDfTt3iesqxvdUYTGJXiwpBf,False,3334000000,3334000000,0,2
1JJ9xL961Bdbky6KeVkMAbFdo96HcJcBMr,False,152000000,152000000,0,2
1FfbMXbyRnDfqZhri12KqWTqa6NZQf56eT,False,500000000,500000000,0,2
1HHAxqYTx9p3zSPT7X7AA5Kh8RiGqYZQKu,False,2834000000,2834000000,0,2
1F814DGC65Zw1pAc3rraKYNAyzyMp5gpX,False,450000000,450000000,0,2
1MTxUFgctvrqBBbhvdQfPXeGPJGgwG1aY3,False,2384000000,2384000000,0,2
1M94gZcPb5MEgzcF6ybGpLS6NxYXz5AMUz,False,136000000,136000000,0,2
19PVtAiQ3vxNRwvdeVjm4boYZTkwSvPuhr,False,123000000,123000000,0,2
19YRUAqVAj3YVgiiPrm3616hZeCRExMnXS,False,118000000,118000000,0,2
1PZRUBjWV5aotGvpPgcxV1gftFuXBgtf9i,False,115000000,115000000,0,2
15QYopAcYCqeL6HE3cKoSmvt4vjnmJANrQ,False,113000000,113000000,0,2
1ALS4DmPT85sD5U46NUijegVbypSFWY5vh,False,111000000,111000000,0,2
1A2kmMxv5wkVzU3i9BCSnRDKmvGWHgUYWb,False,110000000,110000000,0,2
1NrHh9HZjzCxBZASVc2Wau3V26bh2o9ctM,False,109000000,109000000,0,2
171vQMpnjg9Ph4U5KPiaMy72EG2vpKxDkv,False,3990000000,3990000000,0,2
1VnEQq81DBP1PAtGruntinTUNxYLsCDm3,False,240300000000,240300000000,0,14
1EMFjZm6DqMhWypw8gC5wgEzAKTnUF7cHj,False,32265000000,32265000000,0,2
1JiwJx1Lj43TQ9bqik2FUEXLaupuZz7H4G,False,190000000,190000000,0,2
1J8VVnwj2dvYttdEHuEPDJGa6Bon9RcqbE,False,32260000000,32260000000,0,2
13TwjCXayFKU7VuRV2Sgx1gGetMZ7yYoXV,False,933415000000,933415000000,0,20
13FTVuQMWyd3jiwHsfFZAP1AJPcYgPNiWV,False,9500000000,9500000000,0,2
1KPWDubt75f5WXTCAW1mLRnSvrfuTeuxGL,False,32255000000,32255000000,0,2
1cZ16gkfJr4h9HDgSXkYkC74W3Gc5rZ3k,False,2284000000,2284000000,0,2
1JFnBagopSX21nrMzgQs2q9hNBAf7kkJsh,False,100000000,100000000,0,2
1AfnX4JMbYUqno82NrDTkdTn9T6QJze39E,False,100000000,100000000,0,2
169Ccy11FRQT5W8dBjk75NyMwFVd3EBFUp,False,2225000000,2225000000,0,21
1MkxZ2rkFYW8dRu92YaqA1z7wKjRuGLsuh,False,290000000,290000000,0,23
1LRzqbKqCi4Het2XvRc5M66pWopgJbuPMp,False,100000000,100000000,0,2
19aUV767vGiE9DaNKUt51xP8PFAVAiEMRF,False,124000000,124000000,0,16
1GwMmdfuZDL9wvNd1zkN3b9FM8kU2sfqPk,False,100000000,100000000,0,2
1BJdRErZYH2r18179AUEhUD2umXNvG7vxV,False,100000000,100000000,0,2
1M2tsuVXJ4dPW9A5NFS6foBfXLwrNSxmxL,False,1000000000,1000000000,0,2
1MuPyrsFzJ6KGGPt1usbW4E9joK6kQWFgM,False,80000000,80000000,0,2
1PB6WhHnnKyHfzRiBCGK78HvHnn1xaxf4E,False,106960000000,106960000000,0,11
1Gpn7ZPHMo3eabHW19qwwwGeuqLPfFWMQu,False,11405000000,11405000000,0,2
12XafG5uejzEvTUD1p2fwECFDfpL94B4mb,False,20000000000,20000000000,0,2
1NMwD6hkFYFc63pvGZoDXP9APn2ugtANmf,False,5607000000,5607000000,0,2
1NBVpggWpc4Mc1hT3cmp3w2AYzdf6KJKhP,False,59027000000,59027000000,0,2
13BxV4cbUyWyVKaAnYe8zdkDrcnXMNieBX,False,5903000000,5903000000,0,2
1PyvFVJVHREY4Y91sfoRauHvedf4WEDWto,False,32250000000,32250000000,0,2
1BHWaRphpmgeXr1siBRBa6ommY31Vuk3wh,False,123000000,123000000,0,2
1CLoC1NLsw5hPcwqMTpSGEL2WwWewRdoFh,False,2161000000,2161000000,0,2
196YrPp98CxEiV8JGBNkEUxqN3erp379u5,False,2917210898,2917210898,0,37
18Mc5zWPMD14vixKUaG46wPpQjthcMPcPB,False,4500000000,4500000000,0,2
1MKXQKWB9CyF3B8M3u4JjMY7bKug5dgQx5,False,505000000,505000000,0,4
1MBgqrUw77jJUJg1XaBXCrNxhU7d48NHVn,False,32245000000,32245000000,0,2
1HCAZnbsZYQfmV8ahcRJvqknKZTAed8te5,False,900000000,900000000,0,2
1K6T1ZFof83VKPder1E2uTr56HmgZdFDPm,False,39000000,39000000,0,2
126xb9jCJSdxZxCm9Q8ukZBF6sD2rjJuxG,False,90000000,90000000,0,2
18zoEXUHDTydXskMfLGvzvumSP2Rj5jPhC,False,100000000,100000000,0,2
1KYUcottW1pFyQLzSYEqUDoWKXPH5awvBr,False,3215000000,3215000000,0,2
1CtcE1o4JorrZDnpJMHN3hDJXBbkcSTSS8,False,100000000,100000000,0,2
1NWBuMREZwePQVU6K4Y52nQNJK6LkR1TH6,False,80000000,80000000,0,2
18bQW8n6Cj5C3Uetv7zUbFKtMahVVbNsf4,False,4773000000,4773000000,0,2
1BLaSJrUp8LZ9s4uTEpaWobXLGaps1HyAJ,False,32240000000,32240000000,0,2
17vJFYgDzMxitpAywCqvt7KxHjYKzQDrbK,False,4998000000,4998000000,0,2
1FAYHacRei3AogXBXgDSawm6kDkNYHcUjn,False,4946000000,4946000000,0,2
1Lv1fSzFmZ76HfwNXMHu5rwa39PakbkzUc,False,4762000000,4762000000,0,2
19WD2GZJxniY8tr46CcjmGZzexciSYben5,False,4717000000,4717000000,0,2
1NLsZSGrmnD9Gbxt4TB3cF7xefJpdV77H2,False,4681000000,4681000000,0,2
17h8FCzL4UUt41rGd66ehRPXQRqAG9Wfyt,False,4427000000,4427000000,0,2
1FgZV55J1ALq2g9bDdsYUdZ22Y191DFEvS,False,4360000000,4360000000,0,2
1PzezXPdrMtBcWZeotMJwJJQ3SXYk9bAsu,False,4234000000,4234000000,0,2
1L3yS7sUQVf4q83HjxLUTby8Q2mEfarhb,False,4050000000,4050000000,0,2
1EZJ3ob6q7inATFpB9Mt53zyyMupURQPy3,False,3996000000,3996000000,0,2
1KXwimDAZKYcoT9AD3E1LSA8Um1VhAGewt,False,415000000,415000000,0,2
1EMX3S1Luj6PQ33qmM3yFBvX9ALe7aAurt,False,3052000000,3052000000,0,2
1Di6cToV619zPjtHUeeZTZjdDBGZAGYigJ,False,2370000000,2370000000,0,2
1JQJCHXHKS4kQaouTBzMboUQWZQMWsk4i2,False,184000000,184000000,0,2
1MbEfkcFnsMVTT9aAzjuYHoXvtVvpKqt9q,False,190000000,190000000,0,2
1GJq2SUN22L5xLMakQA5GGkmS1y1Q5AXK5,False,50000000,50000000,0,2
1EBfwrGcFtJjp93LaYMjAaDRHRwxX8199K,False,2160000000,2160000000,0,2
1AvNYNvfrthZSTBWy3wJKdEQ42YKErGroW,False,298000000,298000000,0,2
15Yo7eZx1e8teRZMA3Ftrtt3a88GCHTv3e,False,121000000,121000000,0,2
128eao5WWukaxCRgjDjSN3BppJoEetR5YD,False,191000000,191000000,0,4
1CL2BvXfWnwxcxdP4wYMfeib1icGCUv1jY,False,79000000,79000000,0,2
16RrmN95J2AqaaZnKKwytbWRwgeVUAT3Jx,False,189000000,189000000,0,2
1KdQufJkXBNbftvRmttmfX3Ucweb8CrL3W,False,32235000000,32235000000,0,2
1DfKSrty4TmrVShjZheVRN5cC8smd2Mmmg,False,100000000,100000000,0,2
1QAva8Uy9Uow8uqjhLg45Qe5QKcVHfUAGP,False,89000000,89000000,0,2
13Vreuu3sn7MFnKVJeqXz6hFcD8yFMwJJM,False,78000000,78000000,0,2
1DjE7kkgtrxRqqNoHazegE57YErKmYkBNo,False,77000000,77000000,0,2
1CEYrCfJafh1x5g4b7g6EXYvFKCLQH7aPj,False,32230000000,32230000000,0,2
14WkQtureFaTUF1ueDSb98J7SuUCXyAykm,False,2159000000,2159000000,0,2
1HjUDGGQfrBqKXMXniDJtStynarsWqxgak,False,1151000000,1151000000,0,2
1LgBRQ2E2EnLnrxYKiakTCv1c1oJxthW8x,False,123000000,123000000,0,2
1PTsDyybCg8fru8AnXQfxooD1bBUyUvTqg,False,43000000,43000000,0,2
13UxWP9RxofosxQc7pCvLPD1pUTyHMRybd,False,15000000000,15000000000,0,2
1nqpPF64GQwDTufioUdM6MCX6A8XvVGCG,False,2100000000,2100000000,0,2
1JRSk7RTXotNcBysYdcETamUReMc2GttLS,False,17801000000,17801000000,0,2
159QW6ZQTNSCfFFGVP79YTLtF8sp1w7fsb,False,1388000000,1388000000,0,2
1MxPuRzhHUDWNV8zBkfUSgcDKnAvgxqo3J,False,5475000000,5494480520,19480520,30
1LXtJWvwDDRs91JnifkBdTd2DcUKWvVPme,False,32225000000,32225000000,0,2
1QE2YTR6t5Tg8YTpMy6aMSokdddkntcUJ4,False,612000000,612000000,0,2
1GyyEcpMWmJJXFXDvEAc1m1Dcktf53PUyj,False,5375000000,5375000000,0,84
18TPEUxfXgX8U2RDDXidrq9AsLiPjFk8QR,False,515000000,515000000,0,2
1nZEjY3MMDQrXvA8TTDH1aY1US6p5h89f,False,8106000000,8106000000,0,2
1A3nxj4yci8j1yY14rjb2cbyzZUxrBNZRe,False,86000000,86000000,0,2
14RcQBV5WiGUTTG4VNPyvXvBQ8bYaCS5Fo,False,255000000,255000000,0,2
1B4BcEbjL3kRoPTUUM5NspPCQAt9w8D19K,False,1904000000,1904000000,0,2
123ta68243kFQdAaEPQXTV4x63D6YkEjQz,False,30000000,30000000,0,2
13TyZh37kia3fnxKj31KCVZXErY9iQxRJ9,False,98000000,98000000,0,2
17BpivcTwm5gzTd8dKWDVFPPoAxCxYFfbx,False,121000000,121000000,0,2
187FmAQo2jLGevR4ffMYv8LGrZ6CeJp3zL,False,1804000000,1804000000,0,2
1FhdDPU5MwERS9PUFoc5jWXxSUtLGrk9of,False,100000000,100000000,0,2
14Yu9mWGvMva3mYJVkGLxxng7QVXLxzG95,False,65000000,65000000,0,2
1CcT1fed5oqWcspMah8E2C7RBKUyXAeN5e,False,570000000,570000000,0,4
1HFpyCm25TQbiq5YU8iTAm8urvri1UT8CA,False,32220000000,32220000000,0,2
17k3Dxp9HJbNzjV8VY19xXM6PRcC1pLEDP,False,8101000000,8101000000,0,2
1ERKhhGdvHoUJ2Ux539ncdJ7FG41EpJNRH,False,15000000000,15000000000,0,2
1BwuSCdFqfyjxUMLnwhM6rTDzR1hoWg2g5,False,10000000000,10000000000,0,2
1C8nSKj44wynWivHyNbbtBqAvaeBN7X6AF,False,4787000000,4787000000,0,2
16nCkBwBqeSVdEsK4Q2kcSkBSAQSbmhVgE,False,4799000000,4799000000,0,2
1LwzVWG2v3QMrNJEts66R13swu2ErFa4Lu,False,4773000000,4773000000,0,2
18kYquR7za7kL8R1pDtkgNc3wENnJYx3ye,False,4808000000,4808000000,0,2
1AER99TKyeMvTDhnFgvcN9MVL3crJdjbeJ,False,4677000000,4677000000,0,2
1Jg5aYn5pqUgvyVKVbc1vXzLae9SCAePva,False,4480000000,4480000000,0,2
13WiNEkKzGLJmPS8b5cHJqUMwkqNZU8tDp,False,4402000000,4402000000,0,2
1JWuGTQcL4P3JpXuyoNBteKBzEoeja1YSS,False,4344000000,4344000000,0,2
15N5KYDmwhTQXWLa3rYbiui6eHDfU95Pb7,False,4089000000,4089000000,0,2
1M1qa9oN7WyuePV4Qq95B9WpKXjUpkDeUv,False,3741000000,3741000000,0,2
1LGFoRijN9QHDm2DNL5GYmqoXLZq6LN5LG,False,3577000000,3577000000,0,2
1CRZFBqRgoeVH65qs9sfyc38SgG8hax4K6,False,3357000000,3357000000,0,2
17HsVeHTe6zpdWqFXYW8M6QTQu4uzYjuZU,False,3301000000,3301000000,0,2
127f7tvsKQoP7DhpBm4AEzy6Wb8HQhaPg3,False,2330000000,2330000000,0,2
1N4iGbWccrQ2SceTq6fLiJ2oo8QNiBeVFA,False,4717000000,4717000000,0,2
1FyZomiRQziVjA4jmLWkEp5NJprykz5UPR,False,31000000,31000000,0,2
1JTKzGRUFmV4nxsP4ScZtYyQQRYwtsjzPa,False,1500000000,1500000000,0,2
16Dx3oCLyusMweHjtKgULBjrbZuk55VKhZ,False,304000000,304000000,0,2
1LQoMa2PV1SbDdSEfFmfuQR5ffHNx2GoV6,False,53000000,53000000,0,2
15cr6JE6xepxJwXLBC9rhMKK1yXAS6LLxn,False,435000000,435000000,0,2
19eKs2N2UgTb6TJtBaywwmqundREdfFu9,False,50000000,50000000,0,2
1NeBZ1AJFXux18T1Sv9gENfiiA2QtKM4V5,False,100000000,100000000,0,2
1EsXaUbDrNA17PXFSFCvgwPHdqMiiZEZXC,False,385000000,385000000,0,2
16v8Ra8DS6K1TBWZu6Kfd2bJ397v1mpDmX,False,235000000,235000000,0,2
16dbphS1cWS62vffJsMpUCnKWtEwJBzapC,False,250000000,250000000,0,2
1s1em86FciqWBzToZZHWvpDefyeD43WjF,False,1000000000,1000000000,0,2
1C6nd8G1CJa46RzExMWV3w7VJwnU2EhGFu,False,8096000000,8096000000,0,2
165FSw91fsoqotfyqLprrQ5XUgwCP9fhUw,False,500000000,500000000,0,2
14guBvWRUVN77Eh45FNdX8qgj15d1iFN1D,False,70000000,70000000,0,2
1AyfKaKr78pN6xi1vn1VhtPZtek5VDC7fZ,False,2161000000,2161000000,0,2
14vwh1aAuEJgdsQY8YuQY2saNQ2vGTMkRM,False,95000000,95000000,0,2
1EvMvgnUDeSVtHFo9HN5ckdL7QkNzeGUoq,False,2014000000,2014000000,0,2
1AGtMQgrzUZRLsMvRe9WT4mYc17fFuYn9F,False,1868000000,1868000000,0,2
1QCJsjWn2MyGcQgZ2rMm61WiNn1RUWddGq,False,1723000000,1723000000,0,2
1LnirhRTunJaeKsXeZTgdVZQCou1rDTbR7,False,1582000000,1582000000,0,2
1CnLTcih3J3QawPWK4BkumCgc9NDoGRVp9,False,1474000000,1474000000,0,2
1BA9a425mzrtYNZAJ6ebitTF7pY5euphKQ,False,1372000000,1372000000,0,2
1DZPr3xWaXQTE4ZFLWHxPAZN6CB8DHTDyx,False,1310000000,1310000000,0,2
19EMJPTbgeHrbChJBx4cR47tBrtZr33buG,False,1250000000,1250000000,0,2
1HQ3fUPMqZ2vYQf3m67wB2MNdVA321x5r1,False,1197000000,1197000000,0,2
18gVPeBL8LCujZnXbDhW57ops6uXixgPNF,False,1146000000,1146000000,0,2
167pxxgkM8oUWoKvBQCFCNPK7YBsTKjdgf,False,1098000000,1098000000,0,2
1Ks2z19TGwAPH1PDzDSAsGh7igYA3yT5Ne,False,932000000,932000000,0,29
14kwVMGi9o33h7FWCi4rkuvUHRnADBqZJ4,False,1065000000,1065000000,0,2
1DhArTfEenyrc88V14ZhGRZaLV2m63KyqF,False,1033000000,1033000000,0,2
1CxLKwSqRbNnRW5bQR3vzoeZQA2qZi5jUj,False,1005000000,1005000000,0,2
1bX1vDugW4LaX7Mk6ZZGuYcWJHPTPLrYv,False,129000000,129000000,0,10
1EaMrU3V66ccPoDyEmx7Hiuro5TT1dKrL7,False,985000000,985000000,0,2
1CKH7AgPvnM2xpm72CJKRTjBCMykRhrGE8,False,974000000,974000000,0,2
1BdofzqYoVErbpF5fK66S2oqUQbKB4fYv8,False,964000000,964000000,0,2
15pEStoW25u4Vda25ibzWMJdiw1e7i9YNf,False,960000000,960000000,0,2
14HQRD636owZqtHg95q55x4E1R3hx46KiK,False,956000000,956000000,0,2
133jXtvJ5jADDtSuU2ZNsTrRCBKHLHj1MU,False,952000000,952000000,0,2
1Kxacu3Xv7RUFpPZQbcJDNYUNc2t3Ceyau,False,20000000000,20000000000,0,2
1Pc9QRHbnLVEmzz13hApaS7h5vp3Pcefth,False,100000000000,100000000000,0,2
17689YVxtsykpxbXtpvmKGCRfCksFkpzny,False,250000000000,250000000000,0,2
14jWjCKcXdHP885kisJ5x9GUpycusmeywx,False,4749000000,4749000000,0,2
1HhaVdbhuM1ttKUFJpYzZfpk3vXSMkxfnd,False,4673000000,4673000000,0,2
1F6tWM2XkbEVzprYiRmX7F5StN1tTitG15,False,4617000000,4617000000,0,2
12r9zW7zg6kFsLNDCgbywRQuZkdGPxYe7g,False,32215000000,32215000000,0,2
1MPZ4EsdgEdvfkvRdp7PkFHrDZhyRwKY6v,False,8091000000,8091000000,0,2
1NDRyAb7YSWFAqg84QuSZjbxBvj53TcCaV,False,4390000000,4390000000,0,2
15RQ8TSksnC3acA9R1d4UvgEyPXMNd4dpD,False,4014000000,4014000000,0,2
1APF13qxXuy8jE92Qa4GxqjvR3dHz71RdH,False,3936000000,3936000000,0,2
1AmJ5aFYgKzXzNEcxsZoByWux79aR6ri4m,False,3859000000,3859000000,0,2
1GSvCvSZbPrhdggHmiA2zcGV2dDfRK9uL7,False,110000000,110000000,0,2
17Kc9pdjgHv9yEFxmbdwwe56yo5dpfFfwe,False,3207000000,3207000000,0,2
1F5DrL4zToiYjjpSAGsTGF2xegacKfNCf5,False,3023000000,3023000000,0,2
1DK4zBzp8c8RxQTrn5F8FzWTpds7pj4VmF,False,2296000000,2296000000,0,2
12T7zqabVgoeR5Zn6pSDcqT8VabaLUqzCb,False,829000000,829000000,0,2
19mKujq9MsKY9iuBCGkRMrY9Xw1yB3nVFs,False,8086000000,8086000000,0,2
14HAq9nFT9NCUETsmu2sCFomFiBRcJVSRC,False,2149000000,2149000000,0,2
1LZhKU949DbxGBWF5tAeUET9bZfvUezNT6,False,583000000,583000000,0,2
1BNpzGPtefc5ujFCSqcy7UD2wmVrjz1Qf5,False,2005000000,2005000000,0,2
18Dyo2APq2NX8GVkKHpJEQFqwpRuMd9RVZ,False,343000000,343000000,0,2
1FBRTfVpJZYJktysJaEogHbG9QaqQZdYH6,False,1870000000,1870000000,0,2
1G5vEjFTQwLTdGJwDAek9XQGhV2jMfEu8K,False,115000000,115000000,0,2
1KMLFaUngRiEQLk7wcLgsmiQCpwoovZQGr,False,12160171240,12160171240,0,35
15o6KZpsjwoVbDeB62j5WDVHca75imruSt,False,1768000000,1768000000,0,2
12P1aD7s9Y7dYyEH3shmQ8Lxi7qqFD1RQx,False,992500260,992500260,0,8
1K5G8kH3GmzmaBSGjGHp2Ffakm8BZ62Lmd,False,1668000000,1668000000,0,2
16UzymAtv5oEbu83YnVvncKzScdNVb2rUz,False,557365444,557365444,0,57
1GB6USAsxZ1Nhx2YiUZz7N3KgtdNnEoE7G,False,1582000000,1582000000,0,2
19PXDkRo72B8yc8pVBJbcTux8ETX9DxEc,False,1502000000,1502000000,0,2
1B89Q1TNmj1Am7FrpGS3Yqfry1iKRjDVJE,False,1454000000,1454000000,0,2
1HGqdr1aAM2t11VVvYYE2aMG7i2eoHdnp9,False,1427000000,1427000000,0,2
1Dg7h2WvzDiuVi3xLczcNjNhURqWTbPYP6,False,1402000000,1402000000,0,2
1L6rhbSXzVXyaYnpLuF5CFdewDVwRxhnZE,False,1380000000,1380000000,0,2
1MSEjHYNPvEHwfHhjdqXCHBMCAQoBhz2es,False,1373000000,1373000000,0,2
1Gzw1wXGrSbqmQc4RGMkd5vwktSNiKZ6iS,False,1367000000,1367000000,0,2
1A2DTigv5T2m3wyLkqU2FCmvTGhqjR9Mda,False,1364000000,1364000000,0,2
1FKXLZgXi2GKTvvjSnsfvMk3ecxtXG8CKV,False,1362000000,1362000000,0,2
1GPfVjrivfL5UVW5GzSnvT3cPsoXtqBfDY,False,1360000000,1360000000,0,2
1JkcCZNpzWuJozpjDV8AFzPmPWsXdGGQ6A,False,29990000000,29990000000,0,2
1KEA5tvpFUQoCn3j23EacN17o5WFJyF8B9,False,8081000000,8081000000,0,2
1AhznaRaVQvwaxJNCkgMpj9euuUp5xnv71,False,70000000,70000000,0,2
1JFtuVHvVHqaJjjBea7Uyo1wZFfPiNGjfu,False,60000000,60000000,0,2
1CA7uEA5Sj6o2qWsbkBXdZAuMeRsCeMpbC,False,11000000000,11000000000,0,4
1BXc2CWeigjhw1KrJbWxc13evW2kdByyUA,False,92000000,92000000,0,2
13oa682p2ifqNXgGST4k5Zh7DwcR5Bvyhx,False,2000000000,2000000000,0,2
12UZZX6GoQNVLNW1pFZFbnnEjSPWGuJQsf,False,33700000000,33700000000,0,2
1Bpu76SszFvQ5JXrWBgwVg3bwMwjc2WLmH,False,32210000000,32210000000,0,2
1ADT1mGYE1n7miS74HZkMrh73WqiP9ntwU,False,427000000,427000000,0,16
14Vd9ZiSbAapbNAZfptSGE9LqnEwA14xsj,False,8076000000,8076000000,0,2
1FuKwwe9QVx2nu8mwKM1C6oM9j9B3hTzXw,False,436000000,436000000,0,18
1LWEGvDCan4uN16fND3VoFZ6Ln915Y2DKK,False,8071000000,8071000000,0,2
1Q4tZmh3FAZzyThbmXj47UEwdYeq83PLdr,False,477000000,477000000,0,2
1ERVH3VPQGQw4vxMqA86mqRBUwrV11feei,False,32205000000,32205000000,0,2
16bfiQsyfHgkKaKMtsPTWgzuGWFpLRrMfJ,False,8066000000,8066000000,0,2
1E7mjcGdxJhwXMFafta6rtDsn3iw8YUYQq,False,1210000000,1210000000,0,20
19kPqM3eiyQgrvvzDfoLQZ4PYBsvEttFSS,False,1336000000,1336000000,0,22
1KdpKxCdUbCJWZjQveaw3r9h4cNZS2E7Jv,False,6041100000,6041100001,1,70
16c5X6Z1CPpAuUnvQqWwMHH2VriesfYrEw,False,1278000000,1278000000,0,2
14fGFcSDwYbEDCEpNudGdrXpJ5hqPm1K62,False,137000000,137000000,0,2
1DGwtfAiy23iqGtVVjnD9bW82tExaKL7FQ,False,32200000000,32200000000,0,2
14oiAutNyocu9jN2qsNQQGfugMpMW5Tuxg,False,8061000000,8061000000,0,2
11US16biQv95GQGska34ogccEwYVmwCvi,False,29980000000,29980000000,0,2
1LJimv7d9uyaZEBYSxkfxXLngasvfdxQEJ,False,50000000,50000000,0,2
1LN93u9pLVUFe9L9BEsBYMEWXVuEethK8J,False,29970000000,29970000000,0,2
14iDqccXbss9jsyPQTKk9bm4Nc59Wm7Uq2,False,8056000000,8056000000,0,2
17tKKoFc5g7UzyQKHey7kvjaRnMPChDQ9B,False,40000000,40000000,0,2
1ngA5gmSXWtQLUBMGn6rFLj7hy1SAPBja,False,29960000000,29960000000,0,2
16s1pwtim45aYT578Ai9GFXggpo9XmGDTv,False,30000000,30000000,0,2
1FWGvGhGxL9xzu6hVwYoaCUQLM7aHxSRuz,False,29950000000,29950000000,0,2
1HGK2g2gRhnXES9JvnBBuRD6ntvxfL73bQ,False,30000000,30000000,0,2
1LT9Byezma9Pe5gL9XPKJvQt3vwBtzeNVe,False,8051000000,8051000000,0,2
148iKnqz5yUGwAVN3RZCSURsD3E5G1Q8rY,False,4000000000,4000000000,0,2
1M1kPJyh2AwJR8NxmcyVCrTA8UwXCctuLy,False,6000000000,6000000000,0,2
1QJTwv45CnTcVMRhWzFdRzNqeiuNmSFfTx,False,32195000000,32195000000,0,2
1QGFuHGhMiktwBDV5fmNQuNP43DiarzarY,False,8046000000,8046000000,0,2
1FHMFvhTb7pTE6DEAPqbqCNLrH9bASUVEU,False,32190000000,32190000000,0,2
13nh2NYY8d4KqC72ceN4oRKWsdNP49v9vK,False,8041000000,8041000000,0,2
1EcGLi5AkiEMBiTvhgeo4b8CjPfF3FH5W8,False,4991000000,4991000000,0,2
13ZjGh6QeapoBkrJTX83dUjkb4RtJhef31,False,29850000000,29850000000,0,2
1Atk8AoPFHasUPMeyakCFTfsuQTho1A88j,False,0,100000000,100000000,1
1A6JgqGDspu8UyZ6XeJax8MzRb13dmtsqj,False,4737000000,4737000000,0,2
1LDnErtckegfRynXPnWvD4YGAu3G3gpKLE,False,4644000000,4644000000,0,2
1NYtkB4jrjH3qwfNzTp6r3geoUj94nv3to,False,4525000000,4525000000,0,2
1MTV1iKTfTtVfD9AKWfj1UBJ6ik8axmfPW,False,4294000000,4294000000,0,2
1NA7Nr4YohaprJReSXddgpATzr24XLf48B,False,3917000000,3917000000,0,2
1FD3SxXaVSVuTYCSbsEuhkEVVjKeATQ8XL,False,3835000000,3835000000,0,2
1Lg6yfq8mXGMxk56vYyAqdTFXMXHf5Hsvp,False,3752000000,3752000000,0,2
1KiifHVSLcdJsq2TvawJhRjJPzrBCZD8G2,False,32185000000,32185000000,0,2
18uZx2TaECut9bhyiKg7DDivMr2EJS4i7o,False,3099000000,3099000000,0,2
1A4ipkQ4mB6VW1krqezfr9T1c27SdMh6Zj,False,2909000000,2909000000,0,2
1Hz9ztM8a3nVmy89yC18CniFEbEYf5fSc9,False,8036000000,8036000000,0,2
15QDZ9AmUYP4eBoDGWe3VMtgJ3tcqvkTST,False,768000000,768000000,0,2
16MbonJnNqqwtkA1adBBFccwvpMg84iSMH,False,8031000000,8031000000,0,2
1AoovWcM8j1uyF5iXqCeBd2hKL75tgANAj,False,761000000,761000000,0,2
1DurMC4puczdZ31P1uTGbbqru4rV2dG5WJ,False,758000000,758000000,0,2
13kNpDGXhU3gzzauHzAM2kc3mPKg8Ysg1f,False,32180000000,32180000000,0,2
1Pxqu1Hui9FcB7aJQCUKSerHA5cs6YDJ7g,False,8026000000,8026000000,0,2
1HU1bHAnt6MPVtJPiJGaDuWJfnUFegJn6j,False,2501000000,2501000000,0,2
1A8UoHAon5vRFqi3eZwgsvyb6NS5pBWMnQ,False,8021000000,8021000000,0,2
1QEko1sGTJuCoaL9KD2SE77Re6JiHwxDC,False,31700000000,31700000000,0,2
1Gjqs6gwRhnYUadxnoirbwZnwKvR4TLjtw,False,4974000000,4974000000,0,2
1FZpNPRWUbtLgpA8DeeWii571Tkt1NTELd,False,4948000000,4948000000,0,2
1Psc62Q3BtZs7zhoNujQX36ANbH4Rsa8nH,False,4689000000,4689000000,0,2
1DAtxQC7hXEWmK3VUeYg7NPgF4iP76rVSP,False,4585000000,4585000000,0,2
1D7ixUn5cgtUbLToFqZ96yMptJsar4MmEh,False,4433000000,4433000000,0,2
1NDiNsveie1VeCLj9vwGyCUjuZehAfti7L,False,4188000000,4188000000,0,2
1GGF6akV6o6PaAvuZeWoG6yehPcF6pqmfo,False,3808000000,3808000000,0,2
132zfEXYAvkcEX6RxBLn4DZ9uDYb494ixi,False,3710000000,3710000000,0,2
1GxcESjVN6Cv2z1uu38xHb3vfqZvLaRshH,False,3625000000,3625000000,0,2
123gN1fHVGc8fBaKpX5uYYxXy2x26CtfKC,False,2965000000,2965000000,0,2
1HPiNQKUDCYJgjtp9L392k8z1VtgoFUydc,False,1845000000,1845000000,0,2
177kiw84AveCqRgGANxgbYJ6TdjkNgtHYT,False,600000000,600000000,0,2
1CKCF9CVeAY7Vj4CTi1B2mrT1nY1Rj46CZ,False,577000000,577000000,0,2
1EZSib3uUSsqj94LPYhUQoVM2XHoG42J6B,False,566000000,566000000,0,2
1B4JW8oork52oTP41sZofFeHFuLwpXhMff,False,556000000,556000000,0,2
17p9415pZFWKjQfJuTUXXbs5iAWedM5t3T,False,548000000,548000000,0,2
1CWJ2sp6YrmSui91KnBeuopeekQFRVBm3U,False,543000000,543000000,0,2
1D4krxptSzBH3qxQXNziPrJc9DDP52svaG,False,541000000,541000000,0,2
1J6e85xbBAskyMVWctYL2CUi8nPLP7anb3,False,540000000,540000000,0,2
1PuDXCPmMX6uaKzBin59RukjTy2tAtxFxF,False,539000000,539000000,0,2
1FenfCbo99Bw2K6d39dY6i3g1YRhwyQHNf,False,4000000000,4000000000,0,2
14BxmCx7cVBj7YPBCvoc3yACRBsK19u8SB,False,0,1005000000,1005000000,2
1BDKe9d1agK3318gNHehgoY5m7vvDhPe3q,False,10000000000,10000000000,0,2
1AXM44z8UkhguYnjh4qcALr8rBjCHksLhR,False,8016000000,8016000000,0,2
1JTv7LFk4Gn4TdpuwrjkJgATUAgeHcrZMF,False,32175000000,32175000000,0,2
1BHA2FgG2hah3zRV2Fbn1FPnL8STU5X6Ua,False,8011000000,8011000000,0,2
17VMjqwCsXgpj6Mw1k9rBLP5m1kHLNYJay,False,10000000000,10000000000,0,2
1FRnYEnfkTF6A93FpEM9BF41D2k7YKSitA,False,4948000000,4948000000,0,2
19AkoBLqKrmCcqTDMuRF6mq5DYBoGVMgPK,False,4908000000,4908000000,0,2
18T9vnTRuKwQcpREgQzTt8BXGeX3EKyPz6,False,32170000000,32170000000,0,2
1CzMLJcbijeAKT1hntdwPSHDZQWZLQ3zL8,False,4871000000,4871000000,0,2
1HF362arfbKF6LT5KRyk77rgzTpJD4VNST,False,4844000000,4844000000,0,2
14176wR3sqbLK64j3Zgiyicth7CoHnfPbQ,False,4585000000,4585000000,0,2
1BHkSdxLJpXijdsdf7HUoGRzNUWBpdZMF6,False,4480000000,4480000000,0,2
1Cg3aVXUzZeKPKpMdiWcZxWznqX7M9z2if,False,4323000000,4323000000,0,2
16worBwBJ3ejY4e6aRw7ih45DzYZH4r7HF,False,4075000000,4075000000,0,2
14bRDmPUPsBEYF72Y5uzExaucqroBqgpD8,False,3692000000,3692000000,0,2
1H764xpE65XgSGDSzdxVJwBfQfUBbcXGmB,False,3587000000,3587000000,0,2
1Gcw4fwU6WBy2mV95fYeNmHU5HdbLd6Kzd,False,3471000000,3471000000,0,2
1FJt4HZCPCcGcJnQ7SwTbrkVBKnRcUnPYX,False,2354000000,2354000000,0,2
1BqEKpEsUF6LbpoEmRTP6AmwTWgi4AxZ7y,False,840000000,840000000,0,2
19Wv8Rwm7vAzqYndd3hPN8jsmGsgpPuJid,False,8006000000,8006000000,0,2
1Hb7eo7NdHuwgAxjWNHaQsF3ZKP9VEDzRh,False,32165000000,32165000000,0,2
1VneWFcbs7rNVRM5oMtEBRo9B1JZxo31W,False,8001000000,8001000000,0,2
1yS9dxiP16mEbFQPyuB2XAiPi69Gdk2a5,False,830000000,830000000,0,2
19MMC7yCdS9tF7f7smasCfKw127mVRDmtv,False,821000000,821000000,0,2
1DxpG2VQUGJBRUXZ3Gw7wwM2tu8tKMj9Yg,False,814000000,814000000,0,2
1v7cqYALT1C7zRERQfUtorKycxEDYxwsQ,False,808000000,808000000,0,2
1EXhk6ngF2YNsxKm55PToa8YZGbrRzRL2G,False,805000000,805000000,0,2
161DtoxoavDozdbdApAwDkoYQmy52vVmzL,False,802000000,802000000,0,2
18KMsrgVZxqxaipCNVyyoiXEJFUn1vhEBd,False,801000000,801000000,0,2
1DxjUR359v8N8bYZvMDcwWF7Vkes542G1g,False,32160000000,32160000000,0,2
1NAnToF4F7AtdRdtwTtHXwcgjcfjQfo2LG,False,500000000,500000000,0,6
17GkshEJKEyB9CMoQ2L8Y5MYxy47Gn9BBa,False,7996000000,7996000000,0,2
1H6x17vodtmnGGj1EFoFt51kjU5goxeihf,False,100000000,100000000,0,2
1vJ7GbbxTu6z2YAidtxc51VWUeMfCpjSe,False,7991000000,7991000000,0,2
13KTDztFyXgZxbPUZfiapeVXH9Su64iUHB,False,7986000000,7986000000,0,2
1LvpQ1zCugAgGj9TvXFXTdkPr4FD5NhKKC,False,32155000000,32155000000,0,2
175oKr2JijvtBLs1cZwQWfZJ49JD3CEWNX,False,7981000000,7981000000,0,2
1BcEfBmq1N5znMwrodHjK8e8vCLm4oDrnN,False,7976000000,7976000000,0,2
1AuP7Wky7TGTmaom4JC4D3Axpvxj4GGsB4,False,549000000,549000000,0,2
1CWtqXYyZT5crpX4Jf1fmML1vESxUnAF3P,False,286000000,286000000,0,19
19h1D5zm5copF5Mkw9dsXRDcrYTpxRt9Wv,False,4899000000,4899000000,0,2
1CjHfoefEK6BspD13LVsD1TuoWh6jAKEWs,False,4841000000,4841000000,0,2
1HSAT2N7Tp3eea6eyhjgMV4XGg9YC2L1vn,False,4783000000,4783000000,0,2
15MjvXxzw6fdhgtgvkxLMH6u54pbNPv5dU,False,4698000000,4698000000,0,2
1LWBcQ9yY5ALSB14ZophR5T2YrgwDm7ZLE,False,4742000000,4742000000,0,2
1Hohys52Lvtz2KnMAhD3pETc4E18ec2VfE,False,4435000000,4435000000,0,2
1KTgGo8PqjZT1RTgq5YD5dBrLdLFgPzmDn,False,4300000000,4300000000,0,2
1Mvf1RxHTFCVud9mJaGm2dqAsSqpYELaPp,False,4140000000,4140000000,0,2
1Czx2f41b5W7EufbFKxgTHvCit1oC2fgfC,False,3876000000,3876000000,0,2
1Eg4c6kZeGTCJfEpwqM5ikGAcrXnWksV8n,False,3488000000,3488000000,0,2
16nuAYWGQ3QpxAiKF5zrHv5zL6EsQQrk2t,False,3354000000,3354000000,0,2
1F6yAHkn1r9jG9FFZ7NL1G7aqBgYGhMHGG,False,3225000000,3225000000,0,2
1BeqqwVoJDtEBG4F6HG5k81cWTT9JmzE8u,False,2105000000,2105000000,0,2
1Jvf9TEQ7BjcgQ2ktJEsmuykFokJCDGtCm,False,486000000,486000000,0,2
1BFriGB8GbzNQExHWRRSxFMR7UcYC85Ynv,False,427000000,427000000,0,2
1NH2TFPpbYcjnmXwXavhKq2pPDvQRHuQeL,False,372000000,372000000,0,2
1PhCR7FrgZQCdkKGtDEG6LfjnRakQDi56t,False,320000000,320000000,0,2
1CN5H1XijavgXY5FP2SyrCw98CJEs2GX2y,False,275000000,275000000,0,2
14472VPth5yCMRzmzCGYZhWHsZ2bFC6NjX,False,240000000,240000000,0,2
1N4p5rKs4WVAx832qN3rprFb5cM3DVSzXb,False,219000000,219000000,0,2
1DMPqNgUWQzawmSz8517HFbcGnxXjWE66M,False,205000000,205000000,0,2
1G9PT8vdYNC4zyp3E4hANmgi9MEXxCdFTn,False,195000000,195000000,0,2
1P1pSq9PR4fGGjrzGopPdNiZSMvtVWehHG,False,188000000,188000000,0,2
19tt12HKMZ2grvy6DNb3urLfFe6amoVvPL,False,182000000,182000000,0,2
1BSfiX2d1sB9ovz8aSVfAhZ2h7JATidMmj,False,32150000000,32150000000,0,2
1BbJU5arnfRa7wDag8ghpcEvvHnDDRDTkL,False,7971000000,7971000000,0,2
16H2qSv8XgbPxN9BsqMAo1NUxxkCEjj7ns,False,177000000,177000000,0,2
1P6YNnVKHRN82Ghawo9JqEoCwiU1dhCJF2,False,176000000,176000000,0,2
14ACbPJDhu7Yd1e9gDXpA1J8Kq7xNjwn96,False,7000000000,7000000000,0,2
14ZYNaxKGBYR1mJciAyE8KPYscLM4wwf2Z,False,2900000000,2900000000,0,2
163fsWPK3ZNVNZJbu7NvgpCj9LhNfomMUZ,False,7000000000,7000000000,0,2
12XPyScv6VNLLGuWTRJcuaaec5u6GC1b3k,False,900000000,900000000,0,2
1Ktz4yFrKf4goP55Xo3TS1KBntZdcxtY7c,False,32145000000,32145000000,0,2
1PUr2VxhookWGC3D4hcbLsa7vXeuUY46Fr,False,7966000000,7966000000,0,2
1Gk8dktDh9NsdNLkGXXS7WipwSKSBvUcbJ,False,7961000000,7961000000,0,2
12GTSV1xfCMTcP8mj5sFGfjXC7xsKa3PPY,False,7956000000,7956000000,0,2
112jA9B4KFAUEZzAVRENcixScXKW9axLT2,False,2805000000,2805000000,0,14
1MTqugkwkkasXkZvHEpBcvNWv5p45xoqnu,False,1270000000,1270000000,0,2
1LPxJCMSPChWszfhu7fXnmE1rcG5xaFZNT,False,10050000000,10050000000,0,4
1KmHjUdEvPA1ygWySjEQvRknazMQW8fMgz,False,32140000000,32140000000,0,2
1BKdjSPk8ma58xYKmmdTRVGc863F4AXdiD,False,91000000,91000000,0,2
1MGkD5efMcndBVmuaYkqW7RfXW98D9xPM,False,200000000,200000000,0,3
1M8w9WubhsCnmLqeMhvSLK4PiPWCEv1AVT,False,7951000000,7951000000,0,2
19T9Mpho1jWsupvKvADJGR84hu7bf6vvHL,False,52000000,52000000,0,2
14VU5MaUMKsdvrgBHj7YRXrqYAQEQXaPT2,False,4246000000,4246000000,0,2
16DRmiALRhXzJqW6kU7CX961vp1gDrY4d5,False,7941000000,7941000000,0,2
1Fk8PoiTPjsKCgrtk9tHu3H6HaYSFPMyfu,False,7936000000,7936000000,0,2
13aKY1C8evyLLFfyo7er3ZcbXTGoCsMUNp,False,7931000000,7931000000,0,2
1GUsfpBmQoDXbniv1zYybGYEviyjyRAQzJ,False,103000000,103000000,0,2
17BcFeG5fMEQWU9S5d1bynwP27jQxcKPQY,False,332000000,332000000,0,2
1qeqLLxAiZDUfTnSN71i82Zs4aht3hjwv,False,151000000,151000000,0,2
1GrEWL6NodtofKxfyAYi1AeM5yWC9LY1pA,False,234000000,234000000,0,2
1LvbWXKs7keQrfSHt8uVX8sbSaNQQUVgzq,False,123000000,123000000,0,2
1FeBt9FyM3RMkbGmw7VMDSAWvKn6Nt3SeH,False,112000000,112000000,0,2
1Hfen7fs7ChbxEbPhwks7hzcnmg4N2CkMm,False,4814000000,4814000000,0,2
1uuzYgtpsj5VzedoXeNmd8WnRk7uQRi9U,False,7926000000,7926000000,0,2
1KFS7pvwWXepVuE2zaawySnn9cmj1TnBX,False,234000000,234000000,0,2
17strMHoLvyrKvGdhSwG5mSWgjJSbznkr9,False,196000000,196000000,0,2
15zyjpmw37eMNnA8Gofb68WMQpxd2v8ohG,False,100000000,100000000,0,2
1GZv3RsinpYuT3voEDJwKf5ZqZ7AGaa5D6,False,20316000000,20316000000,0,2
1EcJtfHraKwt1RZrfXjvEbrHUi3GJf3vAi,False,34257000000,34257000000,0,2
14RbzMcYv5tY2vbho9XR3PNctpZEM24Hf4,False,32135000000,32135000000,0,2
1G6yRSprFHkt6u6YRymuhAGGdnQkCGxiUo,False,7921000000,7921000000,0,2
1FGkMuQzsnqDsr1C9z9mAGncPkfRX4nMJn,False,930000000,930000000,0,2
1Kip8T6mZqhE2Dx3U48i8aaKmMyyewbTMy,False,29700000000,29700000000,0,2
1EiQXYKK8arnsscTGNeT54toTBDfuxb3Wz,False,4005000000,4005000000,0,6
1JUqQj3vJhbtJXsT3JP8F19dDNUmaoqGeH,False,4934000000,4934000000,0,2
1FV8UPS73KgM348Vgf96ZncUN78evNSZGq,False,4975000000,4975000000,0,2
13GvUWovDzBX8PdhXJBrdYJi2YPZh6sMfp,False,1385000000,1385000000,0,2
1Jhc2Vnqkxog4oRSTGv5iNJjoaMmpFHFj2,False,4817000000,4817000000,0,2
165zVBtQGgJVwszxgD915Nzm4JkrqVjJdb,False,4749000000,4749000000,0,2
15vnarcjie98unmdAaY7PXwADjqdyLYrNu,False,4680000000,4680000000,0,2
1HrR2Z81abL6t62imPcuD94vw48ECjEDxK,False,4638000000,4638000000,0,2
1NrjdYRM6HQefPe4uSMATHRHxM4feN4dmx,False,4592000000,4592000000,0,2
1QH23yQjbJ3A8mVh8dKu1MCPg8hUTS1Eog,False,4329000000,4329000000,0,2
1D2KdmSaCEveiCSCMp51gpHe8xChGtRpDY,False,4191000000,4191000000,0,2
1yFdWv9MKhEgVR3EDQeTTY8qBF2fx2DMY,False,4013000000,4013000000,0,2
1yMFJWDYzbf17XGs4XPZ4TAHRk5VWL883,False,3357000000,3357000000,0,2
1GkXL6EbVxPMtfzztueB1QmkiAR1A1wkZC,False,2843000000,2843000000,0,2
16drBmt1qYMyEPp1pdSVQgWMuStFzKwPXT,False,2681000000,2681000000,0,2
1PrvurJfWsbWyephgPWzcLNauFMFqLiNim,False,609000000,609000000,0,2
17nymCPGbRyF3PLbddrkW8d88GhFhhDbQ1,False,64000000,64000000,0,2
1ESyHnacZXZFATYweKhE8RYFg8ptGiUDuv,False,32130000000,32130000000,0,2
1BhWSz1juZNwCwh5a9AvmAV6Hqqnjmj97Z,False,7916000000,7916000000,0,2
12w55No8LkYxprpD5orCYgnzv43xT8t3Bx,False,57000000,57000000,0,2
1PZT7cf48y4sWoQ5EVC64hGWpi7UsiaK7m,False,37000000,37000000,0,2
1NNa39M6UJz5GSu7FHm3EsjvsmigcLV3cR,False,98000000,98000000,0,2
12qGrLVVysg9JF9Wb3xG7BPVLFDh5FYk9s,False,606000000,606000000,0,2
1K5rH8QLGmBsQseF7iSapqeJCQsdz4HjAs,False,51000000,51000000,0,2
16UHGMhiCXjSDPa7LoSTbQXuxToqiVdEeV,False,7911000000,7911000000,0,2
13CW9LihZTrJzS9j2nrRcBnqXq474fMY3r,False,603000000,603000000,0,2
17epYWg8Qn41PR7AXyniN1Y7DagGKfQYPp,False,7906000000,7906000000,0,2
1GEYjEvnac66vbVHfnBeDZtvr1Jy6GDXPV,False,585000000,585000000,0,2
1QHXTxVoipM7rfpYXQqw4uDo7JLZYro7FS,False,345000000,345000000,0,2
19mkBjMoT6nXvz3UzYnHUbycb7ibEd3j52,False,600000000,600000000,0,2
124zvc6Potkb2jiy3aB6T7ay7JWcwJnSHz,False,10000000000,10000000000,0,2
1FChbFePrKGmUV1iAWKvkUNNDGM9QJEkPB,False,4980000000,4980000000,0,2
1HD3xU7Sh6bFi5oQnf4dZ5XUNT6eLhhPoP,False,32125000000,32125000000,0,2
14BAB3vaFu7uF2gUpmocShbR7UELHjS8xD,False,4906000000,4906000000,0,2
16L4jMNcohzAfzjhmsqb2tEQPVaC8yd8vY,False,4844000000,4844000000,0,2
1CpbNdbuRdJJsAvRxyEX5uPDiiWw9Q6DGo,False,4713000000,4713000000,0,2
15viFaUToHgxf8d8gNda5WdwFP7C2bNnJt,False,4638000000,4638000000,0,2
16biBw2ZA5VCdvvUz91D1D46UTtuk2qPRj,False,4565000000,4565000000,0,2
1JXShxBox51Tokn4C3WAFPVCx61SZksLES,False,4521000000,4521000000,0,2
1Q4cUJ82y5fkTE71VJM12AbpTMMUF76KFu,False,4467000000,4467000000,0,2
13HW6AjsdWVbuKdvgtfr2pqnwgkHYyKCbw,False,4197000000,4197000000,0,2
1AfcDJaQchrVEyAVnUDZTh3JboX3PYtTbD,False,4038000000,4038000000,0,2
1KuEfXb8gHUg2TFUFjAainqyfZGE3yPGS7,False,3787000000,3787000000,0,2
1LPqd2eHzNtf1BCZY2hZ2CF44mH4Fc2Uff,False,2754000000,2754000000,0,2
1Eq7YTYKx5JbzhJopjypYKZmnPVU8C79Ct,False,7901000000,7901000000,0,2
174X2ASR8dv8Hu4aJRUhxpvsib7NBZ4cYY,False,109000000,109000000,0,2
13GMsHZ7WS8wt6ssfYcewGTFY244eHs9DN,False,1634000000,1634000000,0,2
13FQsPFX6sNvY9BFi84ATBDHB9CpUeY5pw,False,7896000000,7896000000,0,2
1MCA5DAcZk1UXe7kyJqubEp3jCQLbnoAvv,False,108000000,108000000,0,2
19BEenQ5NKQvLwXzQYnhM1ZiWUxaUQySAA,False,140000000000,140000000000,0,2
173oBM3b2zEj6RKnvp92TSbdMT8CFHXNzc,False,107000000,107000000,0,2
1Bg2kUiYxg7FMgQMi73C1rDg5Y2grrBPDv,False,106000000,106000000,0,2
1MaKQvZdXACj786JyEUo1Mxr7gpN5HyNFB,False,27700000000,27700000000,0,2
1B5hM6KCpk5xJprQvpKNQcjcuDhsLfqmQS,False,2005000000,2005000000,0,4
14TgcShxQ92hj4JyAp5c8XmzXJhF8kfMUC,False,7891000000,7891000000,0,2
1NhxEdUqRDhczQTRxHc8pRmfxDV2XBK2nL,False,105000000,105000000,0,2
1QHR2CD9BcB4Qntdug7y8fUyjqxVAmbiTZ,False,104000000,104000000,0,2
1ERaEn5X6qQ1PZiU93bcHbF3u5GMYvc2FC,False,103000000,103000000,0,2
18vgQnPKp6UtXcqQvZNaC13QQyjk9TpXMF,False,500000000,500000000,0,2
1J9UKtLYAEmoFmN8CwqtBG3GFnKMoF1eu,False,5100000000,5100000000,0,2
1QHRwmv7ELCUY2P8mEEKbrabUSzDUHRVGg,False,2400000000,2400000000,0,2
15S15Z4yELNX3Fx3VbgNWQzQc6paf3CdoP,False,5029000000,5029000000,0,2
16RCKBTFf5UxybuznJDsRUAB82L2q5dVen,False,7886000000,7886000000,0,2
1QBdSMdkpABHtAPEh6Fd1itUMqtMQRe2Ns,False,7881000000,7881000000,0,2
12XFZusQwJceFukYf4vJHM2YVashan3ZBU,False,4987000000,4987000000,0,2
13ZtVU7LVpcnbZKvEuKUSB6qDwYHpbPUUa,False,32120000000,32120000000,0,2
1PvvU6t36AKA6MDn1FvFmuA48scZax3uDy,False,4856000000,4856000000,0,2
17QCzuMgU5fBxmN7k9Q5YCAVPx43mFbvXD,False,4777000000,4777000000,0,2
1JYBWdZUrFetfz8eFJTgj8ZjvNZuoWMoaM,False,4709000000,4709000000,0,2
1JE19uDciSqZuPfwAxo5su4MUnXCVQGyjr,False,4562000000,4562000000,0,2
1GZq8NhVkQbnj8aXgAtqxWqf2MADy7YGX9,False,4470000000,4470000000,0,2
1MjYrn88vsQCfreQ7gEEwFZRqetcQifCn6,False,4369000000,4369000000,0,2
1MT2CWU8seXPAVUeARohXUNLtUqtRTPPUZ,False,4294000000,4294000000,0,2
13bQtTYjtCoPTpojvjPKbZTxJbAnB24QdS,False,4231000000,4231000000,0,2
1L6ZosqPTDDsk87qqeBNRaxsUsT5aV8Wk2,False,3959000000,3959000000,0,2
1HoVzFKFopBkjeDyqyoJrK7tHULHhDX7vS,False,3775000000,3775000000,0,2
1PxftKD8ntGZNdqhHJyX1f4HuF42JhauHS,False,3443000000,3443000000,0,2
14aE7RkcR5XcVbm7mzfvMJJTTEXtMovK3J,False,1752000000,1752000000,0,2
1JXovLCXoHwrd8M475QT3MFgVQvewNwa6f,False,1634000000,1634000000,0,2
1tsy5TZ6GdF4ambyadTP4muMGdYWCVrHW,False,7876000000,7876000000,0,2
1EfCBiG1ZdtGnkHWyTfnrNZKzc6gQokzWb,False,32115000000,32115000000,0,2
1KcuUSj9BzWWPDtW84TjcntgPnpNtf7U2W,False,1518000000,1518000000,0,2
144mua2hNKjftEX5q7wJ52ESjCbis8XQ5S,False,7871000000,7871000000,0,2
14PFaizYX5P4SoGDzdw8baDH4JQhCV7HS7,False,1405000000,1405000000,0,2
17QqHdYdW5xzqkRnTb2bCbrxUTMjaUUAxx,False,1295000000,1295000000,0,2
1JjBfEfa9aRvQ1B7Usab77eW6vYCzbPTwi,False,1187000000,1187000000,0,2
14C6k3GPxbNrtvcDiaYFZXuKMKujnrPUPV,False,1080000000,1080000000,0,2
1FXCfKtPRxpUTMCUKrmV7Bzm857wTvCseR,False,976000000,976000000,0,2
15LU3ECHSNEovzeHJ9gzcQEXFS8oDVH3m6,False,874000000,874000000,0,2
1NPAHjTMneUrKMCuUnqHznqCU5GcsqVFcF,False,814000000,814000000,0,2
1LvNtufDCkAKje165iaGYfPgCR39yeHqJX,False,764000000,764000000,0,2
1DtMSiVfaSJk4kmsQJ8xgJ4YvBC9hUWkSq,False,725000000,725000000,0,2
13PvebfqZ7puaajfeGU9XxpFgZJuqwT6Fw,False,700000000,700000000,0,2
1Hwy5h83VTyuu6b3MR9QCPiCpDzenZnCfn,False,686000000,686000000,0,2
1B11nLH3wcy1zVt5DGrRJ6eLE6ykBkC3hp,False,680000000,680000000,0,2
15eZrpXvSAVq3RjdjMu45WDeyMGn3Hw8Cp,False,675000000,675000000,0,2
1EXex5L6HmK8dSh91syA8NapWu6D9AW61c,False,672000000,672000000,0,2
1JDqm8SYp7zpUF6UphzyvWmyJRTZ5M52S2,False,669000000,669000000,0,2
1DBcoNsSEoLH3PS7FuG9onvGgeZouCUF8e,False,668000000,668000000,0,2
1EuMa4dhfCK8ikgQ4emB7geSBgWK2cEdBG,False,998581000000,998581000000,0,48
1EVDWo9ssxhFsEuE15hihJytuakCDnWVEg,False,372000000,372000000,0,2
133TV1WEyndGG4h4PDGjsk3R3KHoKP2DRH,False,366483000000,366483000000,0,6
1Pfkba3U4yBmK3ajVUuufwaf7tGmsooc6U,False,3290000000,3290000000,0,2
1Mn6YswHKDBYuRGwRbx9XNpx8VYFf7cYqp,False,272000000,272000000,0,2
1Ly2atV48k2Zp26gVkT49jJ1wYL3ymmi9G,False,32110000000,32110000000,0,2
1JDdw5F7tE2uXmaFcmf7rqeErYzHxWQwvZ,False,7866000000,7866000000,0,2
1NPuRWJHQqvq9ub5tHej23kdkk7T8ZyRvG,False,7861000000,7861000000,0,2
15UXFJC3VV2qnDJo2Znt96pYwiXZe7Mvps,False,7856000000,7856000000,0,2
12Vv6pBBmHgMsxNSP3HBAr4NCg4MjVXZMQ,False,7851000000,7851000000,0,2
1HGDQc7rp8ijHHyYAELYS845nNVLKCgZik,False,7846000000,7846000000,0,2
1K7rQ7VdNmN2AeVVBHNyr6hLgFKunYbf2f,False,32105000000,32105000000,0,2
17g8cHwJ67zkcSjSBDPteSv5k2kxUNiEzs,False,4774000000,4774000000,0,2
12TVACURCG14FrD5yfHsCadYEqJz1ocLFX,False,4676000000,4676000000,0,2
1MxKfKpZnBJLe5TTyxNQn2wGVCjxSsDr45,False,4607000000,4607000000,0,2
1PMf5G9iZnB67ucoJS7i4329vWAKfvEdbh,False,4459000000,4459000000,0,2
14529eMqA2HWVXetU9xDyDES3PBnUZQfJ5,False,4363000000,4363000000,0,2
1KPmbsYnZ5Tfap84vUFqnUoXKo2faWwMkg,False,20737000000,20737000000,0,74
1Q2wX5uB54LxpjRXmxTFkTMkZAkJYEi9rS,False,4256000000,4256000000,0,2
1ChH42K64TWX28XYZCM8rdPtA5duBfNaiY,False,4176000000,4176000000,0,2
1Bwiy6SJFSj88SHdcN7pfyD3jSEDcZ7pdq,False,4105000000,4105000000,0,2
1AzW1vZZXeQe9bnbDzHeKNHKZFxGdSTdoM,False,3830000000,3830000000,0,2
1Gy51SEidtGN6J3NKRPxgtGfDpLQZNJ2Lb,False,3512000000,3512000000,0,2
16DRMXu12VuVve8QBVbjQvm5vD7tmBtzeH,False,2443000000,2443000000,0,2
1Navs9JVi4FRaFai2pJtm9QTEfQ1XzzKWy,False,950000000,950000000,0,2
1DTCCAFBxRBs7RNarys7iVDDU9xsccoAR8,False,7841000000,7841000000,0,2
1JA2iEYKq5AQnyMJfx1tHfRGvy54CD8mtp,False,7836000000,7836000000,0,2
1JQxZZsTmAa2P6A8XYUoxau7Jj1Kp7NRJ7,False,166000000,166000000,0,2
1aCQZijV95AErC2tFzZTtDMgzoUjkhMBX,False,2440000000,2440000000,0,2
17X9DQ5RoCRZ4wLmSyELURN7EYLN8djKNP,False,87000000,87000000,0,2
1Fk3oNraCgnGFG8rkJfKf1G4Quo31pii6B,False,2437000000,2437000000,0,2
1MSseaXXn2xNM2zU2F5Fy4fo8qF9i7EgRq,False,62000000,62000000,0,2
1JApZYP5XaEjw1riFBCV2MP9euZGsZY2q1,False,2434000000,2434000000,0,2
1Fd36brSpHQKdmtLDPjDD8FN516TbptwWP,False,43000000,43000000,0,2
13NwMVnFinLRTYRRuWcwbP66Y2cU8ev8UY,False,777238000000,777238000000,0,44
1DiGHbBMBkrCHn9aLPSmVitj2heTdyYTnu,False,4823000000,4823000000,0,2
1NWmP26KxeRQRPKDZ4YqpLwtb9khW4pokz,False,177000000,177000000,0,2
1GMqbd4uz1Wovv1oBpiK9xUA1i89AeC1cf,False,97024000000,97024000000,0,12
1PJAQN32G6LJ43FFs1DaKXdenkzRwSjRG6,False,32100000000,32100000000,0,2
1AE3pYJVDSmWobaNd7o9gjCwJzTEJwWPNS,False,7831000000,7831000000,0,2
195pneycmt6C59QLq9eRT1qReRd58DeYay,False,1535000000,1535000000,0,2
1EGqRmWjvhcjyfsUnffcSLokGRs2CPGoEE,False,7826000000,7826000000,0,2
1G9QV4bKBMro4GC773uUiw97Bo349XHTCa,False,199318000000,199318000000,0,19
1DUYq1S2FQpzvjxm6gQv5z9mXqx1LGE8vQ,False,1000000000,1000000000,0,2
1CzAE2dnjX2HPVeP55osghmCwk4bfpwHeC,False,7821000000,7821000000,0,2
1LgDF7vTnLHybftGDxDwbaoVpegbXqk1wj,False,32095000000,32095000000,0,2
1NXYKYCZkQPPoMemCxkBWhKtNyRA5RRg7g,False,3190000000,3190000000,0,2
16ZAXpwtpp9ifRq6tKFEw93msWU1tfVowN,False,76840000000,76840000000,0,7
1Fd2z6dmmBLfSAFmv2j7icLquszhzCfhZb,False,7816000000,7816000000,0,2
12iXdn16cfCGgb1oE9kLXM54YQSSgb3Ufk,False,2917000000,2917000000,0,2
1BmVks9WhvGvL6vqeRjUqgEc6r6gFeD37T,False,40000000,40000000,0,2
13QMfWvVRHuUk7yAgQMtY69XisM4PUjk16,False,7811000000,7811000000,0,2
1BY99Qdii7XsV39gTKSVouaggk1mYnYiqB,False,7806000000,7806000000,0,2
129FXvA3tgp4wyBviGAkSXqWosgLLoreZR,False,89995000000,89995000000,0,2
158rTXRbLNSM6tE2pZdgE9VC92jsoLCnqV,False,160132470000,160132470001,1,41
1EUWb2HxBXUZyeie4fm9SkZJ2Mgbjs4KNb,False,55000000000,55000000000,0,4
1KKJqHxavqLe6xCzdgygFxk8ZsFwd7sNSh,False,4945000000,4945000000,0,2
1FZThdfEm7jVDZHuXb1Uus8VxqZJ8WCBui,False,4688000000,4688000000,0,2
1GixzCdLbdmBpXoHXbLuDqQ9jVj9x9jhcB,False,4588000000,4588000000,0,2
1DtULM4ZFaSd4wwXQ2AktUw5aLAJKEBmXi,False,4504000000,4504000000,0,2
1EfLeHDeCewsdnnCyiCbQxx5CEkHbew5iU,False,4355000000,4355000000,0,2
1A4Hpq47TfkrtvjS6Aez1TUHEXaJWzTVia,False,4257000000,4257000000,0,2
1E7nsoxAhjgBP7SAKKYgMkuMe3aqzLjnKg,False,4146000000,4146000000,0,2
1PtLaexmUNNVuccP2aoAnbtmt9rkxkdC7H,False,4066000000,4066000000,0,2
1EPcnod86EnRnWPEsuHgiVhu29vEgi1icg,False,3988000000,3988000000,0,2
1BbnDa77dt9aonL82CkndcS21dqfMYT6VS,False,3712000000,3712000000,0,2
18J78Qw79Gya8YG5RUXM6cyDhDUqh13ch8,False,3010000000,3010000000,0,2
18uXJNpxoV8GPgwVi3xLb2iiJqfC8jaGkZ,False,9044295942,9044295942,0,44
1Fn2gawZxtPG9vJob7UWtzS6Dkw2Zdf8eH,False,1923000000,1923000000,0,2
12nEGZm5zbAhvHYALioaFVHVaQ7hgmfMKm,False,32090000000,32090000000,0,2
17da48hxMoqWNviiy4uqWkhfMr2p8xjnW6,False,7801000000,7801000000,0,2
14S2iHEvg2NHB9xfVo754w96WjmQ7d8CzK,False,2667000000,2667000000,0,2
1Bd8bm3WVn6RFx8pd6cgpQJQin9bMqsrAg,False,250000000,250000000,0,2
1PThLyi3tHu812f1pbeNRQArEiVAsPFRJy,False,1897000000,1897000000,0,2
1EeEJhVbiPbGaCNe8fnHtKnENB8NPnZW4r,False,7500000000,7500000000,0,2
12DaDEtPXbbpzs2vUfSwBF7W4LF7KqDPGR,False,16095000000,16095000000,0,4
1GCaVLX3X5KigWCmMav5B6epoHcJNfRLNS,False,7796000000,7796000000,0,2
16MED46fbGWWBJtmSmA44nAagm8xJuz6mT,False,1872000000,1872000000,0,2
198gMmnpRqz6f1MS8cSpHwByrduRTKjeX4,False,5485000000,5485000000,0,2
1QBnzUkMvujiPiWrguKipnx2D1fuFgagUJ,False,1852000000,1852000000,0,2
13Zv5GCiKEtwgmhCM8bJ12DYRGNNVEpibE,False,2200000000,2200000000,0,2
1LNTtQEoWN36Kd5BjoRDoUtBtary4iFJwZ,False,467000000,467000000,0,2
1R2jPvwKhPAEv885Ro1J68cHAVnw7hKz8,False,1839000000,1839000000,0,2
1AZv9Gvvt63QChcdZjQZQfD4j5eTrXyMN6,False,32085000000,32085000000,0,2
1M3n4sY2vQPRAuEd1o3tkTWfmkDXaFd1xy,False,7791000000,7791000000,0,2
15i2dw5uzK9GLDdYCztQxdJQyv7vJhPL45,False,1828000000,1828000000,0,2
1HfnGfJfmRsBq36irmXywaDaPwc4agqfqu,False,32080000000,32080000000,0,2
1CmGzbkxqDqGXf7pk3BkBw6EapH5RrkGf4,False,7786000000,7786000000,0,2
1JNkASeuBWN22NAh6tTHfxdfZjnz7Nzhih,False,1826000000,1826000000,0,2
1Cx5tEzE47Agx83AHgdGTQNHYWcexcZrg1,False,1825000000,1825000000,0,2
1Q5zevUPN7ozwdSDFLriQ5Gneext1onXxV,False,111640000000,111640000000,0,7
1F5MEdmau2wu5a13FwgiPUyZ6rG7kjHc9C,False,648000000,648000000,0,2
17a4tekCatJXrj58DFLNKohFHNjKdmcGDU,False,80000000,80000000,0,2
1CQj14M1MdKW53LzJqTwKhPA6c889Pbyvq,False,1824000000,1824000000,0,2
1GpyrouAxhfFtRGSYzsFenAMvESzXxJkWm,False,32075000000,32075000000,0,2
17ycZ9F5eBihzBf8VDBrZRCz3FUN23ZWMV,False,7781000000,7781000000,0,2
1EugwBCJA3oCur8FfK45mCVgBBxk9FNB9b,False,1256000000,1256000000,0,2
1FKstZowybhgU2wrKxCicRfYAJRL7QwuKS,False,944000000,944000000,0,2
1CaPZpyGaMv11B11AM2H6aGwsXjUF1yFh4,False,10000000000,10000000000,0,2
1BEXbnV4vG3cWgMGKF5F1Vce4sszJtvSWj,False,32070000000,32070000000,0,2
14CsMKbCUqHwUu9GVaCBmXK4mVgz9UnBHe,False,7776000000,7776000000,0,2
1JEHp4pGoEAabjhtoJsw9c4xaGRe9Hpr6X,False,687000000,687000000,0,2
1Cfg6sjzztse9qpuCwKZGQ4j7th5vdphNT,False,200000000,200000000,0,2
19fjLWV6A8D1CMRpcTdc11QfmyGYcMEU7e,False,717000000,717000000,0,2
1HujfUp8tzNvBem9MqXxL5yA1SpQWKwmcZ,False,539000000,539000000,0,2
1NKA5hm8e5hz4NKTdwcxf5ncXKhQ9LVFpG,False,32065000000,32065000000,0,2
1FiQQYCC8rbYjgrS1H4VpMUxohNF5x6wj8,False,7771000000,7771000000,0,2
1AuNEqpCovjwF9bZB2uZv3ibc2LBtVc4RQ,False,1362000000,1362000000,0,2
1EpEJj4RmUxmRh8bTDJwHnqD33jv1DXrxe,False,299000000,299000000,0,2
1Bu5CCeLXXkAt2qBHQAo6DYHde5tvXKwyr,False,380000000,380000000,0,2
17TgyPn2wEA9bHuHedYGaozaKqM3M9uqsY,False,15000000000,15000000000,0,2
14F6SmvBmuZFepQGGzXDCUBfDGzzfuhiWZ,False,32060000000,32060000000,0,2
15zek8CHC1pb2P1paf6k3tuUgQPgL1qAmM,False,7766000000,7766000000,0,2
1299PBWEXLUo5q1WrdC19KmzCtr2BCza6S,False,226000000,226000000,0,2
1DnM64p57zMWxQwXiwS6KGHDqFefvX7yQd,False,1000000000,1000000000,0,2
12h5gdyA5iK3RLcEdWRSaAxDdj1dDBBYjS,False,1884000000,1884000000,0,2
1J39HkpXjtKh42PW6HMP2vg9zjPL657u9o,False,4923000000,4923000000,0,2
1H3cYuTjMVutPrx36eXHzxbLhZxJ6yjQZY,False,4849000000,4849000000,0,2
1FVsF1KTfex7G7TUjxNQrF1T1nvvVidQHy,False,4586000000,4586000000,0,2
